Sample,End,Position,Substitution,Pos_Count,Neg_Count,Combined_Count,Pos_Total,Neg_Total,Combined_Total,Frequency
WA09,5p,12,A>G,5922,5782,11704,4741580,4881734,9623314,0.0012162130426171
WA09,5p,18,A>G,5307,5973,11280,4741455,4881610,9623065,0.0011721837065425
WA09,5p,24,A>G,5130,6106,11236,4741363,4881548,9622911,0.0011676300445883
WA09,5p,22,A>G,5112,6092,11204,4741354,4881580,9622934,0.0011643018646911
WA03,5p,21,A>G,6591,6138,12729,5399034,5543509,10942543,0.0011632579373917
WA09,5p,25,A>G,4918,6166,11084,4741301,4881503,9622804,0.0011518472162583
WA09,5p,21,A>G,4989,6022,11011,4741379,4881587,9622966,0.0011442418065282
WA03,5p,12,A>G,6562,5908,12470,5399213,5543665,10942878,0.0011395539637744
WA09,5p,15,A>G,5266,5584,10850,4741496,4881672,9623168,0.0011274873305755
WA09,5p,11,A>G,5257,5591,10848,4741614,4881733,9623347,0.0011272585307377
WA09,5p,20,A>G,5209,5544,10753,4741390,4881557,9622947,0.0011174331522349
WA09,3p,9,A>G,4510,6189,10699,4741664,4881723,9623387,0.0011117707310326
WA09,3p,24,A>G,4740,5949,10689,4741491,4881450,9622941,0.0011107830755691
WA09,5p,23,A>G,5191,5485,10676,4741312,4881565,9622877,0.0011094395158537
WA09,3p,18,A>G,4635,6024,10659,4741560,4881490,9623050,0.0011076529790451
WA09,5p,19,A>G,4892,5742,10634,4741379,4881580,9622959,0.0011050655001231
WA09,3p,21,A>G,4855,5735,10590,4741546,4881493,9623039,0.0011004839531461
WA03,5p,11,A>G,5697,6158,11855,5399321,5543705,10943026,0.0010833383745958
WA09,5p,16,A>G,4911,5489,10400,4741451,4881636,9623087,0.0010807342799665
WA09,5p,9,A>G,5008,5378,10386,4741618,4881747,9623365,0.0010792482671082
WA03,3p,24,A>G,4930,6787,11717,5399198,5543130,10942328,0.0010707959037601
WA09,3p,23,A>G,4846,5425,10271,4741501,4881486,9622987,0.0010673401096769
WA03,3p,15,A>G,5685,5991,11676,5399349,5543505,10942854,0.0010669976954823
WA03,3p,21,A>G,5171,6487,11658,5399248,5543303,10942551,0.0010653822860866
WA03,5p,25,A>G,5523,6091,11614,5398991,5543444,10942435,0.0010613725372826
WA09,5p,10,A>G,5047,5161,10208,4741622,4881737,9623359,0.0010607522799471
WA09,3p,15,A>G,4757,5433,10190,4741598,4881557,9623155,0.0010589042782746
WA03,5p,15,A>G,5968,5615,11583,5399092,5543505,10942597,0.0010585238586416
WA03,5p,18,A>G,5816,5759,11575,5399074,5543600,10942674,0.0010577853274254
WA09,5p,13,A>G,4861,5310,10171,4741530,4881708,9623238,0.0010569207578571
WA09,3p,20,A>G,4591,5492,10083,4741534,4881501,9623035,0.0010477983297369
WA09,3p,17,A>G,4418,5655,10073,4741582,4881528,9623110,0.0010467509983778
WA09,3p,22,A>G,4637,5398,10035,4741524,4881498,9623022,0.0010428117071747
WA03,5p,24,A>G,5628,5761,11389,5398952,5543428,10942380,0.0010408156178089
WA09,5p,17,A>G,4411,5604,10015,4741476,4881638,9623114,0.0010407234082439
WA03,5p,19,A>G,5716,5643,11359,5399071,5543546,10942617,0.0010380515008429
WA09,3p,12,A>G,4379,5608,9987,4741642,4881680,9623322,0.0010377913157223
WA03,5p,9,A>G,6133,5209,11342,5399319,5543732,10943051,0.0010364568345701
WA03,5p,16,A>G,5807,5441,11248,5399083,5543501,10942584,0.0010279107750052
WA09,3p,19,A>G,4541,5348,9889,4741552,4881442,9622994,0.0010276427481925
WA03,5p,22,A>G,5705,5515,11220,5398989,5543454,10942443,0.0010253651766794
WA03,5p,20,A>G,5343,5867,11210,5399050,5543533,10942583,0.0010244381970874
WA03,3p,12,A>G,5183,6018,11201,5399397,5543595,10942992,0.0010235774640061
WA09,3p,25,A>G,4472,5339,9811,4741451,4881469,9622920,0.0010195450029720
WA09,3p,13,A>G,4744,5054,9798,4741628,4881645,9623273,0.0010181567123784
WA09,3p,16,A>G,4386,5410,9796,4741586,4881546,9623132,0.0010179637980649
WA09,3p,10,A>G,4535,5234,9769,4741658,4881705,9623363,0.0010151336907897
WA09,5p,5,A>G,4129,5607,9736,4741671,4881751,9623422,0.0010116983335034
WA03,3p,9,A>G,4909,6014,10923,5399436,5543670,10943106,0.0009981626788591
WA09,3p,14,A>G,4503,5087,9590,4741616,4881571,9623187,0.0009965513503998
WA09,3p,11,A>G,4425,4969,9394,4741648,4881712,9623360,0.0009761663286004
WA03,3p,19,A>G,5041,5619,10660,5399297,5543425,10942722,0.0009741634668229
WA09,5p,14,A>G,4575,4729,9304,4741498,4881705,9623203,0.0009668298590396
WA03,3p,18,A>G,4820,5748,10568,5399325,5543443,10942768,0.0009657519925488
WA03,3p,25,A>G,5146,5411,10557,5399050,5543142,10942192,0.0009647975469631
WA03,3p,22,A>G,4973,5581,10554,5399256,5543263,10942519,0.0009644945555954
WA03,5p,13,A>G,5324,5062,10386,5399156,5543662,10942818,0.0009491156665495
WA03,3p,10,A>G,4828,5457,10285,5399438,5543654,10943092,0.0009398623350694
WA09,3p,8,A>G,3999,5020,9019,4741663,4881718,9623381,0.0009371966048107
DAL218,5p,15,A>G,6209,6545,12754,6952449,6657923,13610372,0.0009370794567554
WA03,5p,23,A>G,4917,5307,10224,5398935,5543457,10942392,0.0009343478098755
WA03,5p,10,A>G,5044,5176,10220,5399344,5543717,10943061,0.0009339251604281
DAL218,5p,11,A>G,8895,3763,12658,6952715,6658016,13610731,0.0009300014819189
WA03,3p,20,A>G,4675,5467,10142,5399252,5543409,10942661,0.0009268312341943
WA03,5p,14,A>G,5012,5035,10047,5399124,5543629,10942753,0.0009181418971989
DAL193,3p,21,A>G,5368,6421,11789,6484248,6362443,12846691,0.0009176682151069
WA03,5p,17,A>G,5034,4992,10026,5399113,5543491,10942604,0.0009162352946337
WA03,3p,13,A>G,4500,5386,9886,5399378,5543551,10942929,0.0009034144331924
WA03,3p,23,A>G,4726,5095,9821,5399255,5543267,10942522,0.0008975079053987
WA03,3p,11,A>G,4785,5017,9802,5399404,5543644,10943048,0.0008957285026986
WA03,3p,16,A>G,4563,5190,9753,5399342,5543495,10942837,0.0008912679591224
WA09,3p,6,A>G,3271,5132,8403,4741672,4881751,9623423,0.0008731820268110
WA03,5p,8,A>G,4528,4929,9457,5399403,5543732,10943135,0.0008641947668561
WA03,3p,17,A>G,4618,4819,9437,5399346,5543438,10942784,0.0008623947982524
WA03,3p,14,A>G,4647,4714,9361,5399356,5543493,10942849,0.0008554445007876
WA09,5p,8,A>G,3839,4387,8226,4741639,4881744,9623383,0.0008547929558659
DAL193,3p,24,A>G,6063,4716,10779,6484164,6362319,12846483,0.0008390623332471
DAL218,5p,19,A>G,7394,3994,11388,6952296,6657770,13610066,0.0008367336352373
WA09,3p,7,A>G,3333,4661,7994,4741672,4881748,9623420,0.0008306818158201
WA09,5p,6,A>G,3519,4267,7786,4741669,4881751,9623420,0.0008090678781555
WA03,5p,5,A>G,4324,4518,8842,5399456,5543740,10943196,0.0008079906455116
WA13,5p,24,A>G,558,9004,9562,5896781,6081498,11978279,0.0007982782835497
WA09,3p,5,A>G,3329,4240,7569,4741672,4881751,9623423,0.0007865184768455
WA11,5p,12,A>G,7445,7948,15393,9756411,10108221,19864632,0.0007748947979504
WA03,3p,8,A>G,3991,4328,8319,5399449,5543673,10943122,0.0007602035324105
DAL193,3p,18,A>G,4771,4879,9650,6484244,6362380,12846624,0.0007511701128638
WA03,3p,7,A>G,3778,4439,8217,5399458,5543739,10943197,0.0007508774629571
DAL193,5p,18,A>G,4612,5029,9641,6483967,6362571,12846538,0.0007504745636528
DAL193,3p,9,A>G,4901,4612,9513,6484400,6362631,12847031,0.0007404823729311
DAL218,3p,19,A>G,3313,6612,9925,6952716,6657697,13610413,0.0007292210750695
DAL193,5p,24,A>G,4646,4704,9350,6483905,6362426,12846331,0.0007278342742375
DAL193,3p,15,A>G,4534,4696,9230,6484332,6362438,12846770,0.0007184685333356
WA03,3p,6,A>G,3745,4069,7814,5399458,5543741,10943199,0.0007140507999534
DAL193,3p,12,A>G,4325,4814,9139,6484368,6362594,12846962,0.0007113744089847
WA03,5p,6,A>G,3975,3760,7735,5399452,5543742,10943194,0.0007068320272856
DAL193,5p,13,A>G,5519,3540,9059,6484143,6362652,12846795,0.0007051564222827
DAL218,3p,18,A>G,3041,6525,9566,6952711,6657672,13610383,0.0007028457612103
DAL218,3p,12,A>G,3318,6212,9530,6952858,6657882,13610740,0.0007001823559924
WA09,5p,7,A>G,3177,3536,6713,4741667,4881751,9623418,0.0006975692004649
WA03,3p,5,A>G,3567,4057,7624,5399458,5543740,10943198,0.0006966884817399
DAL193,5p,15,A>G,4719,4194,8913,6484166,6362534,12846700,0.0006937968505530
DAL193,5p,21,A>G,4515,4292,8807,6484003,6362532,12846535,0.0006855545094455
DAL193,5p,12,A>G,3934,4848,8782,6484218,6362670,12846888,0.0006835896755696
DAL218,3p,21,A>G,3597,5665,9262,6952660,6657692,13610352,0.0006805114224819
DAL193,5p,9,A>G,4269,4429,8698,6484295,6362695,12846990,0.0006770457515729
WA14,3p,14,A>G,2324,6993,9317,6684291,7140742,13825033,0.0006739224419934
DAL193,5p,5,A>G,3303,5343,8646,6484403,6362696,12847099,0.0006729924008525
WA12,3p,24,A>G,3393,5676,9069,6631933,6940411,13572344,0.0006681970336148
DAL193,5p,19,A>G,4412,4154,8566,6483980,6362593,12846573,0.0006667926146529
WA12,3p,9,A>G,2881,6165,9046,6632231,6940656,13572887,0.0006664757468326
DAL193,5p,25,A>G,3953,4585,8538,6483942,6362403,12846345,0.0006646248407621
WA03,5p,7,A>G,3739,3514,7253,5399453,5543742,10943195,0.0006627863252002
DAL193,5p,10,A>G,4171,4318,8489,6484284,6362694,12846978,0.0006607779666159
DAL193,3p,17,A>G,4161,4298,8459,6484294,6362445,12846739,0.0006584550367217
DAL193,3p,20,A>G,3839,4487,8326,6484261,6362382,12846643,0.0006481070580072
WA12,3p,15,A>G,2883,5908,8791,6632188,6940474,13572662,0.0006476990291219
DAL193,5p,20,A>G,4265,4036,8301,6483952,6362554,12846506,0.0006461679152292
WA08,5p,16,A>G,2140,6833,8973,6797921,7188997,13986918,0.0006415280335524
DAL218,3p,22,A>G,3371,5351,8722,6952654,6657637,13610291,0.0006408386124881
DAL193,5p,11,A>G,4132,4100,8232,6484315,6362677,12846992,0.0006407725637254
WA12,5p,16,A>G,4380,4288,8668,6631930,6940590,13572520,0.0006386433764695
WA12,5p,12,A>G,3831,4822,8653,6632126,6940660,13572786,0.0006375257076918
DAL193,3p,14,A>G,4110,4040,8150,6484363,6362486,12846849,0.0006343968081200
DAL193,5p,23,A>G,4027,4069,8096,6483966,6362463,12846429,0.0006302140462536
DAL193,5p,22,A>G,3827,4258,8085,6484010,6362499,12846509,0.0006293538579235
DAL193,3p,11,A>G,3997,4039,8036,6484398,6362639,12847037,0.0006255138830844
DAL193,3p,10,A>G,4087,3932,8019,6484393,6362640,12847033,0.0006241908151088
DAL193,5p,16,A>G,4075,3934,8009,6484111,6362519,12846630,0.0006234319817726
DAL218,3p,24,A>G,3617,4830,8447,6952669,6657588,13610257,0.0006206348638383
DAL218,5p,10,A>G,3775,4650,8425,6952716,6658028,13610744,0.0006189962870508
DAL218,3p,23,A>G,3439,4981,8420,6952651,6657632,13610283,0.0006186498840619
WA12,5p,18,A>G,3392,4958,8350,6632019,6940577,13572596,0.0006152102368625
DAL193,3p,23,A>G,4057,3829,7886,6484218,6362399,12846617,0.0006138581075469
WA12,5p,15,A>G,3619,4696,8315,6631987,6940631,13572618,0.0006126305182979
DAL193,5p,14,A>G,3767,4086,7853,6484145,6362627,12846772,0.0006112819625038
WA08,5p,15,A>G,2175,6346,8521,6797997,7189013,13987010,0.0006092081152440
DAL218,5p,22,A>G,3661,4620,8281,6952322,6657786,13610108,0.0006084448411430
DAL193,5p,17,A>G,3586,4203,7789,6484043,6362598,12846641,0.0006063063488736
WA12,5p,21,A>G,3717,4505,8222,6631936,6940534,13572470,0.0006057850929123
DAL218,3p,14,A>G,2708,5485,8193,6952816,6657779,13610595,0.0006019575191238
WA12,5p,9,A>G,3548,4617,8165,6632209,6940675,13572884,0.0006015670656287
WA12,5p,19,A>G,3554,4605,8159,6631996,6940532,13572528,0.0006011407749536
WA12,3p,12,A>G,3056,5095,8151,6632223,6940615,13572838,0.0006005376325864
DAL193,3p,19,A>G,3777,3923,7700,6484265,6362400,12846665,0.0005993773481288
WA12,5p,11,A>G,3287,4846,8133,6632166,6940667,13572833,0.0005992116752633
DAL218,5p,24,A>G,3682,4473,8155,6952375,6657772,13610147,0.0005991852990272
WA12,5p,20,A>G,3186,4793,7979,6631973,6940532,13572505,0.0005878796876479
DAL193,3p,22,A>G,3814,3723,7537,6484224,6362407,12846631,0.0005866907829764
DAL218,3p,9,A>G,3556,4423,7979,6952882,6657945,13610827,0.0005862244814367
DAL193,3p,13,A>G,3515,4005,7520,6484385,6362543,12846928,0.0005853539460951
DAL218,3p,15,A>G,3427,4536,7963,6952788,6657738,13610526,0.0005850618851909
WA12,3p,13,A>G,3164,4763,7927,6632204,6940591,13572795,0.0005840359336452
DAL218,5p,25,A>G,3977,3962,7939,6952272,6657720,13609992,0.0005833214303138
DAL218,3p,16,A>G,3200,4736,7936,6952760,6657689,13610449,0.0005830814251609
DAL218,5p,16,A>G,3744,4184,7928,6952253,6657920,13610173,0.0005825054538248
DAL218,5p,17,A>G,3261,4667,7928,6952350,6657874,13610224,0.0005825032710703
DAL218,3p,20,A>G,3130,4783,7913,6952697,6657752,13610449,0.0005813915470386
WA12,3p,21,A>G,3238,4647,7885,6632096,6940454,13572550,0.0005809519950193
DAL218,5p,20,A>G,3249,4654,7903,6952289,6657772,13610061,0.0005806733709716
DAL193,3p,6,A>G,3984,3463,7447,6484405,6362696,12847101,0.0005796638478984
DAL218,5p,23,A>G,3669,4210,7879,6952288,6657745,13610033,0.0005789111606121
WA12,5p,24,A>G,3648,4189,7837,6631934,6940518,13572452,0.0005774196143777
DAL193,3p,8,A>G,3646,3767,7413,6484400,6362644,12847044,0.0005770198965614
WA12,3p,25,A>G,3035,4785,7820,6631986,6940428,13572414,0.0005761686904039
WA12,5p,22,A>G,3273,4533,7806,6631921,6940529,13572450,0.0005751356608423
WA12,3p,18,A>G,3166,4628,7794,6632160,6940482,13572642,0.0005742433934380
DAL193,3p,16,A>G,3808,3524,7332,6484341,6362460,12846801,0.0005707257394272
WA12,3p,10,A>G,2963,4719,7682,6632228,6940644,13572872,0.0005659819086188
WA12,3p,23,A>G,3099,4579,7678,6631950,6940459,13572409,0.0005657065005924
WA12,5p,5,A>G,2863,4781,7644,6632242,6940677,13572919,0.0005631802562145
DAL218,5p,5,A>G,3579,4079,7658,6952891,6658031,13610922,0.0005626363886296
WA12,5p,10,A>G,3255,4330,7585,6632199,6940665,13572864,0.0005588356296799
WA12,3p,22,A>G,3137,4431,7568,6632039,6940438,13572477,0.0005575990292707
DAL218,5p,9,A>G,4052,3534,7586,6952736,6658029,13610765,0.0005573529481994
DAL218,5p,13,A>G,3141,4435,7576,6952475,6658005,13610480,0.0005566298910839
WA08,5p,18,A>G,2346,5404,7750,6797991,7188972,13986963,0.0005540874026763
WA18,5p,9,A>G,7515,8130,15645,14112833,14131230,28244063,0.0005539217215313
DAL193,3p,25,A>G,3541,3565,7106,6484128,6362355,12846483,0.0005531475034840
WA12,5p,25,A>G,3302,4145,7447,6631933,6940515,13572448,0.0005486851008749
DAL218,5p,18,A>G,3488,3941,7429,6952457,6657843,13610300,0.0005458366090387
WA12,3p,16,A>G,3241,4135,7376,6632187,6940478,13572665,0.0005434452261217
DAL218,5p,21,A>G,3382,3996,7378,6952371,6657729,13610100,0.0005420974129506
DAL193,3p,7,A>G,3659,3294,6953,6484405,6362696,12847101,0.0005412115931835
WA12,3p,19,A>G,3139,4191,7330,6632121,6940435,13572556,0.0005400603983509
DAL218,3p,13,A>G,2601,4718,7319,6952870,6657811,13610681,0.0005377394415459
WA12,5p,13,A>G,3187,4018,7205,6632065,6940658,13572723,0.0005308441054901
DAL218,5p,12,A>G,3867,3337,7204,6952625,6658005,13610630,0.0005292921782459
WA12,5p,23,A>G,2959,4202,7161,6631926,6940534,13572460,0.0005276125330264
WA12,5p,17,A>G,2937,4133,7070,6631958,6940621,13572579,0.0005209032122782
DAL218,5p,14,A>G,3427,3659,7086,6952554,6657955,13610509,0.0005206271124761
WA11,3p,10,A>G,5150,5149,10299,9756615,10107969,19864584,0.0005184603916195
WA12,3p,20,A>G,3100,3931,7031,6632105,6940432,13572537,0.0005180313746796
WA12,5p,14,A>G,3107,3912,7019,6632026,6940638,13572664,0.0005171423973952
DAL218,3p,25,A>G,3152,3867,7019,6952605,6657566,13610171,0.0005157172529279
DAL218,3p,10,A>G,3264,3713,6977,6952881,6657960,13610841,0.0005126060909829
WA12,3p,17,A>G,2785,4172,6957,6632168,6940473,13572641,0.0005125752607764
WA18,5p,18,A>G,5950,8515,14465,14112481,14130987,28243468,0.0005121538190706
DAL224,5p,23,A>G,2749,1959,4708,4609100,4586313,9195413,0.0005119944041665
WA18,5p,25,A>G,6736,7645,14381,14112273,14130551,28242824,0.0005091912905026
WA14,5p,12,A>G,3177,3847,7024,6684139,7140917,13825056,0.0005080630414806
WA26,5p,22,A>G,1745,1075,2820,2709542,2900059,5609601,0.0005027095510001
DAL218,3p,8,A>G,2664,4158,6822,6952887,6657945,13610832,0.0005012184413120
WA12,3p,14,A>G,2755,4036,6791,6632209,6940533,13572742,0.0005003410512039
WA12,3p,11,A>G,2908,3853,6761,6632231,6940642,13572873,0.0004981259310390
WA11,5p,11,A>G,4625,5255,9880,9756457,10108195,19864652,0.0004973658738144
WA18,3p,12,A>G,6281,7718,13999,14112895,14131136,28244031,0.0004956445487543
DAL218,3p,17,A>G,3068,3676,6744,6952737,6657651,13610388,0.0004955038754222
WA18,5p,22,A>G,6318,7660,13978,14112376,14129592,28241968,0.0004949371800152
WA18,5p,24,A>G,6488,7480,13968,14112253,14129481,28241734,0.0004945871949647
WA14,5p,11,A>G,2834,3998,6832,6684218,7140646,13824864,0.0004941820765831
WA08,5p,7,A>G,1280,5610,6890,6798110,7189085,13987195,0.0004925934041814
WA18,5p,21,A>G,6338,7561,13899,14112347,14130679,28243026,0.0004921214886818
WA11,5p,9,A>G,4490,5205,9695,9756493,10108240,19864733,0.0004880508587757
WA08,5p,9,A>G,2380,4437,6817,6798054,7189067,13987121,0.0004873769233854
WA18,5p,11,A>G,6376,7358,13734,14112776,14131211,28243987,0.0004862627928556
DAL193,3p,5,A>G,2891,3343,6234,6484405,6362696,12847101,0.0004852456597017
WA14,5p,16,A>G,2676,4022,6698,6683910,7140868,13824778,0.0004844924092090
DAL218,3p,11,A>G,2786,3798,6584,6952866,6657905,13610771,0.0004837345364197
WA11,3p,12,A>G,3818,5753,9571,9756581,10108019,19864600,0.0004818118663350
WA12,5p,8,A>G,2615,3923,6538,6632204,6940670,13572874,0.0004816960652548
DAL193,5p,8,A>G,3344,2844,6188,6484314,6362693,12847007,0.0004816686096613
WA18,5p,10,A>G,6355,7236,13591,14112791,14131213,28244004,0.0004811994786574
WA08,5p,12,A>G,2435,4270,6705,6798016,7189056,13987072,0.0004793712365246
WA18,5p,15,A>G,6637,6832,13469,14112545,14131148,28243693,0.0004768852288544
WA08,5p,13,A>G,2197,4472,6669,6797995,7189043,13987038,0.0004767985902376
WA18,5p,19,A>G,5891,7498,13389,14112359,14130867,28243226,0.0004740605765077
WA18,3p,15,A>G,6350,7017,13367,14112809,14130957,28243766,0.0004732725798677
WA12,3p,7,A>G,2550,3863,6413,6632243,6940676,13572919,0.0004724849533103
WA18,3p,24,A>G,5995,7289,13284,14112551,14130690,28243241,0.0004703426210894
WA18,5p,16,A>G,6013,7271,13284,14112522,14131083,28243605,0.0004703365593733
WA14,5p,14,A>G,2956,3542,6498,6683951,7140942,13824893,0.0004700217209637
WA14,5p,13,A>G,3022,3449,6471,6684018,7140931,13824949,0.0004680668261416
WA18,3p,18,A>G,5806,7362,13168,14112708,14130769,28243477,0.0004662315479075
WA14,5p,18,A>G,2929,3509,6438,6683891,7140646,13824537,0.0004656937154567
DAL224,5p,17,A>G,2425,1854,4279,4609285,4586385,9195670,0.0004653277031472
WA12,3p,8,A>G,2635,3678,6313,6632240,6940664,13572904,0.0004651178553977
WA18,3p,23,A>G,6060,7013,13073,14112548,14130648,28243196,0.0004628725445944
WA11,3p,9,A>G,3784,5407,9191,9756610,10108092,19864702,0.0004626799838225
WA18,3p,13,A>G,5957,7098,13055,14112898,14131061,28243959,0.0004622227358423
WA18,5p,12,A>G,6555,6475,13030,14112682,14131223,28243905,0.0004613384728492
DAL224,5p,15,A>G,2717,1503,4220,4609299,4586416,9195715,0.0004589093942124
WA18,5p,20,A>G,5906,7004,12910,14112397,14130866,28243263,0.0004571001587174
WA14,3p,18,A>G,2525,3793,6318,6684177,7140647,13824824,0.0004570040095989
WA18,3p,21,A>G,5746,7121,12867,14112659,14130783,28243442,0.0004555747844048
WA18,3p,19,A>G,5808,7035,12843,14112724,14130771,28243495,0.0004547241763103
WA14,5p,19,A>G,3035,3239,6274,6683958,7140595,13824553,0.0004538302251074
WA18,3p,20,A>G,6249,6538,12787,14112697,14130797,28243494,0.0004527414348947
WA11,5p,22,A>G,4226,4760,8986,9756136,10108029,19864165,0.0004523724002493
WA18,5p,5,A>G,6332,6430,12762,14112925,14131239,28244164,0.0004518455564838
WA14,5p,5,A>G,2841,3397,6238,6684341,7140972,13825313,0.0004512013579728
WA18,3p,22,A>G,6009,6729,12738,14112575,14130715,28243290,0.0004510097796680
WA12,3p,5,A>G,2366,3753,6119,6632243,6940678,13572921,0.0004508241077952
WA11,5p,15,A>G,4415,4521,8936,9756237,10108096,19864333,0.0004498515001737
WA11,5p,10,A>G,4810,4123,8933,9756446,10108197,19864643,0.0004496934578688
WA18,3p,10,A>G,5384,7310,12694,14112909,14131197,28244106,0.0004494389024032
WA18,5p,17,A>G,6044,6641,12685,14112485,14130990,28243475,0.0004491302858447
WA11,3p,22,A>G,4738,4183,8921,9756405,10107842,19864247,0.0004490983222268
WA14,3p,13,A>G,2178,4027,6205,6684289,7140794,13825083,0.0004488218985737
WA14,5p,17,A>G,2798,3392,6190,6683904,7140873,13824777,0.0004477468244153
WA14,5p,24,A>G,3069,3031,6100,6683714,7140421,13824135,0.0004412572649210
WA14,5p,23,A>G,2756,3319,6075,6683762,7140257,13824019,0.0004394525210070
WA14,5p,9,A>G,2705,3341,6046,6684241,7140959,13825200,0.0004373173624974
WA12,3p,6,A>G,2190,3730,5920,6632243,6940679,13572922,0.0004361625300727
WA18,5p,23,A>G,5741,6544,12285,14112288,14129275,28241563,0.0004349971706594
WA11,5p,13,A>G,4303,4315,8618,9756334,10108178,19864512,0.0004338389989142
DAL224,5p,24,A>G,1913,2071,3984,4609109,4586316,9195425,0.0004332589303920
WA11,5p,21,A>G,4556,4044,8600,9756251,10108036,19864287,0.0004329377641392
WA18,3p,25,A>G,5953,6259,12212,14112486,14130651,28243137,0.0004323882293953
DAL195,5p,19,A>G,978,1023,2001,2363138,2267420,4630558,0.0004321293459665
WA14,5p,21,A>G,2811,3162,5973,6683480,7140494,13823974,0.0004320754654197
DAL193,5p,6,A>G,2481,3048,5529,6484404,6362696,12847100,0.0004303694997314
WA14,5p,22,A>G,2716,3211,5927,6683768,7140398,13824166,0.0004287419581043
DAL195,5p,21,A>G,1008,976,1984,2363086,2267400,4630486,0.0004284647443054
WA14,3p,24,A>G,2589,3334,5923,6683623,7140532,13824155,0.0004284529506505
WA14,3p,22,A>G,2581,3338,5919,6684105,7140560,13824665,0.0004281478068365
DAL212,3p,15,A>G,1660,1824,3484,4131254,4007935,8139189,0.0004280524754984
WA08,5p,14,A>G,2157,3830,5987,6797984,7189041,13987025,0.0004280395580904
WA11,5p,24,A>G,4217,4279,8496,9756046,10108010,19864056,0.0004277072114577
WA12,5p,6,A>G,2536,3262,5798,6632242,6940679,13572921,0.0004271740769728
WA18,3p,14,A>G,5255,6808,12063,14112830,14131006,28243836,0.0004271020409550
WA14,5p,15,A>G,2573,3330,5903,6684030,7140908,13824938,0.0004269820233551
WA11,3p,21,A>G,4098,4344,8442,9756421,10107904,19864325,0.0004249829782788
WA18,5p,13,A>G,5422,6581,12003,14112608,14131206,28243814,0.0004249780146548
WA14,5p,10,A>G,2719,3141,5860,6684210,7140628,13824838,0.0004238747680081
WA08,5p,10,A>G,2150,3777,5927,6798015,7189037,13987052,0.0004237490501929
WA11,5p,20,A>G,4216,4177,8393,9756292,10108082,19864374,0.0004225152023416
WA14,3p,20,A>G,2481,3358,5839,6684176,7140544,13824720,0.0004223593678569
DAL212,5p,25,A>G,1684,1749,3433,4131016,4007614,8138630,0.0004218154652564
WA25,5p,10,A>G,1797,1130,2927,3375217,3569085,6944302,0.0004214966457391
WA11,5p,18,A>G,4331,4035,8366,9756327,10108075,19864402,0.0004211553914384
WA11,5p,25,A>G,4220,4142,8362,9756056,10107943,19863999,0.0004209625665003
DAL195,5p,22,A>G,901,1048,1949,2363094,2267388,4630482,0.0004209065060613
WA11,5p,16,A>G,4137,4213,8350,9756275,10108079,19864354,0.0004203509462225
WA11,5p,8,A>G,3609,4708,8317,9756500,10108261,19864761,0.0004186811006686
WA11,5p,17,A>G,4116,4193,8309,9756369,10108078,19864447,0.0004182849892574
WA11,3p,24,A>G,3513,4791,8304,9756358,10107704,19864062,0.0004180413854930
WA11,5p,5,A>G,3585,4669,8254,9756638,10108267,19864905,0.0004155066435001
DAL224,5p,21,A>G,1768,2052,3820,4609195,4586347,9195542,0.0004154186887515
WA14,5p,20,A>G,2780,2948,5728,6683860,7140558,13824418,0.0004143393233624
WA18,3p,11,A>G,5902,5754,11656,14112900,14131167,28244067,0.0004126884417885
WA18,3p,9,A>G,5487,6156,11643,14112909,14131177,28244086,0.0004122278908228
DAL195,3p,23,A>G,1113,795,1908,2363219,2267370,4630589,0.0004120426148811
WA14,5p,25,A>G,2681,3012,5693,6683731,7140511,13824242,0.0004118128140407
WA11,5p,19,A>G,4288,3865,8153,9756284,10108088,19864372,0.0004104333124651
WA11,3p,18,A>G,3543,4596,8139,9756421,10108016,19864437,0.0004097271923689
WA14,3p,15,A>G,2442,3222,5664,6684271,7140702,13824973,0.0004096933860196
WA14,3p,25,A>G,2677,2985,5662,6683613,7140513,13824126,0.0004095738132016
WA26,5p,18,A>G,819,1475,2294,2709554,2900082,5609636,0.0004089391896372
WA11,3p,15,A>G,3663,4426,8089,9756471,10107972,19864443,0.0004072100083551
DAL218,5p,8,A>G,3100,2420,5520,6952719,6658029,13610748,0.0004055618398048
WA26,5p,20,A>G,1095,1172,2267,2709563,2900082,5609645,0.0004041253947442
DAL195,5p,12,A>G,886,983,1869,2362864,2267454,4630318,0.0004036439829834
WA18,5p,14,A>G,5141,6254,11395,14112535,14131179,28243714,0.0004034526054186
DAL193,5p,7,A>G,2668,2513,5181,6484404,6362696,12847100,0.0004032816744634
WA18,3p,5,A>G,4292,7077,11369,14112928,14131239,28244167,0.0004025255905051
WA11,3p,13,A>G,3884,4100,7984,9756565,10107963,19864528,0.0004019224619885
WA11,3p,25,A>G,3740,4243,7983,9756281,10107693,19863974,0.0004018833290861
WA14,3p,21,A>G,2515,3039,5554,6684132,7140443,13824575,0.0004017483358439
WA11,5p,23,A>G,4065,3909,7974,9756095,10108016,19864111,0.0004014274789342
DAL224,3p,13,A>G,1385,2304,3689,4609454,4586364,9195818,0.0004011606145315
DAL218,3p,6,A>G,2217,3238,5455,6952891,6658030,13610921,0.0004007811080528
WA14,3p,10,A>G,2340,3189,5529,6684256,7140912,13825168,0.0003999228074479
WA11,3p,16,A>G,3723,4221,7944,9756477,10108011,19864488,0.0003999096276732
WA11,3p,11,A>G,3633,4310,7943,9756587,10107918,19864505,0.0003998589443834
WA11,3p,20,A>G,3891,4041,7932,9756433,10107963,19864396,0.0003993073839244
WA11,3p,23,A>G,3695,4226,7921,9756375,10107816,19864191,0.0003987577445263
WA18,3p,16,A>G,5854,5406,11260,14112765,14130927,28243692,0.0003986730913224
WA18,3p,17,A>G,5380,5872,11252,14112743,14130850,28243593,0.0003983912386784
WA11,3p,19,A>G,3897,4007,7904,9756438,10108000,19864438,0.0003978969855578
WA22,5p,5,A>G,431,828,1259,1513708,1653396,3167104,0.0003975240472052
DAL218,3p,7,A>G,2043,3365,5408,6952891,6658026,13610917,0.0003973281153650
WA12,5p,7,A>G,2272,3075,5347,6632238,6940679,13572917,0.0003939462681456
DAL212,3p,11,A>G,1521,1681,3202,4131313,4008105,8139418,0.0003933942205695
WA08,5p,25,A>G,2466,3011,5477,6797835,7188817,13986652,0.0003915876365551
DAL212,3p,23,A>G,1621,1566,3187,4131172,4007904,8139076,0.0003915677897589
WA26,5p,19,A>G,982,1200,2182,2709570,2900086,5609656,0.0003889721580075
WA08,5p,17,A>G,2056,3377,5433,6797959,7188875,13986834,0.0003884367255663
DAL212,3p,12,A>G,1647,1513,3160,4131314,4008034,8139348,0.0003882374853612
WA08,5p,24,A>G,2443,2968,5411,6797841,7188876,13986717,0.0003868670539341
WA26,5p,25,A>G,999,1170,2169,2709506,2900041,5609547,0.0003866622385016
WA11,3p,17,A>G,3688,3992,7680,9756469,10108044,19864513,0.0003866190930530
DAL212,5p,18,A>G,1567,1570,3137,4131113,4008066,8139179,0.0003854197087937
DAL212,3p,17,A>G,1387,1748,3135,4131249,4007981,8139230,0.0003851715702836
DAL212,5p,5,A>G,1180,1951,3131,4131322,4008153,8139475,0.0003846685443471
DAL224,3p,24,A>G,1101,2434,3535,4609325,4586202,9195527,0.0003844260367024
DAL212,5p,23,A>G,1296,1832,3128,4131005,4007962,8138967,0.0003843239565905
DAL224,5p,16,A>G,1994,1540,3534,4609292,4586373,9195665,0.0003843115207002
WA25,5p,16,A>G,1041,1627,2668,3375081,3569035,6944116,0.0003842101716042
WA11,3p,7,A>G,3349,4275,7624,9756642,10108265,19864907,0.0003837923832213
WA11,3p,14,A>G,3503,4119,7622,9756515,10107914,19864429,0.0003837009359795
DAL212,3p,18,A>G,1619,1499,3118,4131222,4007954,8139176,0.0003830854622138
DAL218,3p,5,A>G,2000,3201,5201,6952891,6658031,13610922,0.0003821195948371
WA14,3p,23,A>G,2159,3112,5271,6683638,7140562,13824200,0.0003812878864599
WA25,5p,13,A>G,1452,1195,2647,3375133,3569081,6944214,0.0003811806490986
DAL212,5p,24,A>G,1350,1744,3094,4131060,4007918,8138978,0.0003801460085037
DAL212,5p,22,A>G,1391,1702,3093,4131015,4007967,8138982,0.0003800229561878
WA26,5p,15,A>G,830,1290,2120,2709545,2900085,5609630,0.0003779215384971
WA26,5p,5,A>G,828,1289,2117,2709623,2900125,5609748,0.0003773788056076
WA26,5p,11,A>G,1059,1056,2115,2709605,2900103,5609708,0.0003770249717097
WA14,3p,19,A>G,2173,3028,5201,6684172,7140542,13824714,0.0003762103143688
WA26,5p,24,A>G,983,1127,2110,2709495,2900057,5609552,0.0003761441198869
DAL224,3p,9,A>G,1106,2351,3457,4609466,4586431,9195897,0.0003759285255152
WA14,3p,11,A>G,1909,3282,5191,6684256,7140894,13825150,0.0003754751304687
DAL218,5p,7,A>G,2415,2694,5109,6952888,6658031,13610919,0.0003753603999847
WA08,5p,19,A>G,2337,2882,5219,6797966,7188988,13986954,0.0003731334213296
DAL195,3p,21,A>G,843,883,1726,2363235,2267382,4630617,0.0003727365057399
DAL195,3p,24,A>G,839,881,1720,2363198,2267373,4630571,0.0003714444719668
WA14,3p,16,A>G,2293,2838,5131,6684263,7140648,13824911,0.0003711416297725
DAL212,5p,21,A>G,1482,1524,3006,4130973,4008040,8139013,0.0003693322519573
DAL195,5p,17,A>G,715,994,1709,2363159,2267431,4630590,0.0003690674406501
WA08,5p,20,A>G,2066,3096,5162,6797883,7188971,13986854,0.0003690608338372
DAL212,5p,11,A>G,1462,1535,2997,4131234,4008143,8139377,0.0003682099993648
WA26,5p,21,A>G,845,1219,2064,2709545,2900061,5609606,0.0003679402795846
WA25,5p,11,A>G,998,1554,2552,3375193,3569088,6944281,0.0003674966494011
WA26,5p,14,A>G,837,1224,2061,2709563,2900089,5609652,0.0003674024698858
DAL212,5p,16,A>G,1492,1497,2989,4131154,4008081,8139235,0.0003672335299324
WA26,5p,17,A>G,963,1095,2058,2709554,2900055,5609609,0.0003668704895474
DAL212,3p,13,A>G,1696,1289,2985,4131307,4007923,8139230,0.0003667423085476
DAL212,3p,21,A>G,1404,1569,2973,4131228,4007917,8139145,0.0003652717822326
DAL212,3p,25,A>G,1519,1452,2971,4131071,4007924,8138995,0.0003650327835316
DAL195,5p,25,A>G,763,925,1688,2363135,2267374,4630509,0.0003645387580501
WA11,5p,14,A>G,3539,3696,7235,9756261,10108167,19864428,0.0003642188941961
DAL212,3p,20,A>G,1460,1500,2960,4131221,4007928,8139149,0.0003636743841401
WA18,3p,6,A>G,4039,6229,10268,14112928,14131239,28244167,0.0003635440903603
DAL212,3p,24,A>G,1437,1521,2958,4131124,4007904,8139028,0.0003634340611679
WA14,5p,8,A>G,2300,2720,5020,6684277,7140970,13825247,0.0003631038201342
DAL195,3p,14,A>G,758,919,1677,2363250,2267410,4630660,0.0003621513995845
DAL195,5p,18,A>G,850,824,1674,2363182,2267420,4630602,0.0003615080717366
DAL195,3p,19,A>G,889,784,1673,2363215,2267369,4630584,0.0003612935215083
DAL212,5p,9,A>G,1436,1503,2939,4131243,4008153,8139396,0.0003610833039699
DAL212,3p,14,A>G,1456,1479,2935,4131271,4007904,8139175,0.0003606016580304
WA26,5p,16,A>G,810,1209,2019,2709540,2900076,5609616,0.0003599176842051
DAL224,3p,19,A>G,1542,1766,3308,4609353,4586195,9195548,0.0003597392999307
WA25,5p,12,A>G,1435,1063,2498,3375142,3569084,6944226,0.0003597233154566
WA26,5p,12,A>G,956,1059,2015,2709595,2900107,5609702,0.0003591991161027
DAL212,5p,14,A>G,1360,1563,2923,4131134,4008108,8139242,0.0003591243508916
WA18,5p,6,A>G,4838,5302,10140,14112927,14131239,28244166,0.0003590121938810
WA08,5p,22,A>G,2198,2822,5020,6797887,7188939,13986826,0.0003589091620929
WA26,3p,14,A>G,1061,949,2010,2709584,2900069,5609653,0.0003583109329578
DAL212,5p,12,A>G,1263,1650,2913,4131187,4008141,8139328,0.0003578919537337
WA14,3p,12,A>G,2049,2892,4941,6684291,7140849,13825140,0.0003573924025362
WA26,3p,10,A>G,726,1269,1995,2709609,2900074,5609683,0.0003556350688621
WA14,3p,7,A>G,1897,3018,4915,6684341,7140969,13825310,0.0003555073991107
DAL218,5p,6,A>G,2454,2384,4838,6952891,6658031,13610922,0.0003554498365356
DAL195,3p,18,A>G,876,768,1644,2363236,2267374,4630610,0.0003550288190972
WA14,3p,17,A>G,2268,2608,4876,6684212,7140653,13824865,0.0003526978382790
DAL195,3p,13,A>G,889,744,1633,2363269,2267412,4630681,0.0003526479150690
DAL212,5p,19,A>G,1383,1486,2869,4131040,4008052,8139092,0.0003524963226856
DAL212,3p,16,A>G,1486,1381,2867,4131236,4007982,8139218,0.0003522451419780
DAL195,5p,13,A>G,880,748,1628,2363073,2267445,4630518,0.0003515805359141
DAL212,5p,20,A>G,1238,1622,2860,4131020,4008040,8139060,0.0003513919297805
DAL224,5p,20,A>G,1569,1638,3207,4609148,4586313,9195461,0.0003487590236095
WA14,3p,9,A>G,2231,2589,4820,6684323,7140920,13825243,0.0003486376333493
WA11,5p,6,A>G,3070,3850,6920,9756642,10108269,19864911,0.0003483529324646
WA26,5p,13,A>G,940,1013,1953,2709592,2900104,5609696,0.0003481472079770
DAL195,5p,16,A>G,819,792,1611,2363170,2267429,4630599,0.0003479031546458
DAL195,3p,17,A>G,894,716,1610,2363234,2267398,4630632,0.0003476847220854
WA26,3p,15,A>G,976,974,1950,2709593,2900082,5609675,0.0003476137209374
WA08,5p,21,A>G,2191,2667,4858,6797885,7188979,13986864,0.0003473258909216
DAL212,3p,22,A>G,1314,1511,2825,4131183,4007898,8139081,0.0003470907833451
DAL195,5p,11,A>G,810,795,1605,2362948,2267450,4630398,0.0003466224717616
WA25,5p,20,A>G,988,1418,2406,3375145,3569019,6944164,0.0003464779921672
WA18,5p,8,A>G,4647,5137,9784,14112828,14131230,28244058,0.0003464091455979
WA26,3p,9,A>G,1151,792,1943,2709613,2900111,5609724,0.0003463628513630
DAL195,5p,24,A>G,823,780,1603,2363067,2267402,4630469,0.0003461852352321
WA08,3p,25,A>G,2013,2821,4834,6797966,7188892,13986858,0.0003456101434646
WA18,3p,7,A>G,4040,5710,9750,14112928,14131237,28244165,0.0003452040448000
WA02,5p,12,A>G,2320,2271,4591,6552628,6754236,13306864,0.0003450099136806
DAL212,3p,19,A>G,1541,1262,2803,4131233,4007956,8139189,0.0003443832057469
WA11,3p,8,A>G,3264,3553,6817,9756629,10108160,19864789,0.0003431700180656
DAL212,5p,13,A>G,1347,1437,2784,4131181,4008142,8139323,0.0003420431895871
WA25,5p,22,A>G,991,1378,2369,3375139,3569001,6944140,0.0003411509560579
WA25,5p,21,A>G,1037,1325,2362,3375130,3569013,6944143,0.0003401427649171
WA14,3p,8,A>G,2074,2601,4675,6684326,7140932,13825258,0.0003381492048828
WA25,5p,19,A>G,1188,1156,2344,3375134,3569021,6944155,0.0003375500690868
DAL212,5p,15,A>G,1396,1339,2735,4131156,4008091,8139247,0.0003360261704798
WA02,5p,24,A>G,2122,2328,4450,6552457,6754135,13306592,0.0003344207141843
WA11,5p,7,A>G,2982,3653,6635,9756629,10108269,19864898,0.0003340062455895
WA08,3p,19,A>G,2004,2665,4669,6798028,7188946,13986974,0.0003338105869075
WA08,3p,18,A>G,1925,2742,4667,6798023,7188956,13986979,0.0003336674774445
WA02,5p,9,A>G,2178,2262,4440,6552662,6754226,13306888,0.0003336617847839
DAL212,3p,9,A>G,1171,1541,2712,4131316,4008115,8139431,0.0003331928239209
DAL195,3p,22,A>G,699,838,1537,2363231,2267383,4630614,0.0003319214255388
WA26,5p,23,A>G,809,1050,1859,2709528,2900065,5609593,0.0003313965915174
WA14,5p,6,A>G,1949,2629,4578,6684340,7140972,13825312,0.0003311317675868
DAL224,3p,23,A>G,1057,1984,3041,4609323,4586083,9195406,0.0003307086168897
WA02,5p,19,A>G,2084,2315,4399,6552516,6754124,13306640,0.0003305868348433
WA02,5p,11,A>G,2049,2347,4396,6552625,6754225,13306850,0.0003303561699425
WA22,3p,24,A>G,255,789,1044,1513672,1653285,3166957,0.0003296539864608
WA08,5p,23,A>G,2120,2482,4602,6797851,7188919,13986770,0.0003290252145420
DAL195,3p,20,A>G,728,794,1522,2363222,2267380,4630602,0.0003286829660592
DAL195,3p,9,A>G,668,854,1522,2363276,2267438,4630714,0.0003286750164229
WA08,5p,11,A>G,2101,2492,4593,6797997,7189047,13987044,0.0003283753164714
DAL195,3p,12,A>G,701,818,1519,2363273,2267414,4630687,0.0003280290807821
WA08,3p,23,A>G,2077,2505,4582,6798009,7188864,13986873,0.0003275928794091
WA25,5p,23,A>G,905,1369,2274,3375144,3569002,6944146,0.0003274700733538
WA08,3p,21,A>G,1965,2592,4557,6798010,7188926,13986936,0.0003258040216956
DAL224,5p,25,A>G,1365,1617,2982,4609125,4586257,9195382,0.0003242932158772
DAL195,3p,10,A>G,795,704,1499,2363274,2267432,4630706,0.0003237087390130
WA18,5p,7,A>G,4730,4409,9139,14112921,14131239,28244160,0.0003235713152736
WA11,3p,6,A>G,3009,3403,6412,9756642,10108269,19864911,0.0003227802027403
DAL212,3p,10,A>G,1180,1440,2620,4131317,4008102,8139419,0.0003218902970838
WA02,5p,20,A>G,2031,2246,4277,6552507,6754132,13306639,0.0003214185039512
WA22,5p,25,A>G,492,525,1017,1513644,1653364,3167008,0.0003211232810273
WA18,3p,8,A>G,4809,4260,9069,14112927,14131187,28244114,0.0003210934497715
WA08,3p,20,A>G,1885,2603,4488,6798009,7188917,13986926,0.0003208710763179
DAL224,3p,16,A>G,983,1966,2949,4609379,4586240,9195619,0.0003206961923933
WA02,5p,14,A>G,1748,2517,4265,6552607,6754183,13306790,0.0003205130613769
WA11,3p,5,A>G,3253,3107,6360,9756642,10108269,19864911,0.0003201625217450
WA02,5p,18,A>G,2138,2113,4251,6552548,6754087,13306635,0.0003194646881048
DAL224,5p,22,A>G,1701,1230,2931,4609138,4586312,9195450,0.0003187445965124
DAL224,5p,5,A>G,1484,1447,2931,4609471,4586477,9195948,0.0003187273351262
WA22,3p,18,A>G,271,737,1008,1513665,1653288,3166953,0.0003182870096272
WA02,5p,25,A>G,2140,2085,4225,6552470,6754083,13306553,0.0003175127322605
WA14,5p,7,A>G,1794,2592,4386,6684336,7140972,13825308,0.0003172442885178
DAL195,5p,10,A>G,771,698,1469,2363146,2267458,4630604,0.0003172372329829
WA02,3p,24,A>G,1828,2393,4221,6552556,6754026,13306582,0.0003172114371669
WA25,5p,15,A>G,1025,1175,2200,3375137,3569055,6944192,0.0003168115167322
WA02,5p,21,A>G,2062,2145,4207,6552521,6754152,13306673,0.0003161571641536
WA02,5p,22,A>G,2165,2038,4203,6552516,6754117,13306633,0.0003158575125653
WA02,5p,15,A>G,2104,2089,4193,6552586,6754168,13306754,0.0003151031423591
WA02,3p,23,A>G,1851,2331,4182,6552585,6754052,13306637,0.0003142792577869
WA07,5p,19,A>G,1674,1996,3670,5691482,6013884,11705366,0.0003135314179838
WA25,5p,25,A>G,990,1182,2172,3375125,3568950,6944075,0.0003127846401428
DAL195,5p,9,A>G,757,689,1446,2363181,2267461,4630642,0.0003122677157940
WA02,3p,21,A>G,1737,2415,4152,6552597,6754089,13306686,0.0003120235947552
WA02,3p,22,A>G,1828,2321,4149,6552593,6754062,13306655,0.0003117988705651
DAL195,5p,23,A>G,784,657,1441,2363068,2267398,4630466,0.0003111997798925
WA02,5p,23,A>G,1945,2188,4133,6552465,6754131,13306596,0.0003105978418522
WA08,5p,5,A>G,1723,2616,4339,6798116,7189084,13987200,0.0003102121940059
DAL227,3p,24,A>G,748,1588,2336,3765312,3771081,7536393,0.0003099626041264
DAL212,5p,17,A>G,1074,1446,2520,4131159,4008081,8139240,0.0003096112167720
WA02,3p,25,A>G,1883,2236,4119,6552517,6754038,13306555,0.0003095466858251
WA08,5p,8,A>G,1825,2502,4327,6798069,7189064,13987133,0.0003093557486012
WA25,3p,19,A>G,1103,1045,2148,3375204,3569005,6944209,0.0003093224872696
WA26,3p,18,A>G,857,878,1735,2709582,2900059,5609641,0.0003092889544981
DAL212,3p,7,A>G,1100,1417,2517,4131322,4008153,8139475,0.0003092337036479
WA22,3p,25,A>G,314,665,979,1513669,1653296,3166965,0.0003091287715525
DAL212,3p,6,A>G,1158,1354,2512,4131322,4008151,8139473,0.0003086194892470
WA26,3p,13,A>G,898,831,1729,2709604,2900084,5609688,0.0003082167849620
WA25,5p,18,A>G,994,1144,2138,3375102,3568996,6944098,0.0003078873598846
DAL227,3p,22,A>G,835,1485,2320,3765309,3771137,7536446,0.0003078374077118
WA02,3p,20,A>G,1819,2271,4090,6552618,6754033,13306651,0.0003073650913366
WA25,5p,17,A>G,1109,1025,2134,3375076,3568871,6943947,0.0003073180138039
DAL224,3p,21,A>G,1476,1348,2824,4609343,4586223,9195566,0.0003071045327715
DAL195,5p,5,A>G,668,754,1422,2363277,2267461,4630738,0.0003070784829545
WA26,3p,24,A>G,909,812,1721,2709558,2899951,5609509,0.0003068004704155
WA08,3p,15,A>G,1861,2416,4277,6798069,7188978,13987047,0.0003057829147210
DAL195,3p,8,A>G,657,758,1415,2363278,2267413,4630691,0.0003055699462564
DAL195,3p,15,A>G,737,676,1413,2363254,2267411,4630665,0.0003051397585443
WA26,3p,11,A>G,775,932,1707,2709594,2900076,5609670,0.0003042959746295
WA07,5p,18,A>G,1684,1873,3557,5691474,6013905,11705379,0.0003038773883357
WA25,5p,24,A>G,1094,1015,2109,3375124,3568967,6944091,0.0003037114576983
WA08,3p,22,A>G,1908,2335,4243,6798012,7188920,13986932,0.0003033545884115
WA26,5p,9,A>G,736,965,1701,2709594,2900123,5609717,0.0003032238524688
WA08,3p,24,A>G,1840,2401,4241,6798015,7188867,13986882,0.0003032126817113
DAL195,5p,20,A>G,691,711,1402,2363110,2267401,4630511,0.0003027743590286
WA08,3p,13,A>G,1748,2470,4218,6798090,7189013,13987103,0.0003015635189073
DAL212,5p,10,A>G,1246,1207,2453,4131179,4008148,8139327,0.0003013762685784
WA22,3p,20,A>G,273,680,953,1513684,1653304,3166988,0.0003009168332813
WA26,3p,22,A>G,887,801,1688,2709522,2900007,5609529,0.0003009165297122
WA02,3p,18,A>G,1686,2310,3996,6552611,6754085,13306696,0.0003002999392185
DAL224,3p,22,A>G,1330,1429,2759,4609324,4586172,9195496,0.0003000381926108
DAL195,3p,16,A>G,718,671,1389,2363259,2267394,4630653,0.0002999576949514
WA08,3p,11,A>G,1769,2426,4195,6798109,7189046,13987155,0.0002999180319371
WA08,3p,16,A>G,1711,2481,4192,6798049,7188961,13987010,0.0002997066563904
WA25,3p,24,A>G,909,1171,2080,3375177,3568962,6944139,0.0002995331746671
DAL224,5p,18,A>G,1199,1555,2754,4609226,4586351,9195577,0.0002994918100299
WA26,5p,10,A>G,807,873,1680,2709601,2900123,5609724,0.0002994799744158
WA08,3p,14,A>G,1832,2351,4183,6798067,7188981,13987048,0.0002990623897194
WA25,3p,14,A>G,934,1142,2076,3375223,3569037,6944260,0.0002989519401635
DAL212,3p,8,A>G,1111,1306,2417,4131319,4008093,8139412,0.0002969501973852
WA08,3p,17,A>G,1675,2472,4147,6798000,7188943,13986943,0.0002964908057464
WA02,5p,17,A>G,1928,2013,3941,6552567,6754148,13306715,0.0002961662589151
WA22,5p,23,A>G,470,466,936,1513634,1653393,3167027,0.0002955453174223
WA02,5p,10,A>G,1916,2014,3930,6552618,6754222,13306840,0.0002953368342897
WA26,3p,19,A>G,823,833,1656,2709567,2900016,5609583,0.0002952091091262
WA22,3p,21,A>G,251,683,934,1513677,1653327,3167004,0.0002949159521112
WA02,3p,12,A>G,1785,2135,3920,6552670,6754189,13306859,0.0002945849204534
WA07,3p,18,A>G,1123,2322,3445,5691639,6013769,11705408,0.0002943084085578
DAL195,5p,14,A>G,642,716,1358,2363094,2267434,4630528,0.0002932710913312
WA26,3p,16,A>G,729,916,1645,2709580,2900075,5609655,0.0002932444152091
WA02,5p,13,A>G,1853,2048,3901,6552614,6754205,13306819,0.0002931579666034
DAL195,3p,6,A>G,665,692,1357,2363278,2267461,4630739,0.0002930417801564
WA07,5p,21,A>G,1444,1984,3428,5691379,6013853,11705232,0.0002928604917869
DAL195,5p,15,A>G,701,655,1356,2363178,2267432,4630610,0.0002928339894743
WA02,3p,15,A>G,1691,2198,3889,6552632,6754146,13306778,0.0002922570738010
WA07,5p,23,A>G,1972,1446,3418,5691314,6013795,11705109,0.0002920092414346
DAL224,5p,19,A>G,1170,1514,2684,4609203,4586337,9195540,0.0002918806290875
WA26,3p,20,A>G,747,883,1630,2709563,2899983,5609546,0.0002905761000979
DAL195,3p,25,A>G,726,619,1345,2363180,2267377,4630557,0.0002904618170125
WA26,3p,12,A>G,828,800,1628,2709607,2900081,5609688,0.0002902122185761
WA25,5p,5,A>G,967,1047,2014,3375244,3569088,6944332,0.0002900206960151
DAL195,3p,11,A>G,695,644,1339,2363274,2267431,4630705,0.0002891568346504
WA08,3p,12,A>G,1805,2236,4041,6798091,7189018,13987109,0.0002889088803125
WA02,5p,16,A>G,1889,1948,3837,6552525,6754178,13306703,0.0002883509160759
WA02,3p,19,A>G,1797,2038,3835,6552605,6754056,13306661,0.0002882015255367
WA26,3p,21,A>G,792,820,1612,2709562,2900021,5609583,0.0002873653888354
DAL227,3p,15,A>G,894,1271,2165,3765341,3771186,7536527,0.0002872675968652
WA02,3p,10,A>G,1682,2140,3822,6552680,6754207,13306887,0.0002872196930807
WA02,3p,17,A>G,1670,2123,3793,6552608,6754116,13306724,0.0002850438620354
WA08,3p,10,A>G,1771,2215,3986,6798074,7189042,13987116,0.0002849765455580
WA26,3p,25,A>G,914,682,1596,2709500,2900002,5609502,0.0002845172352198
WA26,3p,8,A>G,834,760,1594,2709619,2900114,5609733,0.0002841489960395
WA25,5p,9,A>G,1041,931,1972,3375227,3569087,6944314,0.0002839733341551
DAL212,3p,5,A>G,1019,1290,2309,4131322,4008151,8139473,0.0002836792996303
WA26,3p,23,A>G,889,697,1586,2709541,2899974,5609515,0.0002827338905413
WA14,3p,6,A>G,1778,2128,3906,6684341,7140971,13825312,0.0002825252695924
DAL224,3p,14,A>G,1455,1142,2597,4609412,4586293,9195705,0.0002824144532692
DAL224,3p,8,A>G,1087,1488,2575,4609469,4586423,9195892,0.0002800163377299
WA25,3p,16,A>G,969,970,1939,3375196,3569030,6944226,0.0002792247832947
DAL224,3p,15,A>G,1218,1349,2567,4609400,4586272,9195672,0.0002791530624406
WA22,3p,19,A>G,333,549,882,1513662,1653275,3166937,0.0002785025404673
WA02,5p,5,A>G,1607,2072,3679,6552698,6754258,13306956,0.0002764719444477
WA22,5p,18,A>G,382,493,875,1513651,1653392,3167043,0.0002762829554256
DAL224,5p,10,A>G,1167,1373,2540,4609338,4586470,9195808,0.0002762128134906
WA25,3p,23,A>G,970,937,1907,3375175,3568972,6944147,0.0002746197625136
WA02,3p,16,A>G,1693,1948,3641,6552629,6754119,13306748,0.0002736205720586
WA07,3p,23,A>G,1060,2142,3202,5691568,6013670,11705238,0.0002735527462149
WA25,3p,25,A>G,796,1101,1897,3375156,3568970,6944126,0.0002731805269662
WA07,5p,5,A>G,1947,1249,3196,5691729,6013978,11705707,0.0002730292155783
WA26,3p,17,A>G,865,663,1528,2709570,2900078,5609648,0.0002723878574912
WA08,3p,9,A>G,1613,2192,3805,6798103,7189051,13987154,0.0002720353261285
DAL227,5p,20,A>G,800,1250,2050,3765254,3771167,7536421,0.0002720124048271
DAL212,5p,8,A>G,1087,1123,2210,4131248,4008153,8139401,0.0002715187518098
WA07,5p,20,A>G,1435,1736,3171,5691421,6013876,11705297,0.0002709029937471
WA22,5p,20,A>G,311,539,850,1513678,1653356,3167034,0.0002683899194009
WA02,3p,13,A>G,1540,2020,3560,6552675,6754177,13306852,0.0002675313440023
DAL227,5p,24,A>G,675,1332,2007,3765270,3771180,7536450,0.0002663057540353
WA14,3p,5,A>G,1697,1980,3677,6684341,7140970,13825311,0.0002659614673405
WA22,5p,19,A>G,357,482,839,1513674,1653350,3167024,0.0002649174745755
WA07,3p,25,A>G,1440,1660,3100,5691455,6013662,11705117,0.0002648414364418
WA22,3p,14,A>G,259,579,838,1513686,1653352,3167038,0.0002646005510511
WA08,3p,8,A>G,1844,1857,3701,6798110,7189053,13987163,0.0002645997619388
WA02,3p,9,A>G,1557,1953,3510,6552688,6754191,13306879,0.0002637733461016
WA07,5p,17,A>G,1664,1417,3081,5691561,6013916,11705477,0.0002632101195021
WA22,3p,23,A>G,283,547,830,1513676,1653329,3167005,0.0002620772622714
WA22,5p,8,A>G,168,661,829,1513692,1653397,3167089,0.0002617545638913
DAL195,3p,7,A>G,611,601,1212,2363278,2267461,4630739,0.0002617292833821
DAL224,3p,25,A>G,1193,1207,2400,4609265,4586173,9195438,0.0002609989866714
WA25,3p,15,A>G,970,842,1812,3375218,3569039,6944257,0.0002609350431586
WA25,3p,21,A>G,794,1016,1810,3375199,3568998,6944197,0.0002606492874554
WA02,3p,11,A>G,1600,1858,3458,6552667,6754202,13306869,0.0002598657881128
WA25,3p,18,A>G,874,929,1803,3375213,3569006,6944219,0.0002596404289668
WA25,5p,14,A>G,894,909,1803,3375151,3569071,6944222,0.0002596403167986
WA07,5p,25,A>G,1489,1543,3032,5691334,6013719,11705053,0.0002590334276999
DAL227,5p,15,A>G,883,1068,1951,3765318,3771201,7536519,0.0002588728297507
DAL224,3p,12,A>G,1130,1250,2380,4609458,4586384,9195842,0.0002588126242273
DAL224,5p,11,A>G,1024,1355,2379,4609388,4586469,9195857,0.0002587034574374
WA25,3p,22,A>G,831,964,1795,3375179,3568994,6944173,0.0002584901038611
DAL212,5p,6,A>G,969,1134,2103,4131322,4008153,8139475,0.0002583704722970
WA07,5p,22,A>G,1561,1460,3021,5691396,6013861,11705257,0.0002580891645523
WA22,5p,14,A>G,308,508,816,1513677,1653376,3167053,0.0002576527768875
WA22,5p,21,A>G,321,495,816,1513690,1653371,3167061,0.0002576521260563
WA07,5p,16,A>G,1541,1473,3014,5691534,6013925,11705459,0.0002574866991546
WA07,3p,16,A>G,1458,1556,3014,5691636,6013850,11705486,0.0002574861052330
WA22,5p,13,A>G,260,554,814,1513697,1653377,3167074,0.0002570195707457
WA22,3p,9,A>G,299,515,814,1513709,1653397,3167106,0.0002570169738556
WA07,3p,22,A>G,1368,1638,3006,5691577,6013736,11705313,0.0002568064604509
WA22,3p,17,A>G,264,548,812,1513671,1653319,3166990,0.0002563948733655
WA02,3p,14,A>G,1467,1940,3407,6552653,6754155,13306808,0.0002560343547453
WA07,5p,11,A>G,1500,1485,2985,5691326,6013942,11705268,0.0002550133837174
WA22,5p,16,A>G,298,507,805,1513668,1653368,3167036,0.0002541808807983
DAL227,3p,7,A>G,587,1328,1915,3765386,3771243,7536629,0.0002540923800282
DAL224,3p,10,A>G,1105,1227,2332,4609461,4586371,9195832,0.0002535931495921
WA22,5p,22,A>G,373,429,802,1513691,1653380,3167071,0.0002532308243168
WA25,5p,6,A>G,842,916,1758,3375244,3569089,6944333,0.0002531560626484
DAL224,5p,12,A>G,1077,1247,2324,4609357,4586464,9195821,0.0002527234925516
WA22,5p,10,A>G,374,426,800,1513705,1653389,3167094,0.0002525974915806
WA26,5p,6,A>G,588,829,1417,2709621,2900126,5609747,0.0002525960618188
WA07,3p,19,A>G,1162,1787,2949,5691628,6013742,11705370,0.0002519356500477
DAL224,3p,20,A>G,1124,1184,2308,4609344,4586225,9195569,0.0002509904498568
WA22,3p,22,A>G,364,426,790,1513684,1653356,3167040,0.0002494442760432
WA22,3p,10,A>G,250,540,790,1513706,1653396,3167102,0.0002494393928582
DAL227,3p,12,A>G,957,918,1875,3765377,3771173,7536550,0.0002487875752167
WA07,3p,12,A>G,1243,1669,2912,5691705,6013884,11705589,0.0002487700533480
WA02,5p,8,A>G,1533,1770,3303,6552655,6754257,13306912,0.0002482168665427
WA22,5p,12,A>G,298,482,780,1513692,1653345,3167037,0.0002462869868586
WA25,3p,13,A>G,903,802,1705,3375230,3569053,6944283,0.0002455257079816
WA02,3p,8,A>G,1492,1773,3265,6552692,6754207,13306899,0.0002453614474717
WA25,3p,11,A>G,721,982,1703,3375233,3569054,6944287,0.0002452375600259
WA22,3p,16,A>G,260,513,773,1513637,1653341,3166978,0.0002440812661155
WA07,5p,15,A>G,1550,1305,2855,5691563,6013633,11705196,0.0002439087735053
WA07,3p,24,A>G,1313,1527,2840,5691554,6013661,11705215,0.0002426268974982
WA07,5p,10,A>G,1457,1372,2829,5691582,6013961,11705543,0.0002416803731360
WA07,3p,11,A>G,1319,1509,2828,5691711,6013883,11705594,0.0002415938909208
DAL195,3p,5,A>G,541,577,1118,2363278,2267461,4630739,0.0002414301475423
WA22,5p,15,A>G,371,393,764,1513695,1653381,3167076,0.0002412319754878
WA22,5p,24,A>G,314,449,763,1513632,1653375,3167007,0.0002409214757024
DAL224,5p,14,A>G,1145,1066,2211,4609270,4586428,9195698,0.0002404385180983
WA22,3p,12,A>G,211,549,760,1513662,1653379,3167041,0.0002399716328269
WA07,5p,12,A>G,1423,1385,2808,5691520,6013938,11705458,0.0002398880932296
DAL224,3p,18,A>G,940,1260,2200,4609363,4586282,9195645,0.0002392436854619
DAL224,5p,7,A>G,1501,694,2195,4609471,4586477,9195948,0.0002386920848182
WA25,3p,10,A>G,819,836,1655,3375240,3569075,6944315,0.0002383244423676
DAL227,3p,9,A>G,728,1068,1796,3765384,3771218,7536602,0.0002383036811549
WA07,5p,9,A>G,1517,1268,2785,5691672,6013971,11705643,0.0002379194376592
WA07,3p,21,A>G,1356,1428,2784,5691611,6013735,11705346,0.0002378400433442
WA02,5p,6,A>G,1434,1716,3150,6552697,6754258,13306955,0.0002367183176015
DAL227,3p,21,A>G,631,1141,1772,3765307,3771104,7536411,0.0002351251809382
WA26,3p,7,A>G,640,670,1310,2709623,2900126,5609749,0.0002335220345865
DAL227,5p,25,A>G,640,1116,1756,3765247,3771148,7536395,0.0002330026491445
DAL227,3p,17,A>G,815,940,1755,3765328,3771049,7536377,0.0002328705158990
DAL224,3p,7,A>G,1205,921,2126,4609472,4586476,9195948,0.0002311887801018
WA07,5p,24,A>G,1390,1312,2702,5691332,6013785,11705117,0.0002308392133115
WA25,3p,9,A>G,709,892,1601,3375240,3569076,6944316,0.0002305482642206
DAL195,5p,7,A>G,556,509,1065,2363277,2267461,4630738,0.0002299849397655
WA07,5p,14,A>G,1429,1258,2687,5691556,6013950,11705506,0.0002295500937763
WA25,5p,8,A>G,889,705,1594,3375221,3569088,6944309,0.0002295404769574
WA22,5p,11,A>G,312,412,724,1513699,1653381,3167080,0.0002286017404044
WA07,3p,9,A>G,1089,1586,2675,5691720,6013901,11705621,0.0002285226900819
WA08,5p,6,A>G,1499,1688,3187,6798112,7189085,13987197,0.0002278512270900
DAL227,5p,18,A>G,853,862,1715,3765280,3771169,7536449,0.0002275607517545
DAL195,5p,8,A>G,579,473,1052,2363212,2267460,4630672,0.0002271808497773
WA25,3p,20,A>G,743,834,1577,3375190,3568979,6944169,0.0002270970075757
DAL227,5p,21,A>G,740,965,1705,3765270,3771169,7536439,0.0002262341670913
WA22,3p,15,A>G,278,436,714,1513677,1653343,3167020,0.0002254485289009
WA25,3p,12,A>G,692,870,1562,3375226,3569069,6944295,0.0002249328405547
WA07,3p,17,A>G,1051,1577,2628,5691662,6013813,11705475,0.0002245103252964
WA07,3p,13,A>G,1011,1604,2615,5691711,6013848,11705559,0.0002233981307513
DAL227,3p,10,A>G,625,1057,1682,3765382,3771209,7536591,0.0002231778266858
WA07,5p,6,A>G,1294,1310,2604,5691728,6013979,11705707,0.0002224555936689
DAL227,5p,16,A>G,916,760,1676,3765316,3771188,7536504,0.0002223842779092
WA25,3p,17,A>G,693,849,1542,3375198,3569022,6944220,0.0002220551768233
WA07,3p,15,A>G,1141,1458,2599,5691211,6013856,11705067,0.0002220405914805
WA25,5p,7,A>G,883,654,1537,3375242,3569089,6944331,0.0002213316156732
DAL224,3p,17,A>G,1032,992,2024,4609381,4586216,9195597,0.0002201053395445
DAL195,5p,6,A>G,531,482,1013,2363277,2267461,4630738,0.0002187556281525
WA07,5p,13,A>G,1366,1192,2558,5691511,6013949,11705460,0.0002185304977335
WA26,5p,8,A>G,518,707,1225,2709609,2900124,5609733,0.0002183704643340
DAL227,5p,17,A>G,789,854,1643,3765326,3771175,7536501,0.0002180056766395
WA22,5p,17,A>G,283,406,689,1513675,1653395,3167070,0.0002175512382107
DAL224,5p,13,A>G,946,1044,1990,4609320,4586461,9195781,0.0002164035876887
WA08,3p,5,A>G,1121,1904,3025,6798117,7189085,13987202,0.0002162691294513
DAL227,3p,25,A>G,495,1129,1624,3765249,3771100,7536349,0.0002154889589110
WA26,3p,6,A>G,641,566,1207,2709623,2900126,5609749,0.0002151611417908
WA22,3p,13,A>G,167,514,681,1513689,1653380,3167069,0.0002150253120471
DAL227,3p,18,A>G,570,1048,1618,3765321,3771036,7536357,0.0002146925895362
WA26,5p,7,A>G,537,660,1197,2709622,2900126,5609748,0.0002133785688768
DAL227,5p,12,A>G,807,799,1606,3765326,3771232,7536558,0.0002130946248937
WA02,3p,6,A>G,1162,1668,2830,6552698,6754257,13306955,0.0002126707424801
DAL224,5p,9,A>G,1011,944,1955,4609357,4586473,9195830,0.0002125963616117
WA02,3p,7,A>G,1150,1673,2823,6552698,6754257,13306955,0.0002121447017743
WA02,3p,5,A>G,1278,1540,2818,6552698,6754256,13306954,0.0002117689743272
WA07,3p,10,A>G,1226,1240,2466,5691718,6013892,11705610,0.0002106682180595
WA22,3p,11,A>G,207,457,664,1513685,1653390,3167075,0.0002096571757852
DAL227,3p,8,A>G,463,1109,1572,3765386,3771207,7536593,0.0002085823129894
DAL227,5p,5,A>G,804,764,1568,3765386,3771242,7536628,0.0002080506030017
DAL224,5p,8,A>G,1095,818,1913,4609397,4586477,9195874,0.0002080280786796
DAL227,5p,14,A>G,743,821,1564,3765297,3771226,7536523,0.0002075227528662
DAL224,3p,11,A>G,916,988,1904,4609461,4586382,9195843,0.0002070500768662
WA08,3p,6,A>G,1293,1593,2886,6798117,7189085,13987202,0.0002063314735856
WA22,5p,6,A>G,221,432,653,1513704,1653397,3167101,0.0002061822467928
WA25,3p,8,A>G,682,744,1426,3375239,3569076,6944315,0.0002053478276835
WA26,3p,5,A>G,691,449,1140,2709623,2900126,5609749,0.0002032176484188
DAL227,3p,6,A>G,626,903,1529,3765386,3771243,7536629,0.0002028758480747
DAL227,5p,23,A>G,616,910,1526,3765254,3771157,7536411,0.0002024836490472
DAL227,5p,9,A>G,727,799,1526,3765324,3771243,7536567,0.0002024794578221
DAL212,5p,7,A>G,749,897,1646,4131322,4008153,8139475,0.0002022243449362
DAL227,3p,23,A>G,660,863,1523,3765319,3771112,7536431,0.0002020850452953
DAL224,3p,5,A>G,1197,652,1849,4609472,4586477,9195949,0.0002010667958249
WA07,3p,20,A>G,1142,1204,2346,5691604,6013772,11705376,0.0002004207297569
WA02,5p,7,A>G,1300,1363,2663,6552685,6754258,13306943,0.0002001210946796
WA25,3p,7,A>G,759,628,1387,3375244,3569089,6944333,0.0001997312052863
DAL227,5p,22,A>G,583,904,1487,3765253,3771158,7536411,0.0001973087720401
DAL227,5p,19,A>G,624,862,1486,3765279,3771164,7536443,0.0001971752456696
WA22,3p,8,A>G,123,499,622,1513709,1653395,3167104,0.0001963939295962
DAL227,3p,13,A>G,576,889,1465,3765373,3771183,7536556,0.0001943858706815
DAL192,5p,23,A>G,1528,903,2431,6349801,6167567,12517368,0.0001942101566399
WA08,3p,7,A>G,1311,1353,2664,6798117,7189084,13987201,0.0001904598353880
WA07,3p,14,A>G,987,1242,2229,5691695,6013877,11705572,0.0001904221340059
DAL227,5p,13,A>G,740,687,1427,3765325,3771231,7536556,0.0001893437798378
DAL224,3p,6,A>G,890,846,1736,4609472,4586477,9195949,0.0001887787763938
WA07,3p,7,A>G,961,1230,2191,5691729,6013979,11705708,0.0001871736421239
WA07,3p,8,A>G,1115,1061,2176,5691713,6013800,11705513,0.0001858953127470
DAL227,3p,20,A>G,651,747,1398,3765308,3771082,7536390,0.0001854999542221
WA07,3p,6,A>G,1082,1056,2138,5691729,6013979,11705708,0.0001826459364952
DAL227,3p,16,A>G,576,791,1367,3765340,3771079,7536419,0.0001813858810132
DAL227,3p,19,A>G,634,731,1365,3765313,3771111,7536424,0.0001811203828234
DAL227,5p,10,A>G,742,618,1360,3765318,3771238,7536556,0.0001804537775609
WA07,5p,8,A>G,1130,966,2096,5691579,6013975,11705554,0.0001790602990682
WA22,5p,9,A>G,179,386,565,1513700,1653389,3167089,0.0001783972600706
WA25,3p,6,A>G,528,700,1228,3375244,3569089,6944333,0.0001768348378454
WA25,3p,5,A>G,612,609,1221,3375244,3569089,6944333,0.0001758268216688
DAL227,5p,11,A>G,691,631,1322,3765365,3771237,7536602,0.0001754106160840
WA07,3p,5,A>G,1214,835,2049,5691729,6013979,11705708,0.0001750428081752
WA09,5p,4,A>G,661,1005,1666,4741672,4881751,9623423,0.0001731192736721
WA22,3p,7,A>G,176,368,544,1513709,1653397,3167106,0.0001717656434612
WA07,5p,7,A>G,1163,812,1975,5691728,6013979,11705707,0.0001687211203902
DAL227,3p,14,A>G,462,802,1264,3765341,3771166,7536507,0.0001677169542866
WA22,3p,6,A>G,208,322,530,1513709,1653397,3167106,0.0001673452041074
DAL227,3p,11,A>G,559,696,1255,3765378,3771214,7536592,0.0001665208890172
DAL224,5p,6,A>G,714,810,1524,4609472,4586477,9195949,0.0001657251470185
WA22,3p,5,A>G,142,382,524,1513709,1653397,3167106,0.0001654507300987
DAL192,5p,17,A>G,899,1150,2049,6349778,6167623,12517401,0.0001636921274632
DAL192,3p,12,A>G,850,1186,2036,6349997,6167646,12517643,0.0001626504286789
DAL227,3p,5,A>G,501,719,1220,3765386,3771243,7536629,0.0001618760854488
DAL224,3p,4,A>G,355,1108,1463,4609472,4586477,9195949,0.0001590917913964
DAL192,5p,20,A>G,885,1057,1942,6349836,6167621,12517457,0.0001551433330268
WA03,5p,4,A>G,894,783,1677,5399458,5543742,10943200,0.0001532458513049
DAL192,5p,24,A>G,863,1037,1900,6349759,6167564,12517323,0.0001517896438399
DAL192,3p,21,A>G,1186,712,1898,6349882,6167507,12517389,0.0001516290657740
DAL192,3p,15,A>G,1102,790,1892,6349968,6167615,12517583,0.0001511473900352
DAL192,5p,5,A>G,684,1184,1868,6350003,6167707,12517710,0.0001492285729578
DAL192,5p,25,A>G,816,1041,1857,6349777,6167551,12517328,0.0001483543452724
DAL192,5p,15,A>G,919,936,1855,6349890,6167649,12517539,0.0001481920687445
DAL192,5p,21,A>G,884,959,1843,6349784,6167624,12517408,0.0001472349547126
DAL192,5p,16,A>G,1125,713,1838,6349904,6167639,12517543,0.0001468339273929
WA22,5p,7,A>G,118,347,465,1513707,1653397,3167104,0.0001468218283959
DAL192,3p,24,A>G,687,1077,1764,6349899,6167465,12517364,0.0001409242393206
WA03,3p,4,A>G,750,770,1520,5399458,5543736,10943194,0.0001388991184840
DAL192,3p,23,A>G,987,741,1728,6349902,6167465,12517367,0.0001380482013509
DAL227,5p,6,A>G,491,540,1031,3765386,3771243,7536629,0.0001367985607358
DAL192,5p,11,A>G,770,929,1699,6349942,6167706,12517648,0.0001357283732535
DAL227,5p,8,A>G,425,583,1008,3765342,3771242,7536584,0.0001337475970545
DAL192,5p,18,A>G,872,799,1671,6349859,6167631,12517490,0.0001334932162917
WA18,5p,4,A>G,1959,1776,3735,14112928,14131239,28244167,0.0001322396939516
DAL192,5p,19,A>G,853,796,1649,6349822,6167638,12517460,0.0001317359911675
DAL192,3p,9,A>G,765,863,1628,6350003,6167637,12517640,0.0001300564643175
DAL192,3p,18,A>G,668,953,1621,6349922,6167564,12517486,0.0001294988466533
DAL192,3p,25,A>G,831,772,1603,6349856,6167384,12517240,0.0001280633749932
DAL192,5p,22,A>G,745,852,1597,6349783,6167584,12517367,0.0001275827416420
WA13,5p,19,A>G,615,913,1528,5896797,6081472,11978269,0.0001275643417258
DAL192,3p,16,A>G,944,634,1578,6349943,6167587,12517530,0.0001260632089557
DAL192,3p,17,A>G,776,791,1567,6349922,6167606,12517528,0.0001251844613409
WA09,3p,4,A>G,593,575,1168,4741672,4881748,9623420,0.0001213705730395
WA03,3p,3,A>G,845,471,1316,5399458,5543742,10943200,0.0001202573287521
DAL192,5p,9,A>G,703,802,1505,6349914,6167708,12517622,0.0001202305038448
DAL192,5p,12,A>G,667,813,1480,6349906,6167700,12517606,0.0001182334705214
DAL192,3p,14,A>G,860,612,1472,6349967,6167610,12517577,0.0001175946431166
DAL192,3p,20,A>G,751,713,1464,6349910,6167516,12517426,0.0001169569526514
WA12,5p,4,A>G,631,941,1572,6632242,6940679,13572921,0.0001158188425321
DAL192,3p,10,A>G,705,734,1439,6350003,6167645,12517648,0.0001149576981234
DAL192,3p,19,A>G,651,766,1417,6349921,6167519,12517440,0.0001132020604852
DAL192,3p,11,A>G,509,867,1376,6349987,6167644,12517631,0.0001099249530522
DAL192,3p,13,A>G,719,651,1370,6349992,6167621,12517613,0.0001094457865089
DAL192,5p,13,A>G,622,747,1369,6349906,6167705,12517611,0.0001093659165474
DAL227,5p,7,A>G,364,446,810,3765386,3771243,7536629,0.0001074751059127
DAL192,3p,8,A>G,819,490,1309,6350003,6167618,12517621,0.0001045725861168
DAL192,5p,10,A>G,784,524,1308,6349896,6167708,12517604,0.0001044928406426
DAL193,5p,4,A>G,694,642,1336,6484403,6362696,12847099,0.0001039923487785
WA13,5p,18,A>G,731,500,1231,5896796,6081504,11978300,0.0001027691742567
WA11,5p,4,A>G,1111,908,2019,9756638,10108269,19864907,0.0001016365191138
WA13,5p,25,A>G,323,877,1200,5896769,6081462,11978231,0.0001001817380212
WA09,5p,3,A>G,373,583,956,4741672,4881750,9623422,0.0000993409620819
DAL192,3p,22,A>G,595,629,1224,6349894,6167488,12517382,0.0000977840254456
DAL192,5p,14,A>G,639,558,1197,6349889,6167679,12517568,0.0000956256039512
DAL218,3p,3,A>G,158,1123,1281,6952891,6658030,13610921,0.0000941156002595
WA26,3p,4,A>G,429,97,526,2709623,2900126,5609749,0.0000937653360248
WA26,5p,4,A>G,194,330,524,2709623,2900126,5609749,0.0000934088138346
DAL192,3p,5,A>G,660,462,1122,6350003,6167708,12517711,0.0000896330007938
WA13,5p,15,A>G,524,500,1024,5896798,6081508,11978306,0.0000854878811745
WA13,5p,23,A>G,471,550,1021,5896768,6081501,11978269,0.0000852376916898
WA03,5p,3,A>G,472,456,928,5399457,5543742,10943199,0.0000848015283282
WA12,3p,4,A>G,433,716,1149,6632243,6940676,13572919,0.0000846538611186
DAL192,5p,6,A>G,449,607,1056,6350002,6167707,12517709,0.0000843604848140
WA13,5p,16,A>G,448,553,1001,5896754,6081491,11978245,0.0000835681687927
WA08,5p,4,A>G,378,787,1165,6798115,7189085,13987200,0.0000832904369709
WA09,3p,3,A>G,350,437,787,4741672,4881751,9623423,0.0000817796328811
WA13,5p,14,A>G,443,523,966,5896802,6081520,11978322,0.0000806456864325
WA13,5p,22,A>G,484,479,963,5896771,6081483,11978254,0.0000803956903903
WA13,5p,20,A>G,447,516,963,5896788,6081482,11978270,0.0000803955830016
DAL192,3p,6,A>G,491,512,1003,6350003,6167708,12517711,0.0000801264704066
WA14,5p,4,A>G,594,499,1093,6684341,7140972,13825313,0.0000790578846208
DAL218,5p,4,A>G,593,479,1072,6952891,6658031,13610922,0.0000787602779591
DAL193,3p,4,A>G,506,491,997,6484405,6362696,12847101,0.0000776050565805
DAL192,3p,7,A>G,499,465,964,6350003,6167708,12517711,0.0000770108848175
WA18,3p,4,A>G,765,1355,2120,14112928,14131238,28244166,0.0000750597486221
DAL192,5p,8,A>G,464,475,939,6349926,6167708,12517634,0.0000750141760016
WA13,3p,10,A>G,409,488,897,5896843,6081517,11978360,0.0000748850426937
WA13,5p,5,A>G,385,500,885,5896841,6081528,11978369,0.0000738831805899
WA13,3p,25,A>G,443,440,883,5896783,6081437,11978220,0.0000737171299241
WA13,5p,9,A>G,413,468,881,5896837,6081518,11978355,0.0000735493312730
WA13,5p,11,A>G,447,432,879,5896827,6081513,11978340,0.0000733824553319
WA13,5p,12,A>G,498,374,872,5896822,6081502,11978324,0.0000727981644177
WA13,3p,9,A>G,384,487,871,5896842,6081517,11978359,0.0000727144678165
WA13,5p,10,A>G,410,460,870,5896833,6081518,11978351,0.0000726310324351
WA13,3p,21,A>G,423,431,854,5896824,6081466,11978290,0.0000712956523844
WA13,5p,6,A>G,369,475,844,5896841,6081528,11978369,0.0000704603439750
DAL227,3p,4,A>G,300,220,520,3765386,3771243,7536629,0.0000689963642897
DAL224,3p,3,A>G,255,379,634,4609472,4586477,9195949,0.0000689434010563
WA13,5p,17,A>G,411,412,823,5896805,6081514,11978319,0.0000687074705558
WA13,5p,21,A>G,396,425,821,5896782,6081484,11978266,0.0000685408054889
WA02,5p,4,A>G,467,443,910,6552698,6754258,13306956,0.0000683852866125
WA13,3p,18,A>G,285,520,805,5896827,6081499,11978326,0.0000672047162517
WA13,3p,19,A>G,367,430,797,5896822,6081480,11978302,0.0000665369766099
WA13,3p,12,A>G,358,419,777,5896836,6081505,11978341,0.0000648670796732
WA13,3p,23,A>G,424,348,772,5896819,6081454,11978273,0.0000644500254753
WA13,5p,13,A>G,357,397,754,5896809,6081508,11978317,0.0000629470734495
WA25,5p,4,A>G,246,191,437,3375243,3569089,6944332,0.0000629290189467
WA13,3p,24,A>G,361,372,733,5896803,6081440,11978243,0.0000611942836691
WA12,5p,3,A>G,426,401,827,6632242,6940678,13572920,0.0000609301462029
DAL218,3p,4,A>G,350,479,829,6952891,6658031,13610922,0.0000609069686829
WA25,3p,4,A>G,287,133,420,3375244,3569087,6944331,0.0000604809880174
WA13,3p,22,A>G,418,306,724,5896824,6081460,11978284,0.0000604427144990
WA13,3p,11,A>G,318,387,705,5896841,6081492,11978333,0.0000588562699000
DAL227,3p,3,A>G,243,185,428,3765386,3771243,7536629,0.0000567893152230
DAL192,5p,7,A>G,437,270,707,6350002,6167708,12517710,0.0000564799791655
WA13,3p,16,A>G,318,356,674,5896830,6081509,11978339,0.0000562682355208
DAL227,5p,4,A>G,207,217,424,3765385,3771243,7536628,0.0000562585814239
WA07,5p,4,A>G,402,253,655,5691728,6013979,11705707,0.0000559556120788
WA13,3p,13,A>G,338,331,669,5896834,6081495,11978329,0.0000558508620025
DAL195,3p,3,A>G,202,55,257,2363278,2267461,4630739,0.0000554987011792
WA11,5p,3,A>G,473,625,1098,9756642,10108269,19864911,0.0000552733410182
WA13,3p,15,A>G,282,377,659,5896825,6081505,11978330,0.0000550160164230
WA08,3p,4,A>G,492,275,767,6798117,7189081,13987198,0.0000548358577608
WA22,5p,4,A>G,77,96,173,1513709,1653397,3167106,0.0000546240005860
WA11,3p,4,A>G,486,598,1084,9756642,10108267,19864909,0.0000545685862442
DAL193,3p,3,A>G,388,311,699,6484405,6362696,12847101,0.0000544091620359
WA18,3p,3,A>G,671,865,1536,14112928,14131239,28244167,0.0000543829102837
WA13,3p,20,A>G,319,315,634,5896818,6081448,11978266,0.0000529291969305
WA09,5p,2,A>G,215,293,508,4741495,4881667,9623162,0.0000527893014791
WA13,5p,8,A>G,377,253,630,5896843,6081526,11978369,0.0000525948065217
WA13,3p,14,A>G,321,307,628,5896832,6081501,11978333,0.0000524279964499
WA03,5p,2,A>G,342,230,572,5399258,5543638,10942896,0.0000522713548589
WA11,3p,2,A>G,908,109,1017,9756642,10108269,19864911,0.0000511957994677
DAL195,5p,4,A>G,71,164,235,2363278,2267461,4630739,0.0000507478395997
WA13,3p,17,A>G,295,308,603,5896823,6081499,11978322,0.0000503409409098
WA14,3p,4,A>G,313,375,688,6684341,7140971,13825312,0.0000497637955657
WA18,5p,3,A>G,979,409,1388,14112928,14131239,28244167,0.0000491428902824
WA13,3p,8,A>G,265,305,570,5896845,6081521,11978366,0.0000475857892470
WA09,5p,1,A>G,170,287,457,4741672,4881751,9623423,0.0000474883001610
WA13,3p,7,A>G,254,312,566,5896847,6081528,11978375,0.0000472518183810
WA12,3p,3,A>G,258,376,634,6632243,6940679,13572922,0.0000467106493355
WA13,3p,5,A>G,215,344,559,5896847,6081527,11978374,0.0000466674358306
WA13,3p,6,A>G,306,244,550,5896847,6081528,11978375,0.0000459160779321
WA02,3p,4,A>G,274,329,603,6552698,6754256,13306954,0.0000453146527748
WA25,3p,3,A>G,80,234,314,3375244,3569089,6944333,0.0000452167256380
WA12,5p,2,A>G,363,240,603,6631949,6940524,13572473,0.0000444281598497
WA03,5p,1,A>G,208,275,483,5399457,5543742,10943199,0.0000441370023519
WA02,3p,3,A>G,253,327,580,6552698,6754258,13306956,0.0000435862266321
WA07,3p,3,A>G,358,149,507,5691729,6013979,11705708,0.0000433122029014
WA18,5p,2,A>G,785,433,1218,14112820,14131183,28244003,0.0000431241987901
WA11,3p,3,A>G,440,411,851,9756642,10108269,19864911,0.0000428393562901
DAL193,5p,3,A>G,255,292,547,6484400,6362696,12847096,0.0000425777156176
WA22,3p,4,A>G,43,89,132,1513709,1653394,3167103,0.0000416784676722
DAL212,5p,4,A>G,152,183,335,4131322,4008153,8139475,0.0000411574456584
WA14,3p,3,A>G,245,310,555,6684341,7140972,13825313,0.0000401437566007
WA08,5p,3,A>G,259,301,560,6798117,7189084,13987201,0.0000400366020335
DAL212,3p,4,A>G,137,187,324,4131322,4008153,8139475,0.0000398060071442
DAL192,5p,4,A>G,223,272,495,6350003,6167708,12517711,0.0000395439709385
WA14,5p,3,A>G,326,212,538,6684338,7140972,13825310,0.0000389141364642
DAL224,5p,4,A>G,178,177,355,4609471,4586477,9195948,0.0000386039590481
WA02,5p,3,A>G,293,205,498,6552698,6754258,13306956,0.0000374240359704
WA13,5p,7,A>G,261,179,440,5896845,6081528,11978373,0.0000367328684789
WA18,5p,1,A>G,625,394,1019,14112926,14131239,28244165,0.0000360782483745
WA08,3p,3,A>G,229,260,489,6798117,7189085,13987202,0.0000349605303477
DAL195,3p,4,A>G,68,91,159,2363278,2267461,4630739,0.0000343357723249
WA09,3p,2,A>G,133,193,326,4741672,4881751,9623423,0.0000338756802024
DAL218,5p,3,A>G,275,180,455,6952891,6658031,13610922,0.0000334290358875
WA07,3p,4,A>G,196,195,391,5691729,6013979,11705708,0.0000334025075630
WA12,5p,1,A>G,278,175,453,6632243,6940679,13572922,0.0000333752746829
WA11,5p,1,A>G,409,244,653,9756641,10108269,19864910,0.0000328720341547
WA22,3p,3,A>G,56,40,96,1513709,1653396,3167105,0.0000303115937110
WA07,5p,3,A>G,252,98,350,5691729,6013979,11705708,0.0000298999428313
WA26,5p,3,A>G,106,61,167,2709623,2900126,5609749,0.0000297696028824
DAL212,3p,3,A>G,137,105,242,4131322,4008153,8139475,0.0000297316473114
WA25,5p,3,A>G,146,58,204,3375243,3569089,6944332,0.0000293764756639
WA03,3p,2,A>G,173,143,316,5399458,5543742,10943200,0.0000288763798523
DAL227,5p,3,A>G,56,155,211,3765386,3771243,7536629,0.0000279966016637
WA02,5p,1,A>G,153,206,359,6552698,6754258,13306956,0.0000269783713120
WA13,5p,4,A>G,203,114,317,5896841,6081528,11978369,0.0000264643709006
WA08,5p,1,A>G,169,188,357,6798116,7189085,13987201,0.0000255233337964
WA26,3p,3,A>G,84,54,138,2709623,2900126,5609749,0.0000246000311244
WA11,5p,2,A>G,338,148,486,9756471,10108196,19864667,0.0000244655498126
WA08,5p,2,A>G,215,127,342,6797941,7188997,13986938,0.0000244513845704
WA02,5p,2,A>G,214,110,324,6552562,6754179,13306741,0.0000243485613795
DAL192,3p,4,A>G,116,176,292,6350003,6167708,12517711,0.0000233269485132
DAL193,3p,2,A>G,76,205,281,6484402,6362696,12847098,0.0000218726439232
DAL224,5p,3,A>G,74,127,201,4609468,4586477,9195945,0.0000218574600000
DAL212,5p,3,A>G,43,134,177,4131321,4008153,8139474,0.0000217458769449
WA12,3p,2,A>G,120,168,288,6632243,6940679,13572922,0.0000212187176792
WA03,3p,1,A>G,169,61,230,5399458,5543742,10943200,0.0000210176182469
DAL218,5p,2,A>G,115,151,266,6952874,6658014,13610888,0.0000195431774914
WA09,3p,1,A>G,126,62,188,4741672,4881751,9623423,0.0000195356683376
WA26,5p,1,A>G,43,66,109,2709622,2900126,5609748,0.0000194304628301
WA26,3p,2,A>G,77,30,107,2709623,2900126,5609749,0.0000190739371762
DAL193,5p,2,A>G,116,123,239,6484386,6362681,12847067,0.0000186034680134
DAL227,3p,2,A>G,35,99,134,3765386,3771243,7536629,0.0000177798323362
DAL192,3p,3,A>G,114,106,220,6350003,6167708,12517711,0.0000175750981949
WA02,3p,2,A>G,84,145,229,6552698,6754258,13306956,0.0000172090446530
WA25,3p,1,A>G,104,15,119,3375244,3569089,6944333,0.0000171362750029
DAL193,5p,1,A>G,39,178,217,6484405,6362696,12847101,0.0000168909701885
WA26,5p,2,A>G,76,15,91,2709554,2900092,5609646,0.0000162220575059
WA07,5p,2,A>G,156,25,181,5691636,6013923,11705559,0.0000154627386868
WA07,5p,1,A>G,133,36,169,5691729,6013979,11705708,0.0000144374009671
WA25,5p,2,A>G,70,25,95,3375147,3569045,6944192,0.0000136804973134
WA14,5p,1,A>G,79,109,188,6684341,7140972,13825313,0.0000135982454791
DAL227,5p,2,A>G,29,71,100,3765373,3771238,7536611,0.0000132685632839
WA25,5p,1,A>G,64,28,92,3375244,3569089,6944333,0.0000132482126073
DAL218,3p,2,A>G,97,79,176,6952891,6658031,13610922,0.0000129307919037
WA14,5p,2,A>G,129,49,178,6684184,7140911,13825095,0.0000128751375669
WA08,3p,2,A>G,66,109,175,6798117,7189085,13987202,0.0000125114372410
WA13,5p,3,A>G,109,35,144,5896847,6081528,11978375,0.0000120216640404
WA13,5p,1,A>G,94,46,140,5896847,6081528,11978375,0.0000116877289282
WA18,3p,2,A>G,196,134,330,14112928,14131239,28244167,0.0000116838283813
WA22,5p,3,A>G,11,26,37,1513709,1653397,3167106,0.0000116825897207
DAL218,5p,1,A>G,73,82,155,6952891,6658031,13610922,0.0000113879133243
DAL195,5p,3,A>G,25,27,52,2363278,2267459,4630737,0.0000112293140379
WA13,3p,4,A>G,51,82,133,5896847,6081522,11978369,0.0000111033480435
DAL193,3p,1,A>G,73,65,138,6484405,6362696,12847101,0.0000107417229770
WA13,5p,2,A>G,111,17,128,5896725,6081443,11978168,0.0000106861082596
WA25,3p,2,A>G,64,10,74,3375244,3569089,6944333,0.0000106561710102
WA12,3p,1,A>G,88,51,139,6632243,6940679,13572922,0.0000102409783243
WA13,3p,3,A>G,68,46,114,5896847,6081528,11978375,0.0000095171506987
WA22,5p,1,A>G,13,17,30,1513709,1653397,3167106,0.0000094723700438
DAL224,5p,2,A>G,46,40,86,4609461,4586469,9195930,0.0000093519633142
WA02,3p,1,A>G,70,48,118,6552698,6754258,13306956,0.0000088675426596
WA08,3p,1,A>G,88,36,124,6798117,7189085,13987202,0.0000088652469593
WA22,5p,2,A>G,9,18,27,1513674,1653378,3167052,0.0000085252783977
DAL195,3p,2,A>G,21,17,38,2363278,2267460,4630738,0.0000082060354095
WA11,3p,1,A>G,108,53,161,9756642,10108269,19864911,0.0000081047430819
WA07,3p,2,A>G,61,33,94,5691729,6013979,11705708,0.0000080302703604
WA18,3p,1,A>G,148,75,223,14112928,14131239,28244167,0.0000078954355425
WA22,3p,1,A>G,14,11,25,1513709,1653397,3167106,0.0000078936417032
DAL227,5p,1,A>G,21,36,57,3765386,3771243,7536629,0.0000075630630087
WA14,3p,2,A>G,64,40,104,6684341,7140972,13825313,0.0000075224336693
DAL195,5p,2,A>G,24,10,34,2363264,2267447,4630711,0.0000073422850184
DAL192,5p,3,A>G,45,45,90,6350003,6167707,12517710,0.0000071898134723
WA14,3p,1,A>G,42,56,98,6684341,7140972,13825313,0.0000070884471115
DAL218,3p,1,A>G,51,43,94,6952891,6658031,13610922,0.0000069062184031
DAL212,3p,2,A>G,18,37,55,4131322,4008153,8139475,0.0000067571925708
DAL224,3p,2,A>G,35,27,62,4609471,4586476,9195947,0.0000067421006232
WA26,3p,1,A>G,18,17,35,2709623,2900126,5609749,0.0000062391383286
DAL192,3p,2,A>G,28,50,78,6350003,6167706,12517709,0.0000062311721738
WA22,3p,2,A>G,10,9,19,1513709,1653396,3167105,0.0000059991695886
DAL227,3p,1,A>G,12,32,44,3765386,3771243,7536629,0.0000058381539014
WA07,3p,1,A>G,35,28,63,5691729,6013979,11705708,0.0000053819897096
DAL224,5p,1,A>G,7,41,48,4609472,4586477,9195949,0.0000052196896699
DAL212,5p,2,A>G,18,23,41,4131307,4008143,8139450,0.0000050371953879
DAL224,3p,1,A>G,22,23,45,4609472,4586477,9195949,0.0000048934590655
DAL192,5p,2,A>G,27,30,57,6349992,6167694,12517686,0.0000045535572629
DAL195,5p,1,A>G,11,10,21,2363278,2267461,4630739,0.0000045349133259
WA13,3p,2,A>G,22,31,53,5896847,6081528,11978375,0.0000044246402371
DAL212,5p,1,A>G,11,21,32,4131322,4008153,8139475,0.0000039314574957
DAL192,5p,1,A>G,10,38,48,6350003,6167708,12517711,0.0000038345668789
DAL192,3p,1,A>G,24,8,32,6350003,6167708,12517711,0.0000025563779193
WA13,3p,1,A>G,19,11,30,5896847,6081528,11978375,0.0000025045133418
DAL195,3p,1,A>G,8,1,9,2363278,2267461,4630739,0.0000019435342825
DAL212,3p,1,A>G,3,6,9,4131322,4008153,8139475,0.0000011057224207