Sample,End,Position,Substitution,Pos_Count,Neg_Count,Combined_Count,Pos_Total,Neg_Total,Combined_Total,Frequency
DAL192,3p,1,A>-,0,0,0,6350003,6167708,12517711,0.0
DAL192,3p,2,A>-,0,0,0,6350003,6167706,12517709,0.0
DAL192,3p,3,A>-,0,0,0,6350003,6167708,12517711,0.0
DAL192,3p,4,A>-,0,0,0,6350003,6167708,12517711,0.0
DAL192,3p,5,A>-,0,0,0,6350003,6167708,12517711,0.0
DAL192,3p,6,A>-,0,0,0,6350003,6167708,12517711,0.0
DAL192,3p,7,A>-,0,0,0,6350003,6167708,12517711,0.0
DAL192,3p,8,A>-,0,0,0,6350003,6167618,12517621,0.0
DAL192,3p,9,A>-,1,7,8,6350003,6167637,12517640,6.390981047545704e-07
DAL192,3p,10,A>-,2,6,8,6350003,6167645,12517648,6.390976963084439e-07
DAL192,3p,11,A>-,4,6,10,6349987,6167644,12517631,7.988732053213584e-07
DAL192,3p,12,A>-,8,8,16,6349997,6167646,12517643,1.2781959031744235e-06
DAL192,3p,13,A>-,8,8,16,6349992,6167621,12517613,1.2781989665282031e-06
DAL192,3p,14,A>-,3,9,12,6349967,6167610,12517577,9.586519819290903e-07
DAL192,3p,15,A>-,15,8,23,6349968,6167615,12517583,1.8374154179764576e-06
DAL192,3p,16,A>-,11,9,20,6349943,6167587,12517530,1.5977593023543782e-06
DAL192,3p,17,A>-,21,11,32,6349922,6167606,12517528,2.5564152922206366e-06
DAL192,3p,18,A>-,22,11,33,6349922,6167564,12517486,2.636312115707579e-06
DAL192,3p,19,A>-,18,14,32,6349921,6167519,12517440,2.556433264309635e-06
DAL192,3p,20,A>-,34,10,44,6349910,6167516,12517426,3.5150996698522524e-06
DAL192,3p,21,A>-,34,20,54,6349882,6167507,12517389,4.313998710114385e-06
DAL192,3p,22,A>-,27,20,47,6349894,6167488,12517382,3.754778754854649e-06
DAL192,3p,23,A>-,41,38,79,6349902,6167465,12517367,6.311231427503883e-06
DAL192,3p,24,A>-,40,36,76,6349899,6167465,12517364,6.0715658664236334e-06
DAL192,3p,25,A>-,71,71,142,6349856,6167384,12517240,1.1344353867146431e-05
DAL192,5p,1,A>-,0,0,0,6350003,6167708,12517711,0.0
DAL192,5p,2,A>-,0,0,0,6349992,6167694,12517686,0.0
DAL192,5p,3,A>-,0,0,0,6350003,6167707,12517710,0.0
DAL192,5p,4,A>-,0,0,0,6350003,6167708,12517711,0.0
DAL192,5p,5,A>-,0,0,0,6350003,6167707,12517710,0.0
DAL192,5p,6,A>-,1,0,1,6350002,6167707,12517709,7.98868227404871e-08
DAL192,5p,7,A>-,0,0,0,6350002,6167708,12517710,0.0
DAL192,5p,8,A>-,0,0,0,6349926,6167708,12517634,0.0
DAL192,5p,9,A>-,10,1,11,6349914,6167708,12517622,8.787611576703626e-07
DAL192,5p,10,A>-,21,0,21,6349896,6167708,12517604,1.6776373497675754e-06
DAL192,5p,11,A>-,10,5,15,6349942,6167706,12517648,1.1983081805783323e-06
DAL192,5p,12,A>-,5,5,10,6349906,6167700,12517606,7.988748008205402e-07
DAL192,5p,13,A>-,18,5,23,6349906,6167705,12517611,1.8374113079564463e-06
DAL192,5p,14,A>-,101,4,105,6349889,6167679,12517568,8.388210872910776e-06
DAL192,5p,15,A>-,9,8,17,6349890,6167649,12517539,1.358094430542617e-06
DAL192,5p,16,A>-,14,9,23,6349904,6167639,12517543,1.8374212894655128e-06
DAL192,5p,17,A>-,24,2,26,6349778,6167623,12517401,2.077108498800989e-06
DAL192,5p,18,A>-,41,13,54,6349859,6167631,12517490,4.313963901708729e-06
DAL192,5p,19,A>-,36,12,48,6349822,6167638,12517460,3.834643769582647e-06
DAL192,5p,20,A>-,46,13,59,6349836,6167621,12517457,4.713417429754302e-06
DAL192,5p,21,A>-,50,15,65,6349784,6167624,12517408,5.1927683430946726e-06
DAL192,5p,22,A>-,49,17,66,6349783,6167584,12517367,5.272674357155143e-06
DAL192,5p,23,A>-,61,15,76,6349801,6167567,12517368,6.071563926218355e-06
DAL192,5p,24,A>-,61,31,92,6349759,6167564,12517323,7.349814333304333e-06
DAL192,5p,25,A>-,97,59,156,6349777,6167551,12517328,1.2462723673934246e-05
DAL193,3p,1,A>-,0,0,0,6484405,6362696,12847101,0.0
DAL193,3p,2,A>-,0,0,0,6484402,6362696,12847098,0.0
DAL193,3p,3,A>-,0,0,0,6484405,6362696,12847101,0.0
DAL193,3p,4,A>-,0,0,0,6484405,6362696,12847101,0.0
DAL193,3p,5,A>-,0,0,0,6484405,6362696,12847101,0.0
DAL193,3p,6,A>-,0,0,0,6484405,6362696,12847101,0.0
DAL193,3p,7,A>-,0,0,0,6484405,6362696,12847101,0.0
DAL193,3p,8,A>-,1,9,10,6484400,6362644,12847044,7.783891765296359e-07
DAL193,3p,9,A>-,2,15,17,6484400,6362631,12847031,1.3232629391179955e-06
DAL193,3p,10,A>-,3,13,16,6484393,6362640,12847033,1.2454237488142203e-06
DAL193,3p,11,A>-,7,5,12,6484398,6362639,12847037,9.340675207831968e-07
DAL193,3p,12,A>-,2,20,22,6484368,6362594,12846962,1.712467118685336e-06
DAL193,3p,13,A>-,4,15,19,6484385,6362543,12846928,1.4789527893360966e-06
DAL193,3p,14,A>-,6,22,28,6484363,6362486,12846849,2.1795227763632934e-06
DAL193,3p,15,A>-,15,106,121,6484332,6362438,12846770,9.418709916967457e-06
DAL193,3p,16,A>-,20,32,52,6484341,6362460,12846801,4.047700279626033e-06
DAL193,3p,17,A>-,23,22,45,6484294,6362445,12846739,3.502834454720377e-06
DAL193,3p,18,A>-,19,32,51,6484244,6362380,12846624,3.969914586120058e-06
DAL193,3p,19,A>-,26,31,57,6484265,6362400,12846665,4.43694920043451e-06
DAL193,3p,20,A>-,35,32,67,6484261,6362382,12846643,5.215370272218197e-06
DAL193,3p,21,A>-,37,40,77,6484248,6362443,12846691,5.993761350685558e-06
DAL193,3p,22,A>-,34,55,89,6484224,6362407,12846631,6.9278863851542085e-06
DAL193,3p,23,A>-,140,46,186,6484218,6362399,12846617,1.447851990917142e-05
DAL193,3p,24,A>-,104,64,168,6484164,6362319,12846483,1.3077509229568905e-05
DAL193,3p,25,A>-,95,87,182,6484128,6362355,12846483,1.4167301665366312e-05
DAL193,5p,1,A>-,0,0,0,6484405,6362696,12847101,0.0
DAL193,5p,2,A>-,0,0,0,6484386,6362681,12847067,0.0
DAL193,5p,3,A>-,0,0,0,6484400,6362696,12847096,0.0
DAL193,5p,4,A>-,0,0,0,6484403,6362696,12847099,0.0
DAL193,5p,5,A>-,0,0,0,6484403,6362696,12847099,0.0
DAL193,5p,6,A>-,0,0,0,6484404,6362696,12847100,0.0
DAL193,5p,7,A>-,27,0,27,6484404,6362696,12847100,2.1016416156175325e-06
DAL193,5p,8,A>-,10,0,10,6484314,6362693,12847007,7.783914183280199e-07
DAL193,5p,9,A>-,47,1,48,6484295,6362695,12846990,3.736283752069551e-06
DAL193,5p,10,A>-,41,1,42,6484284,6362694,12846978,3.26925133677352e-06
DAL193,5p,11,A>-,15,12,27,6484315,6362677,12846992,2.1016592833559795e-06
DAL193,5p,12,A>-,24,6,30,6484218,6362670,12846888,2.3351958855716654e-06
DAL193,5p,13,A>-,57,11,68,6484143,6362652,12846795,5.293148991635657e-06
DAL193,5p,14,A>-,22,99,121,6484145,6362627,12846772,9.41870845065204e-06
DAL193,5p,15,A>-,24,17,41,6484166,6362534,12846700,3.1914810807444715e-06
DAL193,5p,16,A>-,37,31,68,6484111,6362519,12846630,5.293216975969573e-06
DAL193,5p,17,A>-,40,26,66,6484043,6362598,12846641,5.137529724696129e-06
DAL193,5p,18,A>-,100,28,128,6483967,6362571,12846538,9.963773897683565e-06
DAL193,5p,19,A>-,40,27,67,6483980,6362593,12846573,5.215398690374468e-06
DAL193,5p,20,A>-,49,32,81,6483952,6362554,12846506,6.305216375565465e-06
DAL193,5p,21,A>-,71,19,90,6484003,6362532,12846535,7.005780157840227e-06
DAL193,5p,22,A>-,85,66,151,6484010,6362499,12846509,1.1754166053984004e-05
DAL193,5p,23,A>-,67,35,102,6483966,6362463,12846429,7.939949693412854e-06
DAL193,5p,24,A>-,95,62,157,6483905,6362426,12846331,1.2221388348159486e-05
DAL193,5p,25,A>-,99,66,165,6483942,6362403,12846345,1.28441202536597e-05
DAL195,3p,1,A>-,0,0,0,2363278,2267461,4630739,0.0
DAL195,3p,2,A>-,0,0,0,2363278,2267460,4630738,0.0
DAL195,3p,3,A>-,0,0,0,2363278,2267461,4630739,0.0
DAL195,3p,4,A>-,0,0,0,2363278,2267461,4630739,0.0
DAL195,3p,5,A>-,0,0,0,2363278,2267461,4630739,0.0
DAL195,3p,6,A>-,0,0,0,2363278,2267461,4630739,0.0
DAL195,3p,7,A>-,0,0,0,2363278,2267461,4630739,0.0
DAL195,3p,8,A>-,0,2,2,2363278,2267413,4630691,4.319009841079874e-07
DAL195,3p,9,A>-,0,2,2,2363276,2267438,4630714,4.318988389263513e-07
DAL195,3p,10,A>-,0,9,9,2363274,2267432,4630706,1.9435481328333087e-06
DAL195,3p,11,A>-,3,2,5,2363274,2267431,4630705,1.0797491958567864e-06
DAL195,3p,12,A>-,3,4,7,2363273,2267414,4630687,1.511654750148304e-06
DAL195,3p,13,A>-,4,5,9,2363269,2267412,4630681,1.9435586256103585e-06
DAL195,3p,14,A>-,7,6,13,2363250,2267410,4630660,2.807375190577585e-06
DAL195,3p,15,A>-,9,1,10,2363254,2267411,4630665,2.1595170456079203e-06
DAL195,3p,16,A>-,17,6,23,2363259,2267394,4630653,4.9669020762298536e-06
DAL195,3p,17,A>-,7,11,18,2363234,2267398,4630632,3.887158383564058e-06
DAL195,3p,18,A>-,11,12,23,2363236,2267374,4630610,4.966948199049369e-06
DAL195,3p,19,A>-,11,12,23,2363215,2267369,4630584,4.966976087681381e-06
DAL195,3p,20,A>-,9,18,27,2363222,2267380,4630602,5.830775350591564e-06
DAL195,3p,21,A>-,21,14,35,2363235,2267382,4630617,7.55838800747287e-06
DAL195,3p,22,A>-,20,8,28,2363231,2267383,4630614,6.046714323413698e-06
DAL195,3p,23,A>-,17,26,43,2363219,2267370,4630589,9.286075702248678e-06
DAL195,3p,24,A>-,21,34,55,2363198,2267373,4630571,1.1877584859405028e-05
DAL195,3p,25,A>-,40,35,75,2363180,2267377,4630557,1.6196755595493155e-05
DAL195,5p,1,A>-,0,0,0,2363278,2267461,4630739,0.0
DAL195,5p,2,A>-,0,0,0,2363264,2267447,4630711,0.0
DAL195,5p,3,A>-,0,0,0,2363278,2267459,4630737,0.0
DAL195,5p,4,A>-,0,0,0,2363278,2267461,4630739,0.0
DAL195,5p,5,A>-,0,0,0,2363277,2267461,4630738,0.0
DAL195,5p,6,A>-,0,0,0,2363277,2267461,4630738,0.0
DAL195,5p,7,A>-,1,0,1,2363277,2267461,4630738,2.1594830024933394e-07
DAL195,5p,8,A>-,0,0,0,2363212,2267460,4630672,0.0
DAL195,5p,9,A>-,15,0,15,2363181,2267461,4630642,3.2392916576146462e-06
DAL195,5p,10,A>-,28,2,30,2363146,2267458,4630604,6.478636480251821e-06
DAL195,5p,11,A>-,5,2,7,2362948,2267450,4630398,1.5117490980256989e-06
DAL195,5p,12,A>-,14,2,16,2362864,2267454,4630318,3.455486210666308e-06
DAL195,5p,13,A>-,17,2,19,2363073,2267445,4630518,4.103212642732412e-06
DAL195,5p,14,A>-,11,3,14,2363094,2267434,4630528,3.023413312693498e-06
DAL195,5p,15,A>-,12,6,18,2363178,2267432,4630610,3.887176851429941e-06
DAL195,5p,16,A>-,38,9,47,2363170,2267429,4630599,1.0149874778619353e-05
DAL195,5p,17,A>-,30,1,31,2363159,2267431,4630590,6.694611269838184e-06
DAL195,5p,18,A>-,24,6,30,2363182,2267420,4630602,6.478639278435071e-06
DAL195,5p,19,A>-,25,16,41,2363138,2267420,4630558,8.85422448007346e-06
DAL195,5p,20,A>-,23,14,37,2363110,2267401,4630511,7.990478804607094e-06
DAL195,5p,21,A>-,29,6,35,2363086,2267400,4630486,7.558601840066032e-06
DAL195,5p,22,A>-,17,8,25,2363094,2267388,4630482,5.39900597821134e-06
DAL195,5p,23,A>-,42,23,65,2363068,2267398,4630466,1.4037464047894964e-05
DAL195,5p,24,A>-,46,22,68,2363067,2267402,4630469,1.468533748957179e-05
DAL195,5p,25,A>-,38,53,91,2363135,2267374,4630509,1.9652267169764703e-05
DAL212,3p,1,A>-,0,0,0,4131322,4008153,8139475,0.0
DAL212,3p,2,A>-,0,0,0,4131322,4008153,8139475,0.0
DAL212,3p,3,A>-,0,0,0,4131322,4008153,8139475,0.0
DAL212,3p,4,A>-,0,0,0,4131322,4008153,8139475,0.0
DAL212,3p,5,A>-,0,0,0,4131322,4008151,8139473,0.0
DAL212,3p,6,A>-,0,0,0,4131322,4008151,8139473,0.0
DAL212,3p,7,A>-,0,1,1,4131322,4008153,8139475,1.228580467413439e-07
DAL212,3p,8,A>-,0,0,0,4131319,4008093,8139412,0.0
DAL212,3p,9,A>-,0,6,6,4131316,4008115,8139431,7.371522653119118e-07
DAL212,3p,10,A>-,0,9,9,4131317,4008102,8139419,1.105730028150658e-06
DAL212,3p,11,A>-,7,3,10,4131313,4008105,8139418,1.2285890711104898e-06
DAL212,3p,12,A>-,4,10,14,4131314,4008034,8139348,1.7200394921067388e-06
DAL212,3p,13,A>-,8,15,23,4131307,4007923,8139230,2.825820132862691e-06
DAL212,3p,14,A>-,16,14,30,4131271,4007904,8139175,3.685877254144308e-06
DAL212,3p,15,A>-,16,17,33,4131254,4007935,8139189,4.05445800558262e-06
DAL212,3p,16,A>-,20,40,60,4131236,4007982,8139218,7.371715562846456e-06
DAL212,3p,17,A>-,23,33,56,4131249,4007981,8139230,6.880257714796117e-06
DAL212,3p,18,A>-,33,29,62,4131222,4007954,8139176,7.617478722661852e-06
DAL212,3p,19,A>-,42,31,73,4131233,4007956,8139189,8.968952557803978e-06
DAL212,3p,20,A>-,46,32,78,4131221,4007928,8139149,9.58331147396368e-06
DAL212,3p,21,A>-,79,36,115,4131228,4007917,8139145,1.4129248219561145e-05
DAL212,3p,22,A>-,91,31,122,4131183,4007898,8139081,1.498940728074828e-05
DAL212,3p,23,A>-,59,66,125,4131172,4007904,8139076,1.5358008697793212e-05
DAL212,3p,24,A>-,158,118,276,4131124,4007904,8139028,3.3910683192145305e-05
DAL212,3p,25,A>-,188,154,342,4131071,4007924,8138995,4.20199299790699e-05
DAL212,5p,1,A>-,0,0,0,4131322,4008153,8139475,0.0
DAL212,5p,2,A>-,0,0,0,4131307,4008143,8139450,0.0
DAL212,5p,3,A>-,0,0,0,4131321,4008153,8139474,0.0
DAL212,5p,4,A>-,0,0,0,4131322,4008153,8139475,0.0
DAL212,5p,5,A>-,0,0,0,4131322,4008153,8139475,0.0
DAL212,5p,6,A>-,0,0,0,4131322,4008153,8139475,0.0
DAL212,5p,7,A>-,0,0,0,4131322,4008153,8139475,0.0
DAL212,5p,8,A>-,0,0,0,4131248,4008153,8139401,0.0
DAL212,5p,9,A>-,18,0,18,4131243,4008153,8139396,2.2114663053622163e-06
DAL212,5p,10,A>-,43,2,45,4131179,4008148,8139327,5.528712631892047e-06
DAL212,5p,11,A>-,23,3,26,4131234,4008143,8139377,3.1943476755039112e-06
DAL212,5p,12,A>-,7,6,13,4131187,4008141,8139328,1.5971834529828507e-06
DAL212,5p,13,A>-,14,4,18,4131181,4008142,8139323,2.21148613957205e-06
DAL212,5p,14,A>-,17,4,21,4131134,4008108,8139242,2.580092839112045e-06
DAL212,5p,15,A>-,61,18,79,4131156,4008091,8139247,9.70605757510492e-06
DAL212,5p,16,A>-,49,22,71,4131154,4008081,8139235,8.723178529677543e-06
DAL212,5p,17,A>-,61,12,73,4131159,4008081,8139240,8.968896358873801e-06
DAL212,5p,18,A>-,71,15,86,4131113,4008066,8139179,1.0566176269129848e-05
DAL212,5p,19,A>-,78,21,99,4131040,4008052,8139092,1.2163518977301152e-05
DAL212,5p,20,A>-,66,17,83,4131020,4008040,8139060,1.0197737822303804e-05
DAL212,5p,21,A>-,60,29,89,4130973,4008040,8139013,1.0934986834398717e-05
DAL212,5p,22,A>-,49,20,69,4131015,4007967,8138982,8.4777187122419e-06
DAL212,5p,23,A>-,95,43,138,4131005,4007962,8138967,1.695546867311294e-05
DAL212,5p,24,A>-,110,43,153,4131060,4007918,8138978,1.879842899194469e-05
DAL212,5p,25,A>-,110,115,225,4131016,4007614,8138630,2.764593058045396e-05
DAL218,3p,1,A>-,0,0,0,6952891,6658031,13610922,0.0
DAL218,3p,2,A>-,0,0,0,6952891,6658031,13610922,0.0
DAL218,3p,3,A>-,0,0,0,6952891,6658030,13610921,0.0
DAL218,3p,4,A>-,0,0,0,6952891,6658031,13610922,0.0
DAL218,3p,5,A>-,0,0,0,6952891,6658031,13610922,0.0
DAL218,3p,6,A>-,0,0,0,6952891,6658030,13610921,0.0
DAL218,3p,7,A>-,0,0,0,6952891,6658026,13610917,0.0
DAL218,3p,8,A>-,0,0,0,6952887,6657945,13610832,0.0
DAL218,3p,9,A>-,2,26,28,6952882,6657945,13610827,2.0571857977476315e-06
DAL218,3p,10,A>-,1,12,13,6952881,6657960,13610841,9.55120995095013e-07
DAL218,3p,11,A>-,8,14,22,6952866,6657905,13610771,1.616366919992997e-06
DAL218,3p,12,A>-,12,42,54,6952858,6657882,13610740,3.967455112653684e-06
DAL218,3p,13,A>-,7,22,29,6952870,6657811,13610681,2.130679574372509e-06
DAL218,3p,14,A>-,14,18,32,6952816,6657779,13610595,2.3511095583991736e-06
DAL218,3p,15,A>-,16,33,49,6952788,6657738,13610526,3.600154762571263e-06
DAL218,3p,16,A>-,25,58,83,6952760,6657689,13610449,6.09825583270618e-06
DAL218,3p,17,A>-,23,52,75,6952737,6657651,13610388,5.510496835211457e-06
DAL218,3p,18,A>-,24,74,98,6952711,6657672,13610383,7.200385176522953e-06
DAL218,3p,19,A>-,46,61,107,6952716,6657697,13610413,7.861627711076805e-06
DAL218,3p,20,A>-,53,106,159,6952697,6657752,13610449,1.1682200932533528e-05
DAL218,3p,21,A>-,55,97,152,6952660,6657692,13610352,1.1167969792405076e-05
DAL218,3p,22,A>-,121,65,186,6952654,6657637,13610291,1.3666129548589373e-05
DAL218,3p,23,A>-,74,128,202,6952651,6657632,13610283,1.4841719308849052e-05
DAL218,3p,24,A>-,103,213,316,6952669,6657588,13610257,2.3217783470216612e-05
DAL218,3p,25,A>-,134,264,398,6952605,6657566,13610171,2.9242836111317045e-05
DAL218,5p,1,A>-,0,0,0,6952891,6658031,13610922,0.0
DAL218,5p,2,A>-,0,0,0,6952874,6658014,13610888,0.0
DAL218,5p,3,A>-,0,0,0,6952891,6658031,13610922,0.0
DAL218,5p,4,A>-,0,0,0,6952891,6658031,13610922,0.0
DAL218,5p,5,A>-,0,0,0,6952891,6658031,13610922,0.0
DAL218,5p,6,A>-,0,0,0,6952891,6658031,13610922,0.0
DAL218,5p,7,A>-,0,0,0,6952888,6658031,13610919,0.0
DAL218,5p,8,A>-,0,1,1,6952719,6658029,13610748,7.347134779073126e-08
DAL218,5p,9,A>-,75,0,75,6952736,6658029,13610765,5.5103442018137845e-06
DAL218,5p,10,A>-,30,4,34,6952716,6658028,13610744,2.4980265590183755e-06
DAL218,5p,11,A>-,19,9,28,6952715,6658016,13610731,2.057200307610223e-06
DAL218,5p,12,A>-,49,7,56,6952625,6658005,13610630,4.114431146831558e-06
DAL218,5p,13,A>-,99,5,104,6952475,6658005,13610480,7.64117062734011e-06
DAL218,5p,14,A>-,41,4,45,6952554,6657955,13610509,3.3062687075112328e-06
DAL218,5p,15,A>-,61,14,75,6952449,6657923,13610372,5.510503313208486e-06
DAL218,5p,16,A>-,159,13,172,6952253,6657920,13610173,1.2637605708612229e-05
DAL218,5p,17,A>-,149,6,155,6952350,6657874,13610224,1.1388497353166269e-05
DAL218,5p,18,A>-,162,17,179,6952457,6657843,13610300,1.315180414832884e-05
DAL218,5p,19,A>-,129,26,155,6952296,6657770,13610066,1.1388629562854434e-05
DAL218,5p,20,A>-,125,22,147,6952289,6657772,13610061,1.0800833295309992e-05
DAL218,5p,21,A>-,211,30,241,6952371,6657729,13610100,1.7707437858649093e-05
DAL218,5p,22,A>-,190,32,222,6952322,6657786,13610108,1.6311406198980935e-05
DAL218,5p,23,A>-,142,35,177,6952288,6657745,13610033,1.3005111743667337e-05
DAL218,5p,24,A>-,259,55,314,6952375,6657772,13610147,2.307102193679466e-05
DAL218,5p,25,A>-,326,82,408,6952272,6657720,13609992,2.997797500542249e-05
DAL224,3p,1,A>-,0,0,0,4609472,4586477,9195949,0.0
DAL224,3p,2,A>-,0,0,0,4609471,4586476,9195947,0.0
DAL224,3p,3,A>-,0,0,0,4609472,4586477,9195949,0.0
DAL224,3p,4,A>-,0,0,0,4609472,4586477,9195949,0.0
DAL224,3p,5,A>-,0,0,0,4609472,4586477,9195949,0.0
DAL224,3p,6,A>-,0,0,0,4609472,4586477,9195949,0.0
DAL224,3p,7,A>-,0,0,0,4609472,4586476,9195948,0.0
DAL224,3p,8,A>-,0,0,0,4609469,4586423,9195892,0.0
DAL224,3p,9,A>-,1,11,12,4609466,4586431,9195897,1.3049297964081156e-06
DAL224,3p,10,A>-,4,5,9,4609461,4586371,9195832,9.787042651496895e-07
DAL224,3p,11,A>-,6,10,16,4609461,4586382,9195843,1.7399166123214587e-06
DAL224,3p,12,A>-,7,7,14,4609458,4586384,9195842,1.5224272013373e-06
DAL224,3p,13,A>-,8,12,20,4609454,4586364,9195818,2.174901678132386e-06
DAL224,3p,14,A>-,8,25,33,4609412,4586293,9195705,3.588631866724737e-06
DAL224,3p,15,A>-,8,21,29,4609400,4586272,9195672,3.1536575032254303e-06
DAL224,3p,16,A>-,13,17,30,4609379,4586240,9195619,3.262423116921221e-06
DAL224,3p,17,A>-,26,16,42,4609381,4586216,9195597,4.567403290944568e-06
DAL224,3p,18,A>-,33,23,56,4609363,4586282,9195645,6.0898392663048646e-06
DAL224,3p,19,A>-,20,24,44,4609353,4586195,9195548,4.784924182876322e-06
DAL224,3p,20,A>-,35,40,75,4609344,4586225,9195569,8.156102140063329e-06
DAL224,3p,21,A>-,31,29,60,4609343,4586223,9195566,6.524883840755425e-06
DAL224,3p,22,A>-,37,34,71,4609324,4586172,9195496,7.721171321264236e-06
DAL224,3p,23,A>-,27,46,73,4609323,4586083,9195406,7.938746804654412e-06
DAL224,3p,24,A>-,46,59,105,4609325,4586202,9195527,1.1418595149576527e-05
DAL224,3p,25,A>-,67,63,130,4609265,4586173,9195438,1.4137445111369357e-05
DAL224,5p,1,A>-,0,0,0,4609472,4586477,9195949,0.0
DAL224,5p,2,A>-,0,0,0,4609461,4586469,9195930,0.0
DAL224,5p,3,A>-,0,0,0,4609468,4586477,9195945,0.0
DAL224,5p,4,A>-,0,0,0,4609471,4586477,9195948,0.0
DAL224,5p,5,A>-,0,0,0,4609471,4586477,9195948,0.0
DAL224,5p,6,A>-,0,0,0,4609472,4586477,9195949,0.0
DAL224,5p,7,A>-,0,0,0,4609471,4586477,9195948,0.0
DAL224,5p,8,A>-,1,1,2,4609397,4586477,9195874,2.1748884336605745e-07
DAL224,5p,9,A>-,29,1,30,4609357,4586473,9195830,3.262348260026556e-06
DAL224,5p,10,A>-,20,3,23,4609338,4586470,9195808,2.5011396497186543e-06
DAL224,5p,11,A>-,12,10,22,4609388,4586469,9195857,2.392381699715426e-06
DAL224,5p,12,A>-,15,11,26,4609357,4586464,9195821,2.827371259183927e-06
DAL224,5p,13,A>-,17,18,35,4609320,4586461,9195781,3.806093250807082e-06
DAL224,5p,14,A>-,28,12,40,4609270,4586428,9195698,4.349860119373212e-06
DAL224,5p,15,A>-,21,5,26,4609299,4586416,9195715,2.827403850597806e-06
DAL224,5p,16,A>-,35,22,57,4609292,4586373,9195665,6.198572914520049e-06
DAL224,5p,17,A>-,39,22,61,4609285,4586385,9195670,6.633556880575314e-06
DAL224,5p,18,A>-,30,33,63,4609226,4586351,9195577,6.851119837286991e-06
DAL224,5p,19,A>-,38,18,56,4609203,4586337,9195540,6.089908803615666e-06
DAL224,5p,20,A>-,50,18,68,4609148,4586313,9195461,7.394952792470111e-06
DAL224,5p,21,A>-,53,12,65,4609195,4586347,9195542,7.068642609647153e-06
DAL224,5p,22,A>-,91,49,140,4609138,4586312,9195450,1.5224921020722203e-05
DAL224,5p,23,A>-,73,33,106,4609100,4586313,9195413,1.1527486584887486e-05
DAL224,5p,24,A>-,122,40,162,4609109,4586316,9195425,1.761745650690425e-05
DAL224,5p,25,A>-,78,65,143,4609125,4586257,9195382,1.5551284329460157e-05
DAL227,3p,1,A>-,0,0,0,3765386,3771243,7536629,0.0
DAL227,3p,2,A>-,0,0,0,3765386,3771243,7536629,0.0
DAL227,3p,3,A>-,0,0,0,3765386,3771243,7536629,0.0
DAL227,3p,4,A>-,0,0,0,3765386,3771243,7536629,0.0
DAL227,3p,5,A>-,0,0,0,3765386,3771243,7536629,0.0
DAL227,3p,6,A>-,0,0,0,3765386,3771243,7536629,0.0
DAL227,3p,7,A>-,0,0,0,3765386,3771243,7536629,0.0
DAL227,3p,8,A>-,2,0,2,3765386,3771207,7536593,2.653718994776552e-07
DAL227,3p,9,A>-,2,6,8,3765384,3771218,7536602,1.061486330311724e-06
DAL227,3p,10,A>-,5,10,15,3765382,3771209,7536591,1.990289774249392e-06
DAL227,3p,11,A>-,0,10,10,3765378,3771214,7536592,1.326859673443912e-06
DAL227,3p,12,A>-,7,9,16,3765377,3771173,7536550,2.122987308516496e-06
DAL227,3p,13,A>-,1,6,7,3765373,3771183,7536556,9.288062080345452e-07
DAL227,3p,14,A>-,2,5,7,3765341,3771166,7536507,9.28812246840612e-07
DAL227,3p,15,A>-,4,11,15,3765341,3771186,7536527,1.990306675740696e-06
DAL227,3p,16,A>-,2,9,11,3765340,3771079,7536419,1.4595791449493451e-06
DAL227,3p,17,A>-,13,11,24,3765328,3771049,7536377,3.1845540635772334e-06
DAL227,3p,18,A>-,9,6,15,3765321,3771036,7536357,1.9903515717209256e-06
DAL227,3p,19,A>-,8,12,20,3765313,3771111,7536424,2.6537785029080105e-06
DAL227,3p,20,A>-,19,12,31,3765308,3771082,7536390,4.113375236684938e-06
DAL227,3p,21,A>-,16,14,30,3765307,3771104,7536411,3.980674620850694e-06
DAL227,3p,22,A>-,18,23,41,3765309,3771137,7536446,5.440230050079308e-06
DAL227,3p,23,A>-,20,16,36,3765319,3771112,7536431,4.776796868438124e-06
DAL227,3p,24,A>-,31,33,64,3765312,3771081,7536393,8.492126140449417e-06
DAL227,3p,25,A>-,62,51,113,3765249,3771100,7536349,1.4993997756738707e-05
DAL227,5p,1,A>-,0,0,0,3765386,3771243,7536629,0.0
DAL227,5p,2,A>-,0,0,0,3765373,3771238,7536611,0.0
DAL227,5p,3,A>-,0,0,0,3765386,3771243,7536629,0.0
DAL227,5p,4,A>-,0,0,0,3765385,3771243,7536628,0.0
DAL227,5p,5,A>-,0,0,0,3765386,3771242,7536628,0.0
DAL227,5p,6,A>-,0,0,0,3765386,3771243,7536629,0.0
DAL227,5p,7,A>-,0,0,0,3765386,3771243,7536629,0.0
DAL227,5p,8,A>-,0,0,0,3765342,3771242,7536584,0.0
DAL227,5p,9,A>-,8,1,9,3765324,3771243,7536567,1.194177667364995e-06
DAL227,5p,10,A>-,9,0,9,3765318,3771238,7536556,1.1941794103301296e-06
DAL227,5p,11,A>-,3,1,4,3765365,3771237,7536602,5.30743165155862e-07
DAL227,5p,12,A>-,9,6,15,3765326,3771232,7536558,1.990298489044999e-06
DAL227,5p,13,A>-,15,4,19,3765325,3771231,7536556,2.5210454218080512e-06
DAL227,5p,14,A>-,2,2,4,3765297,3771226,7536523,5.307487285582489e-07
DAL227,5p,15,A>-,7,8,15,3765318,3771201,7536519,1.9903087884472926e-06
DAL227,5p,16,A>-,9,8,17,3765316,3771188,7536504,2.2556877830888166e-06
DAL227,5p,17,A>-,6,3,9,3765326,3771175,7536501,1.1941881252321202e-06
DAL227,5p,18,A>-,14,11,25,3765280,3771169,7536449,3.3172121247022302e-06
DAL227,5p,19,A>-,24,9,33,3765279,3771164,7536443,4.378723490644061e-06
DAL227,5p,20,A>-,28,4,32,3765254,3771167,7536421,4.246047294863172e-06
DAL227,5p,21,A>-,25,7,32,3765270,3771169,7536439,4.246037153621226e-06
DAL227,5p,22,A>-,34,10,44,3765253,3771158,7536411,5.838322777247685e-06
DAL227,5p,23,A>-,28,13,41,3765254,3771157,7536411,5.440255315162615e-06
DAL227,5p,24,A>-,39,27,66,3765270,3771180,7536450,8.757438847202595e-06
DAL227,5p,25,A>-,33,41,74,3765247,3771148,7536395,9.819018244133963e-06
WA02,3p,1,A>-,0,0,0,6552698,6754258,13306956,0.0
WA02,3p,2,A>-,0,0,0,6552698,6754258,13306956,0.0
WA02,3p,3,A>-,0,0,0,6552698,6754258,13306956,0.0
WA02,3p,4,A>-,0,0,0,6552698,6754256,13306954,0.0
WA02,3p,5,A>-,0,0,0,6552698,6754256,13306954,0.0
WA02,3p,6,A>-,0,0,0,6552698,6754257,13306955,0.0
WA02,3p,7,A>-,0,1,1,6552698,6754257,13306955,7.514867225447144e-08
WA02,3p,8,A>-,1,0,1,6552692,6754207,13306899,7.514898850588707e-08
WA02,3p,9,A>-,11,35,46,6552688,6754191,13306879,3.4568586668594493e-06
WA02,3p,10,A>-,12,41,53,6552680,6754207,13306887,3.982899982542874e-06
WA02,3p,11,A>-,27,26,53,6552667,6754202,13306869,3.982905370151311e-06
WA02,3p,12,A>-,29,45,74,6552670,6754189,13306859,5.561041865702492e-06
WA02,3p,13,A>-,37,49,86,6552675,6754177,13306852,6.462835838258365e-06
WA02,3p,14,A>-,34,39,73,6552653,6754155,13306808,5.485913676668364e-06
WA02,3p,15,A>-,65,60,125,6552632,6754146,13306778,9.393708980490996e-06
WA02,3p,16,A>-,77,64,141,6552629,6754119,13306748,1.0596127618859245e-05
WA02,3p,17,A>-,76,69,145,6552608,6754116,13306724,1.0896746637263989e-05
WA02,3p,18,A>-,62,89,151,6552611,6754085,13306696,1.1347670375876928e-05
WA02,3p,19,A>-,70,91,161,6552605,6754056,13306661,1.2099203549260028e-05
WA02,3p,20,A>-,107,85,192,6552618,6754033,13306651,1.4428874703334444e-05
WA02,3p,21,A>-,114,104,218,6552597,6754089,13306686,1.6382741728481457e-05
WA02,3p,22,A>-,91,98,189,6552593,6754062,13306655,1.4203419266524908e-05
WA02,3p,23,A>-,94,140,234,6552585,6754052,13306637,1.758520954618361e-05
WA02,3p,24,A>-,184,214,398,6552556,6754026,13306582,2.991000994846009e-05
WA02,3p,25,A>-,246,237,483,6552517,6754038,13306555,3.629789979449978e-05
WA02,5p,1,A>-,0,0,0,6552698,6754258,13306956,0.0
WA02,5p,2,A>-,0,0,0,6552562,6754179,13306741,0.0
WA02,5p,3,A>-,0,0,0,6552698,6754258,13306956,0.0
WA02,5p,4,A>-,0,0,0,6552698,6754258,13306956,0.0
WA02,5p,5,A>-,0,0,0,6552698,6754258,13306956,0.0
WA02,5p,6,A>-,0,0,0,6552697,6754258,13306955,0.0
WA02,5p,7,A>-,0,0,0,6552685,6754258,13306943,0.0
WA02,5p,8,A>-,0,0,0,6552655,6754257,13306912,0.0
WA02,5p,9,A>-,50,8,58,6552662,6754226,13306888,4.35864493636679e-06
WA02,5p,10,A>-,44,5,49,6552618,6754222,13306840,3.6823167634088935e-06
WA02,5p,11,A>-,41,14,55,6552625,6754225,13306850,4.133209587543258e-06
WA02,5p,12,A>-,38,31,69,6552628,6754236,13306864,5.1852938453417724e-06
WA02,5p,13,A>-,56,28,84,6552614,6754205,13306819,6.31255298505225e-06
WA02,5p,14,A>-,45,21,66,6552607,6754183,13306790,4.959873868904521e-06
WA02,5p,15,A>-,56,24,80,6552586,6754168,13306754,6.011984590682296e-06
WA02,5p,16,A>-,70,27,97,6552525,6754178,13306703,7.289559254459952e-06
WA02,5p,17,A>-,86,49,135,6552567,6754148,13306715,1.014525373091706e-05
WA02,5p,18,A>-,68,63,131,6552548,6754087,13306635,9.84471280680653e-06
WA02,5p,19,A>-,96,75,171,6552516,6754124,13306640,1.2850727155765845e-05
WA02,5p,20,A>-,98,75,173,6552507,6754132,13306639,1.300102903520566e-05
WA02,5p,21,A>-,92,58,150,6552521,6754152,13306673,1.127253972499362e-05
WA02,5p,22,A>-,131,55,186,6552516,6754117,13306633,1.3977991276981938e-05
WA02,5p,23,A>-,145,80,225,6552465,6754131,13306596,1.690890743207354e-05
WA02,5p,24,A>-,203,160,363,6552457,6754135,13306592,2.727971219076981e-05
WA02,5p,25,A>-,209,271,480,6552470,6754083,13306553,3.6072452422501904e-05
WA03,3p,1,A>-,0,0,0,5399458,5543742,10943200,0.0
WA03,3p,2,A>-,0,0,0,5399458,5543742,10943200,0.0
WA03,3p,3,A>-,0,0,0,5399458,5543742,10943200,0.0
WA03,3p,4,A>-,0,0,0,5399458,5543736,10943194,0.0
WA03,3p,5,A>-,0,0,0,5399458,5543740,10943198,0.0
WA03,3p,6,A>-,0,1,1,5399458,5543741,10943199,9.138095725025197e-08
WA03,3p,7,A>-,0,0,0,5399458,5543739,10943197,0.0
WA03,3p,8,A>-,2,1,3,5399449,5543673,10943122,2.741448007250582e-07
WA03,3p,9,A>-,8,33,41,5399436,5543670,10943106,3.74665108790868e-06
WA03,3p,10,A>-,12,36,48,5399438,5543654,10943092,4.386328836493379e-06
WA03,3p,11,A>-,28,39,67,5399404,5543644,10943048,6.122608618732185e-06
WA03,3p,12,A>-,13,53,66,5399397,5543595,10942992,6.031257264923524e-06
WA03,3p,13,A>-,29,55,84,5399378,5543551,10942929,7.676189802565657e-06
WA03,3p,14,A>-,33,52,85,5399356,5543493,10942849,7.76762980097779e-06
WA03,3p,15,A>-,36,50,86,5399349,5543505,10942854,7.859010090055118e-06
WA03,3p,16,A>-,36,67,103,5399342,5543495,10942837,9.412549963048888e-06
WA03,3p,17,A>-,53,66,119,5399346,5543438,10942784,1.0874746316842222e-05
WA03,3p,18,A>-,45,92,137,5399325,5543443,10942768,1.251968423345903e-05
WA03,3p,19,A>-,72,82,154,5399297,5543425,10942722,1.4073280852789644e-05
WA03,3p,20,A>-,71,75,146,5399252,5543409,10942661,1.334227570423684e-05
WA03,3p,21,A>-,78,86,164,5399248,5543303,10942551,1.498736446373428e-05
WA03,3p,22,A>-,95,78,173,5399256,5543263,10942519,1.5809888015730198e-05
WA03,3p,23,A>-,75,106,181,5399255,5543267,10942522,1.6540976568290197e-05
WA03,3p,24,A>-,214,156,370,5399198,5543130,10942328,3.381364550578268e-05
WA03,3p,25,A>-,328,175,503,5399050,5543142,10942192,4.596885157928137e-05
WA03,5p,1,A>-,0,0,0,5399457,5543742,10943199,0.0
WA03,5p,2,A>-,0,0,0,5399258,5543638,10942896,0.0
WA03,5p,3,A>-,0,0,0,5399457,5543742,10943199,0.0
WA03,5p,4,A>-,0,0,0,5399458,5543742,10943200,0.0
WA03,5p,5,A>-,0,0,0,5399456,5543740,10943196,0.0
WA03,5p,6,A>-,0,0,0,5399452,5543742,10943194,0.0
WA03,5p,7,A>-,1,0,1,5399453,5543742,10943195,9.138099065218157e-08
WA03,5p,8,A>-,2,1,3,5399403,5543732,10943135,2.741444750521674e-07
WA03,5p,9,A>-,48,3,51,5399319,5543732,10943051,4.660491850033414e-06
WA03,5p,10,A>-,61,9,70,5399344,5543717,10943061,6.396747674165391e-06
WA03,5p,11,A>-,31,16,47,5399321,5543705,10943026,4.294972889582826e-06
WA03,5p,12,A>-,34,13,47,5399213,5543665,10942878,4.295030978139389e-06
WA03,5p,13,A>-,40,18,58,5399156,5543662,10942818,5.300280055832053e-06
WA03,5p,14,A>-,53,29,82,5399124,5543629,10942753,7.49354390069848e-06
WA03,5p,15,A>-,63,35,98,5399092,5543505,10942597,8.95582648250685e-06
WA03,5p,16,A>-,66,58,124,5399083,5543501,10942584,1.1331875542376462e-05
WA03,5p,17,A>-,130,51,181,5399113,5543491,10942604,1.6540852616068352e-05
WA03,5p,18,A>-,108,53,161,5399074,5543600,10942674,1.4713039975421e-05
WA03,5p,19,A>-,110,53,163,5399071,5543546,10942617,1.489588825049803e-05
WA03,5p,20,A>-,124,40,164,5399050,5543533,10942583,1.4987320635356387e-05
WA03,5p,21,A>-,164,70,234,5399034,5543509,10942543,2.138442590538598e-05
WA03,5p,22,A>-,142,59,201,5398989,5543454,10942443,1.836884140040757e-05
WA03,5p,23,A>-,180,69,249,5398935,5543457,10942392,2.2755536449434456e-05
WA03,5p,24,A>-,190,110,300,5398952,5543428,10942380,2.741633904141512e-05
WA03,5p,25,A>-,187,152,339,5398991,5543444,10942435,3.098030739958702e-05
WA07,3p,1,A>-,0,0,0,5691729,6013979,11705708,0.0
WA07,3p,2,A>-,0,0,0,5691729,6013979,11705708,0.0
WA07,3p,3,A>-,0,0,0,5691729,6013979,11705708,0.0
WA07,3p,4,A>-,0,0,0,5691729,6013979,11705708,0.0
WA07,3p,5,A>-,0,0,0,5691729,6013979,11705708,0.0
WA07,3p,6,A>-,0,0,0,5691729,6013979,11705708,0.0
WA07,3p,7,A>-,0,0,0,5691729,6013979,11705708,0.0
WA07,3p,8,A>-,0,0,0,5691713,6013800,11705513,0.0
WA07,3p,9,A>-,2,6,8,5691720,6013901,11705621,6.834323441703776e-07
WA07,3p,10,A>-,1,6,7,5691718,6013892,11705610,5.980038631049556e-07
WA07,3p,11,A>-,5,6,11,5691711,6013883,11705594,9.397216407813222e-07
WA07,3p,12,A>-,4,20,24,5691705,6013884,11705589,2.050302637483684e-06
WA07,3p,13,A>-,12,24,36,5691711,6013848,11705559,3.075461838259924e-06
WA07,3p,14,A>-,29,14,43,5691695,6013877,11705572,3.673464227121921e-06
WA07,3p,15,A>-,32,22,54,5691211,6013856,11705067,4.61338666408317e-06
WA07,3p,16,A>-,27,12,39,5691636,6013850,11705486,3.3317711028828705e-06
WA07,3p,17,A>-,32,35,67,5691662,6013813,11705475,5.7238172735408005e-06
WA07,3p,18,A>-,26,28,54,5691639,6013769,11705408,4.613252267669781e-06
WA07,3p,19,A>-,41,35,76,5691628,6013742,11705370,6.492746491567546e-06
WA07,3p,20,A>-,35,45,80,5691604,6013772,11705376,6.834466487877024e-06
WA07,3p,21,A>-,24,63,87,5691611,6013735,11705346,7.432501354509299e-06
WA07,3p,22,A>-,37,40,77,5691577,6013736,11705313,6.5782093994410914e-06
WA07,3p,23,A>-,63,55,118,5691568,6013670,11705238,1.0080956918603449e-05
WA07,3p,24,A>-,93,98,191,5691554,6013661,11705215,1.631751317681905e-05
WA07,3p,25,A>-,143,83,226,5691455,6013662,11705117,1.9307795043825703e-05
WA07,5p,1,A>-,0,0,0,5691729,6013979,11705708,0.0
WA07,5p,2,A>-,0,0,0,5691636,6013923,11705559,0.0
WA07,5p,3,A>-,0,0,0,5691729,6013979,11705708,0.0
WA07,5p,4,A>-,0,0,0,5691728,6013979,11705707,0.0
WA07,5p,5,A>-,0,0,0,5691729,6013978,11705707,0.0
WA07,5p,6,A>-,0,0,0,5691728,6013979,11705707,0.0
WA07,5p,7,A>-,0,0,0,5691728,6013979,11705707,0.0
WA07,5p,8,A>-,0,0,0,5691579,6013975,11705554,0.0
WA07,5p,9,A>-,23,1,24,5691672,6013971,11705643,2.0502931791102803e-06
WA07,5p,10,A>-,31,2,33,5691582,6013961,11705543,2.819177205192446e-06
WA07,5p,11,A>-,14,6,20,5691326,6013942,11705268,1.7086323867168184e-06
WA07,5p,12,A>-,22,9,31,5691520,6013938,11705458,2.6483372115811274e-06
WA07,5p,13,A>-,33,6,39,5691511,6013949,11705460,3.3317785033650963e-06
WA07,5p,14,A>-,44,20,64,5691556,6013950,11705506,5.467512468064174e-06
WA07,5p,15,A>-,70,5,75,5691563,6013633,11705196,6.407410862663043e-06
WA07,5p,16,A>-,77,9,86,5691534,6013925,11705459,7.346999378665971e-06
WA07,5p,17,A>-,61,13,74,5691561,6013916,11705477,6.321826953314248e-06
WA07,5p,18,A>-,71,14,85,5691474,6013905,11705379,7.261618782270955e-06
WA07,5p,19,A>-,65,19,84,5691482,6013884,11705366,7.17619594295471e-06
WA07,5p,20,A>-,57,11,68,5691421,6013876,11705297,5.8093357221094e-06
WA07,5p,21,A>-,82,32,114,5691379,6013853,11705232,9.739234557674722e-06
WA07,5p,22,A>-,91,28,119,5691396,6013861,11705257,1.016637225479116e-05
WA07,5p,23,A>-,130,16,146,5691314,6013795,11705109,1.2473185854142835e-05
WA07,5p,24,A>-,145,47,192,5691332,6013785,11705117,1.640308251510856e-05
WA07,5p,25,A>-,145,72,217,5691334,6013719,11705053,1.853900191652272e-05
WA08,3p,1,A>-,0,0,0,6798117,7189085,13987202,0.0
WA08,3p,2,A>-,0,0,0,6798117,7189085,13987202,0.0
WA08,3p,3,A>-,0,0,0,6798117,7189085,13987202,0.0
WA08,3p,4,A>-,0,0,0,6798117,7189081,13987198,0.0
WA08,3p,5,A>-,0,0,0,6798117,7189085,13987202,0.0
WA08,3p,6,A>-,0,0,0,6798117,7189085,13987202,0.0
WA08,3p,7,A>-,0,0,0,6798117,7189084,13987201,0.0
WA08,3p,8,A>-,0,0,0,6798110,7189053,13987163,0.0
WA08,3p,9,A>-,3,22,25,6798103,7189051,13987154,1.7873543109627591e-06
WA08,3p,10,A>-,8,17,25,6798074,7189042,13987116,1.7873591668218095e-06
WA08,3p,11,A>-,16,25,41,6798109,7189046,13987155,2.931260860410856e-06
WA08,3p,12,A>-,31,34,65,6798091,7189018,13987109,4.6471361594451e-06
WA08,3p,13,A>-,14,35,49,6798090,7189013,13987103,3.5032272229638977e-06
WA08,3p,14,A>-,27,29,56,6798067,7188981,13987048,4.003703998156008e-06
WA08,3p,15,A>-,41,45,86,6798069,7188978,13987047,6.148545865328114e-06
WA08,3p,16,A>-,40,46,86,6798049,7188961,13987010,6.148562130147902e-06
WA08,3p,17,A>-,48,54,102,6798000,7188943,13986943,7.292515598297641e-06
WA08,3p,18,A>-,48,48,96,6798023,7188956,13986979,6.863526426971828e-06
WA08,3p,19,A>-,51,60,111,6798028,7188946,13986974,7.935955268094442e-06
WA08,3p,20,A>-,73,72,145,6798009,7188917,13986926,1.0366823989774452e-05
WA08,3p,21,A>-,57,89,146,6798010,7188926,13986936,1.0438311864728627e-05
WA08,3p,22,A>-,76,98,174,6798012,7188920,13986932,1.2440183451238629e-05
WA08,3p,23,A>-,68,98,166,6798009,7188864,13986873,1.1868271056725832e-05
WA08,3p,24,A>-,109,132,241,6798015,7188867,13986882,1.7230430627783946e-05
WA08,3p,25,A>-,155,162,317,6797966,7188892,13986858,2.266413228760884e-05
WA08,5p,1,A>-,0,0,0,6798116,7189085,13987201,0.0
WA08,5p,2,A>-,0,0,0,6797941,7188997,13986938,0.0
WA08,5p,3,A>-,0,0,0,6798117,7189084,13987201,0.0
WA08,5p,4,A>-,0,0,0,6798115,7189085,13987200,0.0
WA08,5p,5,A>-,0,0,0,6798116,7189084,13987200,0.0
WA08,5p,6,A>-,0,0,0,6798112,7189085,13987197,0.0
WA08,5p,7,A>-,0,0,0,6798110,7189085,13987195,0.0
WA08,5p,8,A>-,2,0,2,6798069,7189064,13987133,1.4298855955684414e-07
WA08,5p,9,A>-,28,5,33,6798054,7189067,13987121,2.359313256816753e-06
WA08,5p,10,A>-,36,5,41,6798015,7189037,13987052,2.931282446079417e-06
WA08,5p,11,A>-,20,7,27,6797997,7189047,13987044,1.930357836866746e-06
WA08,5p,12,A>-,33,13,46,6798016,7189056,13987072,3.288751212548273e-06
WA08,5p,13,A>-,41,19,60,6797995,7189043,13987038,4.289685922065844e-06
WA08,5p,14,A>-,33,13,46,6797984,7189041,13987025,3.2887622635978703e-06
WA08,5p,15,A>-,40,32,72,6797997,7189013,13987010,5.147633411286616e-06
WA08,5p,16,A>-,41,17,58,6797921,7188997,13986918,4.1467319676858045e-06
WA08,5p,17,A>-,49,26,75,6797959,7188875,13986834,5.362185609695518e-06
WA08,5p,18,A>-,55,34,89,6797991,7188972,13986963,6.3630682371863e-06
WA08,5p,19,A>-,59,42,101,6797966,7188988,13986954,7.221014668383123e-06
WA08,5p,20,A>-,92,50,142,6797883,7188971,13986854,1.0152390237289958e-05
WA08,5p,21,A>-,69,48,117,6797885,7188979,13986864,8.364991609269954e-06
WA08,5p,22,A>-,84,56,140,6797887,7188939,13986826,1.0009418863150224e-05
WA08,5p,23,A>-,120,31,151,6797851,7188919,13986770,1.0795916426737552e-05
WA08,5p,24,A>-,150,78,228,6797841,7188876,13986717,1.6301180613005897e-05
WA08,5p,25,A>-,163,151,314,6797835,7188817,13986652,2.2449975877000443e-05
WA09,3p,1,A>-,0,0,0,4741672,4881751,9623423,0.0
WA09,3p,2,A>-,0,0,0,4741672,4881751,9623423,0.0
WA09,3p,3,A>-,0,0,0,4741672,4881751,9623423,0.0
WA09,3p,4,A>-,0,0,0,4741672,4881748,9623420,0.0
WA09,3p,5,A>-,0,0,0,4741672,4881751,9623423,0.0
WA09,3p,6,A>-,0,0,0,4741672,4881751,9623423,0.0
WA09,3p,7,A>-,0,0,0,4741672,4881748,9623420,0.0
WA09,3p,8,A>-,0,0,0,4741663,4881718,9623381,0.0
WA09,3p,9,A>-,2,13,15,4741664,4881723,9623387,1.558702772734797e-06
WA09,3p,10,A>-,4,6,10,4741658,4881705,9623363,1.0391377733542836e-06
WA09,3p,11,A>-,14,13,27,4741648,4881712,9623360,2.805672862700761e-06
WA09,3p,12,A>-,20,22,42,4741642,4881680,9623322,4.364397242449125e-06
WA09,3p,13,A>-,17,11,28,4741628,4881645,9623273,2.9096129767907448e-06
WA09,3p,14,A>-,16,21,37,4741616,4881571,9623187,3.844880079749048e-06
WA09,3p,15,A>-,30,54,84,4741598,4881557,9623155,8.728945964187421e-06
WA09,3p,16,A>-,30,28,58,4741586,4881546,9623132,6.027143761511325e-06
WA09,3p,17,A>-,43,51,94,4741582,4881528,9623110,9.7681518760567e-06
WA09,3p,18,A>-,36,74,110,4741560,4881490,9623050,1.1430887296647112e-05
WA09,3p,19,A>-,44,47,91,4741552,4881442,9622994,9.456516339924976e-06
WA09,3p,20,A>-,79,45,124,4741534,4881501,9623035,1.2885747583792432e-05
WA09,3p,21,A>-,58,52,110,4741546,4881493,9623039,1.1430900363180488e-05
WA09,3p,22,A>-,54,54,108,4741524,4881498,9623022,1.1223085637754958e-05
WA09,3p,23,A>-,64,90,154,4741501,4881486,9622987,1.600334698571244e-05
WA09,3p,24,A>-,110,203,313,4741491,4881450,9622941,3.2526438642822395e-05
WA09,3p,25,A>-,164,175,339,4741451,4881469,9622920,3.522839221359005e-05
WA09,5p,1,A>-,0,0,0,4741672,4881751,9623423,0.0
WA09,5p,2,A>-,0,0,0,4741495,4881667,9623162,0.0
WA09,5p,3,A>-,0,0,0,4741672,4881750,9623422,0.0
WA09,5p,4,A>-,0,0,0,4741672,4881751,9623423,0.0
WA09,5p,5,A>-,0,0,0,4741671,4881751,9623422,0.0
WA09,5p,6,A>-,2,0,2,4741669,4881751,9623420,2.0782632369781227e-07
WA09,5p,7,A>-,0,0,0,4741667,4881751,9623418,0.0
WA09,5p,8,A>-,1,0,1,4741639,4881744,9623383,1.039135613744148e-07
WA09,5p,9,A>-,27,2,29,4741618,4881747,9623365,3.013498916439312e-06
WA09,5p,10,A>-,40,2,42,4741622,4881737,9623359,4.36438046216503e-06
WA09,5p,11,A>-,20,4,24,4741614,4881733,9623347,2.493934802517253e-06
WA09,5p,12,A>-,28,27,55,4741580,4881734,9623314,5.715286854403795e-06
WA09,5p,13,A>-,43,15,58,4741530,4881708,9623238,6.027077372501854e-06
WA09,5p,14,A>-,63,10,73,4741498,4881705,9623203,7.585831869077271e-06
WA09,5p,15,A>-,40,18,58,4741496,4881672,9623168,6.027121214136551e-06
WA09,5p,16,A>-,48,18,66,4741451,4881636,9623087,6.85850600747972e-06
WA09,5p,17,A>-,48,18,66,4741476,4881638,9623114,6.858486764263626e-06
WA09,5p,18,A>-,49,25,74,4741455,4881610,9623065,7.689857649304042e-06
WA09,5p,19,A>-,68,40,108,4741379,4881580,9622959,1.1223159113532545e-05
WA09,5p,20,A>-,94,44,138,4741390,4881557,9622947,1.434072119486889e-05
WA09,5p,21,A>-,77,225,302,4741379,4881587,9622966,3.138325543288836e-05
WA09,5p,22,A>-,79,221,300,4741354,4881580,9622934,3.117552297459382e-05
WA09,5p,23,A>-,97,126,223,4741312,4881565,9622877,2.317394267847339e-05
WA09,5p,24,A>-,130,148,278,4741363,4881548,9622911,2.8889387005657644e-05
WA09,5p,25,A>-,157,164,321,4741301,4881503,9622804,3.3358260232672306e-05
WA11,3p,1,A>-,0,0,0,9756642,10108269,19864911,0.0
WA11,3p,2,A>-,0,0,0,9756642,10108269,19864911,0.0
WA11,3p,3,A>-,0,0,0,9756642,10108269,19864911,0.0
WA11,3p,4,A>-,0,0,0,9756642,10108267,19864909,0.0
WA11,3p,5,A>-,0,0,0,9756642,10108269,19864911,0.0
WA11,3p,6,A>-,0,0,0,9756642,10108269,19864911,0.0
WA11,3p,7,A>-,0,3,3,9756642,10108265,19864907,1.5102008783630348e-07
WA11,3p,8,A>-,0,2,2,9756629,10108160,19864789,1.0068065661306546e-07
WA11,3p,9,A>-,5,55,60,9756610,10108092,19864702,3.0204329267058725e-06
WA11,3p,10,A>-,11,37,48,9756615,10107969,19864584,2.416360694993663e-06
WA11,3p,11,A>-,26,51,77,9756587,10107918,19864505,3.876260697158071e-06
WA11,3p,12,A>-,21,37,58,9756581,10108019,19864600,2.9197668213807475e-06
WA11,3p,13,A>-,34,71,105,9756565,10107963,19864528,5.285803921442281e-06
WA11,3p,14,A>-,57,51,108,9756515,10107914,19864429,5.436853986590805e-06
WA11,3p,15,A>-,47,126,173,9756471,10107972,19864443,8.709028488742423e-06
WA11,3p,16,A>-,69,90,159,9756477,10108011,19864488,8.00423348439688e-06
WA11,3p,17,A>-,77,96,173,9756469,10108044,19864513,8.708997799241291e-06
WA11,3p,18,A>-,96,86,182,9756421,10108016,19864437,9.162102102365148e-06
WA11,3p,19,A>-,92,104,196,9756438,10108000,19864438,9.866878690451751e-06
WA11,3p,20,A>-,82,121,203,9756433,10107963,19864396,1.0219288822071407e-05
WA11,3p,21,A>-,130,82,212,9756421,10107904,19864325,1.0672398885942513e-05
WA11,3p,22,A>-,110,108,218,9756405,10107842,19864247,1.0974491003862369e-05
WA11,3p,23,A>-,101,174,275,9756375,10107816,19864191,1.3844007037588392e-05
WA11,3p,24,A>-,182,220,402,9756358,10107704,19864062,2.023755262141248e-05
WA11,3p,25,A>-,252,237,489,9756281,10107693,19863974,2.4617430530265496e-05
WA11,5p,1,A>-,0,0,0,9756641,10108269,19864910,0.0
WA11,5p,2,A>-,0,0,0,9756471,10108196,19864667,0.0
WA11,5p,3,A>-,0,0,0,9756642,10108269,19864911,0.0
WA11,5p,4,A>-,0,0,0,9756638,10108269,19864907,0.0
WA11,5p,5,A>-,0,0,0,9756638,10108267,19864905,0.0
WA11,5p,6,A>-,1,0,1,9756642,10108269,19864911,5.034001914229569e-08
WA11,5p,7,A>-,3,0,3,9756629,10108269,19864898,1.5102015625753528e-07
WA11,5p,8,A>-,4,1,5,9756500,10108261,19864761,2.517019963139753e-07
WA11,5p,9,A>-,55,5,60,9756493,10108240,19864733,3.020428213155445e-06
WA11,5p,10,A>-,50,16,66,9756446,10108197,19864643,3.322486087467064e-06
WA11,5p,11,A>-,42,11,53,9756457,10108195,19864652,2.668055800826513e-06
WA11,5p,12,A>-,42,17,59,9756411,10108221,19864632,2.9701028440899383e-06
WA11,5p,13,A>-,88,27,115,9756334,10108178,19864512,5.789218481682309e-06
WA11,5p,14,A>-,73,24,97,9756261,10108167,19864428,4.88310058562975e-06
WA11,5p,15,A>-,97,22,119,9756237,10108096,19864333,5.990636584676666e-06
WA11,5p,16,A>-,103,41,144,9756275,10108079,19864354,7.249166018688551e-06
WA11,5p,17,A>-,135,40,175,9756369,10108078,19864447,8.809709125051405e-06
WA11,5p,18,A>-,119,41,160,9756327,10108075,19864402,8.054609446586914e-06
WA11,5p,19,A>-,130,63,193,9756284,10108088,19864372,9.715887318260049e-06
WA11,5p,20,A>-,158,58,216,9756292,10108082,19864374,1.087373808004219e-05
WA11,5p,21,A>-,202,64,266,9756251,10108036,19864287,1.339086572802739e-05
WA11,5p,22,A>-,190,64,254,9756136,10108029,19864165,1.2786845054901629e-05
WA11,5p,23,A>-,171,75,246,9756095,10108016,19864111,1.238414344341914e-05
WA11,5p,24,A>-,249,112,361,9756046,10108010,19864056,1.8173529112080637e-05
WA11,5p,25,A>-,307,178,485,9756056,10107943,19863999,2.4416030226340627e-05
WA12,3p,1,A>-,0,0,0,6632243,6940679,13572922,0.0
WA12,3p,2,A>-,0,0,0,6632243,6940679,13572922,0.0
WA12,3p,3,A>-,0,0,0,6632243,6940679,13572922,0.0
WA12,3p,4,A>-,0,0,0,6632243,6940676,13572919,0.0
WA12,3p,5,A>-,0,0,0,6632243,6940678,13572921,0.0
WA12,3p,6,A>-,0,0,0,6632243,6940679,13572922,0.0
WA12,3p,7,A>-,0,0,0,6632243,6940676,13572919,0.0
WA12,3p,8,A>-,0,0,0,6632240,6940664,13572904,0.0
WA12,3p,9,A>-,4,13,17,6632231,6940656,13572887,1.2524969816664648e-06
WA12,3p,10,A>-,5,9,14,6632228,6940644,13572872,1.031469242471306e-06
WA12,3p,11,A>-,6,9,15,6632231,6940642,13572873,1.1051455355104258e-06
WA12,3p,12,A>-,11,6,17,6632223,6940615,13572838,1.2525015033701868e-06
WA12,3p,13,A>-,7,13,20,6632204,6940591,13572795,1.473535848732704e-06
WA12,3p,14,A>-,21,21,42,6632209,6940533,13572742,3.094437365714312e-06
WA12,3p,15,A>-,22,26,48,6632188,6940474,13572662,3.5365206913721127e-06
WA12,3p,16,A>-,24,37,61,6632187,6940478,13572665,4.494327385226115e-06
WA12,3p,17,A>-,31,39,70,6632168,6940473,13572641,5.157433987976253e-06
WA12,3p,18,A>-,28,44,72,6632160,6940482,13572642,5.304788853931312e-06
WA12,3p,19,A>-,36,34,70,6632121,6940435,13572556,5.157466287116443e-06
WA12,3p,20,A>-,50,42,92,6632105,6940432,13572537,6.778393752030295e-06
WA12,3p,21,A>-,44,59,103,6632096,6940454,13572550,7.588846605833097e-06
WA12,3p,22,A>-,54,48,102,6632039,6940438,13572477,7.515208904019509e-06
WA12,3p,23,A>-,60,64,124,6631950,6940459,13572409,9.136182088235036e-06
WA12,3p,24,A>-,101,108,209,6631933,6940411,13572344,1.5398961299536765e-05
WA12,3p,25,A>-,110,110,220,6631986,6940428,13572414,1.6209349346402196e-05
WA12,5p,1,A>-,0,0,0,6632243,6940679,13572922,0.0
WA12,5p,2,A>-,0,0,0,6631949,6940524,13572473,0.0
WA12,5p,3,A>-,0,0,0,6632242,6940678,13572920,0.0
WA12,5p,4,A>-,0,0,0,6632242,6940679,13572921,0.0
WA12,5p,5,A>-,1,0,1,6632242,6940677,13572919,7.367611933733636e-08
WA12,5p,6,A>-,1,0,1,6632242,6940679,13572921,7.367610848099683e-08
WA12,5p,7,A>-,2,0,2,6632238,6940679,13572917,1.4735226038735814e-07
WA12,5p,8,A>-,10,0,10,6632204,6940670,13572874,7.367636360582143e-07
WA12,5p,9,A>-,20,1,21,6632209,6940675,13572884,1.5472024957997137e-06
WA12,5p,10,A>-,38,2,40,6632199,6940665,13572864,2.947056715517079e-06
WA12,5p,11,A>-,14,6,20,6632166,6940667,13572833,1.4735317232592488e-06
WA12,5p,12,A>-,34,8,42,6632126,6940660,13572786,3.0944273342260018e-06
WA12,5p,13,A>-,35,4,39,6632065,6940658,13572723,2.8734101476910717e-06
WA12,5p,14,A>-,47,9,56,6632026,6940638,13572664,4.125940198622762e-06
WA12,5p,15,A>-,131,6,137,6631987,6940631,13572618,1.009385219564862e-05
WA12,5p,16,A>-,95,9,104,6631930,6940590,13572520,7.662541665070304e-06
WA12,5p,17,A>-,92,23,115,6631958,6940621,13572579,8.472965970579358e-06
WA12,5p,18,A>-,80,22,102,6632019,6940577,13572596,7.515143013171541e-06
WA12,5p,19,A>-,98,15,113,6631996,6940532,13572528,8.325641324888038e-06
WA12,5p,20,A>-,126,29,155,6631973,6940532,13572505,1.1420146833616931e-05
WA12,5p,21,A>-,108,20,128,6631936,6940534,13572470,9.43085525331793e-06
WA12,5p,22,A>-,125,32,157,6631921,6940529,13572450,1.1567550442256187e-05
WA12,5p,23,A>-,141,28,169,6631926,6940534,13572460,1.2451685250868305e-05
WA12,5p,24,A>-,148,106,254,6631934,6940518,13572452,1.8714378212573528e-05
WA12,5p,25,A>-,191,174,365,6631933,6940515,13572448,2.6892716774453657e-05
WA13,3p,1,A>-,0,0,0,5896847,6081528,11978375,0.0
WA13,3p,2,A>-,0,0,0,5896847,6081528,11978375,0.0
WA13,3p,3,A>-,0,0,0,5896847,6081528,11978375,0.0
WA13,3p,4,A>-,0,0,0,5896847,6081522,11978369,0.0
WA13,3p,5,A>-,0,0,0,5896847,6081527,11978374,0.0
WA13,3p,6,A>-,0,0,0,5896847,6081528,11978375,0.0
WA13,3p,7,A>-,0,0,0,5896847,6081528,11978375,0.0
WA13,3p,8,A>-,0,0,0,5896845,6081521,11978366,0.0
WA13,3p,9,A>-,2,3,5,5896842,6081517,11978359,4.174194478559209e-07
WA13,3p,10,A>-,2,4,6,5896843,6081517,11978360,5.009032956097496e-07
WA13,3p,11,A>-,5,8,13,5896841,6081492,11978333,1.085292920141726e-06
WA13,3p,12,A>-,2,7,9,5896836,6081505,11978341,7.513561352110446e-07
WA13,3p,13,A>-,10,8,18,5896834,6081495,11978329,1.5027137758530426e-06
WA13,3p,14,A>-,10,5,15,5896832,6081501,11978333,1.2522610617019914e-06
WA13,3p,15,A>-,18,6,24,5896825,6081505,11978330,2.0036182005337973e-06
WA13,3p,16,A>-,19,9,28,5896830,6081509,11978339,2.3375528109531717e-06
WA13,3p,17,A>-,13,11,24,5896823,6081499,11978322,2.0036195386966555e-06
WA13,3p,18,A>-,8,17,25,5896827,6081499,11978326,2.0871029891822947e-06
WA13,3p,19,A>-,18,12,30,5896822,6081480,11978302,2.5045286051395265e-06
WA13,3p,20,A>-,19,16,35,5896818,6081448,11978266,2.921958821084788e-06
WA13,3p,21,A>-,19,25,44,5896824,6081466,11978290,3.673312300837599e-06
WA13,3p,22,A>-,17,30,47,5896824,6081460,11978284,3.92376737769784e-06
WA13,3p,23,A>-,24,47,71,5896819,6081454,11978273,5.927398715991863e-06
WA13,3p,24,A>-,60,80,140,5896803,6081440,11978243,1.168785772671334e-05
WA13,3p,25,A>-,109,98,207,5896783,6081437,11978220,1.7281365678706855e-05
WA13,5p,1,A>-,0,0,0,5896847,6081528,11978375,0.0
WA13,5p,2,A>-,0,0,0,5896725,6081443,11978168,0.0
WA13,5p,3,A>-,0,0,0,5896847,6081528,11978375,0.0
WA13,5p,4,A>-,0,0,0,5896841,6081528,11978369,0.0
WA13,5p,5,A>-,0,0,0,5896841,6081528,11978369,0.0
WA13,5p,6,A>-,0,0,0,5896841,6081528,11978369,0.0
WA13,5p,7,A>-,0,0,0,5896845,6081528,11978373,0.0
WA13,5p,8,A>-,1,0,1,5896843,6081526,11978369,8.348381987564417e-08
WA13,5p,9,A>-,8,2,10,5896837,6081518,11978355,8.348391744943275e-07
WA13,5p,10,A>-,6,1,7,5896833,6081518,11978351,5.843876172938996e-07
WA13,5p,11,A>-,7,6,13,5896827,6081513,11978340,1.0852922859094e-06
WA13,5p,12,A>-,6,2,8,5896822,6081502,11978324,6.678730680519244e-07
WA13,5p,13,A>-,9,3,12,5896809,6081508,11978317,1.0018101875246747e-06
WA13,5p,14,A>-,14,3,17,5896802,6081520,11978322,1.4192305065767977e-06
WA13,5p,15,A>-,17,15,32,5896798,6081508,11978306,2.6714962867036456e-06
WA13,5p,16,A>-,12,4,16,5896754,6081491,11978245,1.3357549457370425e-06
WA13,5p,17,A>-,23,2,25,5896805,6081514,11978319,2.087104208862696e-06
WA13,5p,18,A>-,35,5,40,5896796,6081504,11978300,3.339372031089553e-06
WA13,5p,19,A>-,25,11,36,5896797,6081472,11978269,3.005442606106108e-06
WA13,5p,20,A>-,15,8,23,5896788,6081482,11978270,1.9201437269321865e-06
WA13,5p,21,A>-,27,12,39,5896782,6081484,11978266,3.255896972065907e-06
WA13,5p,22,A>-,38,14,52,5896771,6081483,11978254,4.3412003118317576e-06
WA13,5p,23,A>-,65,7,72,5896768,6081501,11978269,6.010885212212215e-06
WA13,5p,24,A>-,95,41,136,5896781,6081498,11978279,1.1353884810998308e-05
WA13,5p,25,A>-,93,71,164,5896769,6081462,11978231,1.3691504196237324e-05
WA14,3p,1,A>-,0,0,0,6684341,7140972,13825313,0.0
WA14,3p,2,A>-,0,0,0,6684341,7140972,13825313,0.0
WA14,3p,3,A>-,0,0,0,6684341,7140972,13825313,0.0
WA14,3p,4,A>-,0,0,0,6684341,7140971,13825312,0.0
WA14,3p,5,A>-,0,0,0,6684341,7140970,13825311,0.0
WA14,3p,6,A>-,0,0,0,6684341,7140971,13825312,0.0
WA14,3p,7,A>-,0,1,1,6684341,7140969,13825310,7.233110866953437e-08
WA14,3p,8,A>-,0,0,0,6684326,7140932,13825258,0.0
WA14,3p,9,A>-,5,18,23,6684323,7140920,13825243,1.6636235616256438e-06
WA14,3p,10,A>-,19,17,36,6684256,7140912,13825168,2.603946657284743e-06
WA14,3p,11,A>-,23,18,41,6684256,7140894,13825150,2.965609776385789e-06
WA14,3p,12,A>-,93,23,116,6684291,7140849,13825140,8.390511777819248e-06
WA14,3p,13,A>-,21,33,54,6684289,7140794,13825083,3.905944000480865e-06
WA14,3p,14,A>-,26,45,71,6684291,7140742,13825033,5.135611611198324e-06
WA14,3p,15,A>-,23,93,116,6684271,7140702,13824973,8.390613131758016e-06
WA14,3p,16,A>-,46,71,117,6684263,7140648,13824911,8.462983957003413e-06
WA14,3p,17,A>-,46,86,132,6684212,7140653,13824865,9.548013669572904e-06
WA14,3p,18,A>-,62,97,159,6684177,7140647,13824824,1.1501050573953058e-05
WA14,3p,19,A>-,49,98,147,6684172,7140542,13824714,1.0633131361704842e-05
WA14,3p,20,A>-,65,80,145,6684176,7140544,13824720,1.0488458355756934e-05
WA14,3p,21,A>-,110,131,241,6684132,7140443,13824575,1.7432723971622996e-05
WA14,3p,22,A>-,134,115,249,6684105,7140560,13824665,1.8011286349434145e-05
WA14,3p,23,A>-,79,150,229,6683638,7140562,13824200,1.656515386062123e-05
WA14,3p,24,A>-,122,223,345,6683623,7140532,13824155,2.495631740240181e-05
WA14,3p,25,A>-,243,281,524,6683613,7140513,13824126,3.790474710661636e-05
WA14,5p,1,A>-,0,0,0,6684341,7140972,13825313,0.0
WA14,5p,2,A>-,0,0,0,6684184,7140911,13825095,0.0
WA14,5p,3,A>-,0,0,0,6684338,7140972,13825310,0.0
WA14,5p,4,A>-,1,0,1,6684341,7140972,13825313,7.233109297416991e-08
WA14,5p,5,A>-,4,0,4,6684341,7140972,13825313,2.8932437189667964e-07
WA14,5p,6,A>-,2,0,2,6684340,7140972,13825312,1.446621964119146e-07
WA14,5p,7,A>-,1,0,1,6684336,7140972,13825308,7.233111913311444e-08
WA14,5p,8,A>-,5,0,5,6684277,7140970,13825247,3.616571913688052e-07
WA14,5p,9,A>-,66,0,66,6684241,7140959,13825200,4.77389115528166e-06
WA14,5p,10,A>-,60,1,61,6684210,7140628,13824838,4.412348267661437e-06
WA14,5p,11,A>-,42,7,49,6684218,7140646,13824864,3.544338664018684e-06
WA14,5p,12,A>-,66,10,76,6684139,7140917,13825056,5.497265255200413e-06
WA14,5p,13,A>-,75,18,93,6684018,7140931,13824949,6.726968757714766e-06
WA14,5p,14,A>-,72,23,95,6683951,7140942,13824893,6.8716625871896444e-06
WA14,5p,15,A>-,131,13,144,6684030,7140908,13824938,1.0415959912442284e-05
WA14,5p,16,A>-,127,61,188,6683910,7140868,13824778,1.3598771712645222e-05
WA14,5p,17,A>-,221,18,239,6683904,7140873,13824777,1.7287801459654647e-05
WA14,5p,18,A>-,133,33,166,6683891,7140646,13824537,1.2007635409417328e-05
WA14,5p,19,A>-,203,40,243,6683958,7140595,13824553,1.7577421852265313e-05
WA14,5p,20,A>-,137,81,218,6683860,7140558,13824418,1.5769199108418163e-05
WA14,5p,21,A>-,330,73,403,6683480,7140494,13823974,2.9152253903255315e-05
WA14,5p,22,A>-,216,126,342,6683768,7140398,13824166,2.4739286261464164e-05
WA14,5p,23,A>-,178,90,268,6683762,7140257,13824019,1.9386547428790423e-05
WA14,5p,24,A>-,222,109,331,6683714,7140421,13824135,2.3943631916210308e-05
WA14,5p,25,A>-,271,224,495,6683731,7140511,13824242,3.580666484281742e-05
WA18,3p,1,A>-,0,0,0,14112928,14131239,28244167,0.0
WA18,3p,2,A>-,0,0,0,14112928,14131239,28244167,0.0
WA18,3p,3,A>-,0,0,0,14112928,14131239,28244167,0.0
WA18,3p,4,A>-,0,0,0,14112928,14131238,28244166,0.0
WA18,3p,5,A>-,0,0,0,14112928,14131239,28244167,0.0
WA18,3p,6,A>-,0,0,0,14112928,14131239,28244167,0.0
WA18,3p,7,A>-,0,0,0,14112928,14131237,28244165,0.0
WA18,3p,8,A>-,0,0,0,14112927,14131187,28244114,0.0
WA18,3p,9,A>-,3,20,23,14112909,14131177,28244086,8.143297680087789e-07
WA18,3p,10,A>-,7,19,26,14112909,14131197,28244106,9.205460424203196e-07
WA18,3p,11,A>-,12,16,28,14112900,14131167,28244067,9.91358645339568e-07
WA18,3p,12,A>-,15,21,36,14112895,14131136,28244031,1.2746055971968023e-06
WA18,3p,13,A>-,18,26,44,14112898,14131061,28243959,1.5578552567648185e-06
WA18,3p,14,A>-,27,21,48,14112830,14131006,28243836,1.699485863039284e-06
WA18,3p,15,A>-,28,49,77,14112809,14130957,28243766,2.726265328780872e-06
WA18,3p,16,A>-,33,67,100,14112765,14130927,28243692,3.540613599666786e-06
WA18,3p,17,A>-,39,166,205,14112743,14130850,28243593,7.258283321105781e-06
WA18,3p,18,A>-,77,68,145,14112708,14130769,28243477,5.133928800621822e-06
WA18,3p,19,A>-,63,127,190,14112724,14130771,28243495,6.727212761735047e-06
WA18,3p,20,A>-,67,120,187,14112697,14130797,28243494,6.620993847290991e-06
WA18,3p,21,A>-,133,154,287,14112659,14130783,28243442,1.0161650977242788e-05
WA18,3p,22,A>-,104,186,290,14112575,14130715,28243290,1.0267925585156686e-05
WA18,3p,23,A>-,110,96,206,14112548,14130648,28243196,7.293792104831196e-06
WA18,3p,24,A>-,192,196,388,14112551,14130690,28243241,1.373780013419848e-05
WA18,3p,25,A>-,212,196,408,14112486,14130651,28243137,1.4445987356149566e-05
WA18,5p,1,A>-,0,0,0,14112926,14131239,28244165,0.0
WA18,5p,2,A>-,0,0,0,14112820,14131183,28244003,0.0
WA18,5p,3,A>-,0,0,0,14112928,14131239,28244167,0.0
WA18,5p,4,A>-,0,0,0,14112928,14131239,28244167,0.0
WA18,5p,5,A>-,0,0,0,14112925,14131239,28244164,0.0
WA18,5p,6,A>-,1,0,1,14112927,14131239,28244166,3.5405541802862934e-08
WA18,5p,7,A>-,0,0,0,14112921,14131239,28244160,0.0
WA18,5p,8,A>-,2,2,4,14112828,14131230,28244058,1.416227087481551e-07
WA18,5p,9,A>-,59,1,60,14112833,14131230,28244063,2.1243402551538e-06
WA18,5p,10,A>-,49,5,54,14112791,14131213,28244004,1.911910223493808e-06
WA18,5p,11,A>-,26,11,37,14112776,14131211,28243987,1.3100133490360266e-06
WA18,5p,12,A>-,35,4,39,14112682,14131223,28243905,1.3808288903393493e-06
WA18,5p,13,A>-,79,6,85,14112608,14131206,28243814,3.0095085599983062e-06
WA18,5p,14,A>-,54,12,66,14112535,14131179,28243714,2.3368031555623315e-06
WA18,5p,15,A>-,138,25,163,14112545,14131148,28243693,5.77119996312097e-06
WA18,5p,16,A>-,144,29,173,14112522,14131083,28243605,6.12528039533197e-06
WA18,5p,17,A>-,189,25,214,14112485,14130990,28243475,7.576971318154016e-06
WA18,5p,18,A>-,149,26,175,14112481,14130987,28243468,6.196122940709689e-06
WA18,5p,19,A>-,157,48,205,14112359,14130867,28243226,7.258377637172184e-06
WA18,5p,20,A>-,188,31,219,14112397,14130866,28243263,7.754061561512917e-06
WA18,5p,21,A>-,180,86,266,14112347,14130679,28243026,9.418254262131828e-06
WA18,5p,22,A>-,227,78,305,14112376,14129592,28241968,1.0799530684263927e-05
WA18,5p,23,A>-,260,46,306,14112288,14129275,28241563,1.0835094360747667e-05
WA18,5p,24,A>-,316,87,403,14112253,14129481,28241734,1.4269662054036768e-05
WA18,5p,25,A>-,282,160,442,14112273,14130551,28242824,1.5649993074346957e-05
WA22,3p,1,A>-,0,0,0,1513709,1653397,3167106,0.0
WA22,3p,2,A>-,0,0,0,1513709,1653396,3167105,0.0
WA22,3p,3,A>-,0,0,0,1513709,1653396,3167105,0.0
WA22,3p,4,A>-,0,0,0,1513709,1653394,3167103,0.0
WA22,3p,5,A>-,0,0,0,1513709,1653397,3167106,0.0
WA22,3p,6,A>-,0,0,0,1513709,1653397,3167106,0.0
WA22,3p,7,A>-,0,0,0,1513709,1653397,3167106,0.0
WA22,3p,8,A>-,0,0,0,1513709,1653395,3167104,0.0
WA22,3p,9,A>-,0,23,23,1513709,1653397,3167106,7.262150366928041e-06
WA22,3p,10,A>-,0,15,15,1513706,1653396,3167102,4.736191003636763e-06
WA22,3p,11,A>-,1,0,1,1513685,1653390,3167075,3.157487587126923e-07
WA22,3p,12,A>-,2,25,27,1513662,1653379,3167041,8.525308008327016e-06
WA22,3p,13,A>-,17,3,20,1513689,1653380,3167069,6.3149871379499465e-06
WA22,3p,14,A>-,11,60,71,1513686,1653352,3167038,2.2418423776411906e-05
WA22,3p,15,A>-,40,20,60,1513677,1653343,3167020,1.8945254529494604e-05
WA22,3p,16,A>-,29,39,68,1513637,1653341,3166978,2.147157321585436e-05
WA22,3p,17,A>-,36,39,75,1513671,1653319,3166990,2.368179249066148e-05
WA22,3p,18,A>-,55,36,91,1513665,1653288,3166953,2.873424392468092e-05
WA22,3p,19,A>-,7,13,20,1513662,1653275,3166937,6.315250350733216e-06
WA22,3p,20,A>-,40,77,117,1513684,1653304,3166988,3.694361961586214e-05
WA22,3p,21,A>-,47,17,64,1513677,1653327,3167004,2.02083735922026e-05
WA22,3p,22,A>-,58,16,74,1513684,1653356,3167040,2.3365666363544507e-05
WA22,3p,23,A>-,27,40,67,1513676,1653329,3167005,2.1155634424322037e-05
WA22,3p,24,A>-,107,71,178,1513672,1653285,3166957,5.6205373170522994e-05
WA22,3p,25,A>-,103,79,182,1513669,1653296,3166965,5.746827009455425e-05
WA22,5p,1,A>-,0,0,0,1513709,1653397,3167106,0.0
WA22,5p,2,A>-,0,0,0,1513674,1653378,3167052,0.0
WA22,5p,3,A>-,0,0,0,1513709,1653397,3167106,0.0
WA22,5p,4,A>-,0,0,0,1513709,1653397,3167106,0.0
WA22,5p,5,A>-,0,0,0,1513708,1653396,3167104,0.0
WA22,5p,6,A>-,0,0,0,1513704,1653397,3167101,0.0
WA22,5p,7,A>-,0,0,0,1513707,1653397,3167104,0.0
WA22,5p,8,A>-,0,0,0,1513692,1653397,3167089,0.0
WA22,5p,9,A>-,34,1,35,1513700,1653389,3167089,1.105115770349365e-05
WA22,5p,10,A>-,21,0,21,1513705,1653389,3167094,6.6306841539910085e-06
WA22,5p,11,A>-,4,0,4,1513699,1653381,3167080,1.2629930409083446e-06
WA22,5p,12,A>-,32,2,34,1513692,1653345,3167037,1.0735586606661053e-05
WA22,5p,13,A>-,22,7,29,1513697,1653377,3167074,9.15671689389007e-06
WA22,5p,14,A>-,30,5,35,1513677,1653376,3167053,1.1051283322382038e-05
WA22,5p,15,A>-,16,21,37,1513695,1653381,3167076,1.1682700383571471e-05
WA22,5p,16,A>-,74,16,90,1513668,1653368,3167036,2.8417738225899548e-05
WA22,5p,17,A>-,23,7,30,1513675,1653395,3167070,9.472477715996173e-06
WA22,5p,18,A>-,23,27,50,1513651,1653392,3167043,1.578759745289218e-05
WA22,5p,19,A>-,48,21,69,1513674,1653350,3167024,2.1787015191548916e-05
WA22,5p,20,A>-,62,26,88,1513678,1653356,3167034,2.7786250479154943e-05
WA22,5p,21,A>-,61,13,74,1513690,1653371,3167061,2.336551143157647e-05
WA22,5p,22,A>-,44,33,77,1513691,1653380,3167071,2.431268512767791e-05
WA22,5p,23,A>-,75,22,97,1513634,1653393,3167027,3.06280937926958e-05
WA22,5p,24,A>-,92,31,123,1513632,1653375,3167007,3.88379312076039e-05
WA22,5p,25,A>-,116,67,183,1513644,1653364,3167008,5.778324525861633e-05
WA25,3p,1,A>-,0,0,0,3375244,3569089,6944333,0.0
WA25,3p,2,A>-,0,0,0,3375244,3569089,6944333,0.0
WA25,3p,3,A>-,0,0,0,3375244,3569089,6944333,0.0
WA25,3p,4,A>-,0,0,0,3375244,3569087,6944331,0.0
WA25,3p,5,A>-,0,0,0,3375244,3569089,6944333,0.0
WA25,3p,6,A>-,0,0,0,3375244,3569089,6944333,0.0
WA25,3p,7,A>-,0,0,0,3375244,3569089,6944333,0.0
WA25,3p,8,A>-,0,0,0,3375239,3569076,6944315,0.0
WA25,3p,9,A>-,3,12,15,3375240,3569076,6944316,2.160039952098954e-06
WA25,3p,10,A>-,0,4,4,3375240,3569075,6944315,5.760107368401347e-07
WA25,3p,11,A>-,13,8,21,3375233,3569054,6944287,3.0240685616824305e-06
WA25,3p,12,A>-,6,8,14,3375226,3569069,6944295,2.0160433852536508e-06
WA25,3p,13,A>-,2,15,17,3375230,3569053,6944283,2.4480569124271e-06
WA25,3p,14,A>-,14,8,22,3375223,3569037,6944260,3.168084144314873e-06
WA25,3p,15,A>-,17,27,44,3375218,3569039,6944257,6.336171025928332e-06
WA25,3p,16,A>-,31,27,58,3375196,3569030,6944226,8.352262728776396e-06
WA25,3p,17,A>-,21,13,34,3375198,3569022,6944220,4.896158243834441e-06
WA25,3p,18,A>-,29,17,46,3375213,3569006,6944219,6.624215048517335e-06
WA25,3p,19,A>-,23,17,40,3375204,3569005,6944209,5.760195293661236e-06
WA25,3p,20,A>-,16,23,39,3375190,3568979,6944169,5.616222761859626e-06
WA25,3p,21,A>-,20,15,35,3375199,3568998,6944197,5.040179591679211e-06
WA25,3p,22,A>-,31,33,64,3375179,3568994,6944173,9.216360249089416e-06
WA25,3p,23,A>-,32,56,88,3375175,3568972,6944147,1.2672542790352797e-05
WA25,3p,24,A>-,37,48,85,3375177,3568962,6944139,1.224053838784045e-05
WA25,3p,25,A>-,94,72,166,3375156,3568970,6944126,2.3905096192090984e-05
WA25,5p,1,A>-,0,0,0,3375244,3569089,6944333,0.0
WA25,5p,2,A>-,0,0,0,3375147,3569045,6944192,0.0
WA25,5p,3,A>-,0,0,0,3375243,3569089,6944332,0.0
WA25,5p,4,A>-,0,0,0,3375243,3569089,6944332,0.0
WA25,5p,5,A>-,0,0,0,3375244,3569088,6944332,0.0
WA25,5p,6,A>-,0,0,0,3375244,3569089,6944333,0.0
WA25,5p,7,A>-,0,0,0,3375242,3569089,6944331,0.0
WA25,5p,8,A>-,0,0,0,3375221,3569088,6944309,0.0
WA25,5p,9,A>-,22,0,22,3375227,3569087,6944314,3.168059508829814e-06
WA25,5p,10,A>-,15,1,16,3375217,3569085,6944302,2.3040472606174097e-06
WA25,5p,11,A>-,20,0,20,3375193,3569088,6944281,2.8800677852753942e-06
WA25,5p,12,A>-,16,5,21,3375142,3569084,6944226,3.0240951259362814e-06
WA25,5p,13,A>-,13,4,17,3375133,3569081,6944214,2.4480812371277727e-06
WA25,5p,14,A>-,17,0,17,3375151,3569071,6944222,2.4480784168478486e-06
WA25,5p,15,A>-,34,10,44,3375137,3569055,6944192,6.336230334645125e-06
WA25,5p,16,A>-,41,10,51,3375081,3569035,6944116,7.344347358252656e-06
WA25,5p,17,A>-,46,11,57,3375076,3568871,6943947,8.208587997575443e-06
WA25,5p,18,A>-,39,7,46,3375102,3568996,6944098,6.624330474598716e-06
WA25,5p,19,A>-,55,8,63,3375134,3569021,6944155,9.072378136720738e-06
WA25,5p,20,A>-,40,22,62,3375145,3569019,6944164,8.928360562912973e-06
WA25,5p,21,A>-,53,13,66,3375130,3569013,6944143,9.504412567540733e-06
WA25,5p,22,A>-,37,11,48,3375139,3569001,6944140,6.91230303536507e-06
WA25,5p,23,A>-,60,26,86,3375144,3569002,6944146,1.2384532237657444e-05
WA25,5p,24,A>-,63,49,112,3375124,3568967,6944091,1.6128820892468142e-05
WA25,5p,25,A>-,67,65,132,3375125,3568950,6944075,1.9009011279400063e-05
WA26,3p,1,A>-,0,0,0,2709623,2900126,5609749,0.0
WA26,3p,2,A>-,0,0,0,2709623,2900126,5609749,0.0
WA26,3p,3,A>-,0,0,0,2709623,2900126,5609749,0.0
WA26,3p,4,A>-,0,0,0,2709623,2900126,5609749,0.0
WA26,3p,5,A>-,0,0,0,2709623,2900126,5609749,0.0
WA26,3p,6,A>-,0,0,0,2709623,2900126,5609749,0.0
WA26,3p,7,A>-,0,0,0,2709623,2900126,5609749,0.0
WA26,3p,8,A>-,0,0,0,2709619,2900114,5609733,0.0
WA26,3p,9,A>-,7,11,18,2709613,2900111,5609724,3.208714011598432e-06
WA26,3p,10,A>-,7,10,17,2709609,2900074,5609683,3.0304742710060444e-06
WA26,3p,11,A>-,15,13,28,2709594,2900076,5609670,4.991380954672913e-06
WA26,3p,12,A>-,18,47,65,2709607,2900081,5609688,1.1587097179023147e-05
WA26,3p,13,A>-,29,29,58,2709604,2900084,5609688,1.0339255944359116e-05
WA26,3p,14,A>-,57,30,87,2709584,2900069,5609653,1.5508980680266677e-05
WA26,3p,15,A>-,48,35,83,2709593,2900082,5609675,1.4795866070672543e-05
WA26,3p,16,A>-,50,42,92,2709580,2900075,5609655,1.6400295561848276e-05
WA26,3p,17,A>-,42,54,96,2709570,2900078,5609648,1.7113373245522712e-05
WA26,3p,18,A>-,63,65,128,2709582,2900059,5609641,2.281785946729925e-05
WA26,3p,19,A>-,90,34,124,2709567,2900016,5609583,2.2105029910422933e-05
WA26,3p,20,A>-,73,50,123,2709563,2899983,5609546,2.1926908166899786e-05
WA26,3p,21,A>-,84,52,136,2709562,2900021,5609583,2.4244226353367087e-05
WA26,3p,22,A>-,69,67,136,2709522,2900007,5609529,2.424445973984625e-05
WA26,3p,23,A>-,75,99,174,2709541,2899974,5609515,3.1018724435178444e-05
WA26,3p,24,A>-,114,141,255,2709558,2899951,5609509,4.545852408829365e-05
WA26,3p,25,A>-,212,169,381,2709500,2900002,5609502,6.792046780623307e-05
WA26,5p,1,A>-,0,0,0,2709622,2900126,5609748,0.0
WA26,5p,2,A>-,0,0,0,2709554,2900092,5609646,0.0
WA26,5p,3,A>-,0,0,0,2709623,2900126,5609749,0.0
WA26,5p,4,A>-,0,0,0,2709623,2900126,5609749,0.0
WA26,5p,5,A>-,0,0,0,2709623,2900125,5609748,0.0
WA26,5p,6,A>-,0,0,0,2709621,2900126,5609747,0.0
WA26,5p,7,A>-,4,0,4,2709622,2900126,5609748,7.130445075251152e-07
WA26,5p,8,A>-,3,0,3,2709609,2900124,5609733,5.34784810613981e-07
WA26,5p,9,A>-,22,2,24,2709594,2900123,5609717,4.278290687391182e-06
WA26,5p,10,A>-,26,17,43,2709601,2900123,5609724,7.665261249929586e-06
WA26,5p,11,A>-,19,31,50,2709605,2900103,5609708,8.913119898575827e-06
WA26,5p,12,A>-,38,4,42,2709595,2900107,5609702,7.487028722737857e-06
WA26,5p,13,A>-,43,1,44,2709592,2900104,5609696,7.843562289293395e-06
WA26,5p,14,A>-,64,22,86,2709563,2900089,5609652,1.533071926743406e-05
WA26,5p,15,A>-,68,14,82,2709545,2900085,5609630,1.4617719885268724e-05
WA26,5p,16,A>-,57,22,79,2709540,2900076,5609616,1.4082960402280656e-05
WA26,5p,17,A>-,79,32,111,2709554,2900055,5609609,1.978747538375669e-05
WA26,5p,18,A>-,59,23,82,2709554,2900082,5609636,1.4617704250329254e-05
WA26,5p,19,A>-,64,46,110,2709570,2900086,5609656,1.9609045545751827e-05
WA26,5p,20,A>-,74,39,113,2709563,2900082,5609645,2.0143877197220145e-05
WA26,5p,21,A>-,104,32,136,2709545,2900061,5609606,2.4244126949379333e-05
WA26,5p,22,A>-,111,47,158,2709542,2900059,5609601,2.8165996119866634e-05
WA26,5p,23,A>-,113,47,160,2709528,2900065,5609593,2.852256839310802e-05
WA26,5p,24,A>-,148,98,246,2709495,2900057,5609552,4.385376942757639e-05
WA26,5p,25,A>-,218,144,362,2709506,2900041,5609547,6.45328401740818e-05
