Sample,End,Position,Substitution,Pos_Count,Neg_Count,Combined_Count,Pos_Total,Neg_Total,Combined_Total,Frequency
DAL192,3p,1,A>C,10,1,11,6350003,6167708,12517711,8.787549097434826e-07
DAL192,3p,2,A>C,6,9,15,6350003,6167706,12517709,1.1983023411073063e-06
DAL192,3p,3,A>C,149,126,275,6350003,6167708,12517711,2.1968872743587066e-05
DAL192,3p,4,A>C,127,149,276,6350003,6167708,12517711,2.2048759553563745e-05
DAL192,3p,5,A>C,300,238,538,6350003,6167708,12517711,4.297910376745397e-05
DAL192,3p,6,A>C,299,184,483,6350003,6167708,12517711,3.858532921873656e-05
DAL192,3p,7,A>C,310,194,504,6350003,6167708,12517711,4.026295222824685e-05
DAL192,3p,8,A>C,325,258,583,6350003,6167618,12517621,4.657434507723153e-05
DAL192,3p,9,A>C,329,234,563,6350003,6167637,12517640,4.497652912210289e-05
DAL192,3p,10,A>C,407,296,703,6350003,6167645,12517648,5.61607100631045e-05
DAL192,3p,11,A>C,386,327,713,6349987,6167644,12517631,5.695965953941285e-05
DAL192,3p,12,A>C,471,447,918,6349997,6167646,12517643,7.333648994463254e-05
DAL192,3p,13,A>C,738,262,1000,6349992,6167621,12517613,7.98874354080127e-05
DAL192,3p,14,A>C,721,404,1125,6349967,6167610,12517577,8.987362330585224e-05
DAL192,3p,15,A>C,600,407,1007,6349968,6167615,12517583,8.044684025662142e-05
DAL192,3p,16,A>C,592,445,1037,6349943,6167587,12517530,8.28438198270745e-05
DAL192,3p,17,A>C,730,372,1102,6349922,6167606,12517528,8.803655162584817e-05
DAL192,3p,18,A>C,553,435,988,6349922,6167564,12517486,7.89295869793663e-05
DAL192,3p,19,A>C,495,442,937,6349921,6167519,12517440,7.485556152056651e-05
DAL192,3p,20,A>C,491,398,889,6349910,6167516,12517426,7.102099105678755e-05
DAL192,3p,21,A>C,677,514,1191,6349882,6167507,12517389,9.514763821752285e-05
DAL192,3p,22,A>C,892,440,1332,6349894,6167488,12517382,0.0001064120276907
DAL192,3p,23,A>C,714,491,1205,6349902,6167465,12517367,9.626625152078708e-05
DAL192,3p,24,A>C,748,517,1265,6349899,6167465,12517364,0.0001010596160661
DAL192,3p,25,A>C,567,501,1068,6349856,6167384,12517240,8.53223234514957e-05
DAL192,5p,1,A>C,2,11,13,6350003,6167708,12517711,1.0385285296968431e-06
DAL192,5p,2,A>C,9,18,27,6349992,6167694,12517686,2.156948177163096e-06
DAL192,5p,3,A>C,28,47,75,6350003,6167707,12517710,5.991511226893737e-06
DAL192,5p,4,A>C,89,43,132,6350003,6167708,12517711,1.0545058916921792e-05
DAL192,5p,5,A>C,192,115,307,6350003,6167707,12517710,2.452525262208503e-05
DAL192,5p,6,A>C,202,146,348,6350002,6167707,12517709,2.780061431368951e-05
DAL192,5p,7,A>C,233,190,423,6350002,6167708,12517710,3.379212331968068e-05
DAL192,5p,8,A>C,296,234,530,6349926,6167708,12517634,4.2340269734679895e-05
DAL192,5p,9,A>C,342,213,555,6349914,6167708,12517622,4.43374947733683e-05
DAL192,5p,10,A>C,417,179,596,6349896,6167708,12517604,4.761294573626071e-05
DAL192,5p,11,A>C,414,519,933,6349942,6167706,12517648,7.453476883197226e-05
DAL192,5p,12,A>C,472,361,833,6349906,6167700,12517606,6.6546270908351e-05
DAL192,5p,13,A>C,687,302,989,6349906,6167705,12517611,7.90086862421272e-05
DAL192,5p,14,A>C,426,299,725,6349889,6167679,12517568,5.791859888438393e-05
DAL192,5p,15,A>C,533,558,1091,6349890,6167649,12517539,8.715770727776442e-05
DAL192,5p,16,A>C,473,428,901,6349904,6167639,12517543,7.197898181775769e-05
DAL192,5p,17,A>C,492,404,896,6349778,6167623,12517401,7.158035442021871e-05
DAL192,5p,18,A>C,636,629,1265,6349859,6167631,12517490,0.0001010585988085
DAL192,5p,19,A>C,509,649,1158,6349822,6167638,12517460,9.251078094118136e-05
DAL192,5p,20,A>C,718,672,1390,6349836,6167621,12517457,0.0001110449191077
DAL192,5p,21,A>C,579,481,1060,6349784,6167624,12517408,8.468206836431313e-05
DAL192,5p,22,A>C,437,608,1045,6349783,6167584,12517367,8.348401065495643e-05
DAL192,5p,23,A>C,609,426,1035,6349801,6167567,12517368,8.26851139952105e-05
DAL192,5p,24,A>C,596,576,1172,6349759,6167564,12517323,9.363024346339868e-05
DAL192,5p,25,A>C,636,626,1262,6349777,6167551,12517328,0.0001008202389519
DAL193,3p,1,A>C,25,6,31,6484405,6362696,12847101,2.4129957412181937e-06
DAL193,3p,2,A>C,61,9,70,6484402,6362696,12847098,5.448701333172674e-06
DAL193,3p,3,A>C,294,301,595,6484405,6362696,12847101,4.631395051692985e-05
DAL193,3p,4,A>C,180,303,483,6484405,6362696,12847101,3.759603041962541e-05
DAL193,3p,5,A>C,1030,1046,2076,6484405,6362696,12847101,0.0001615928760893
DAL193,3p,6,A>C,1085,963,2048,6484405,6362696,12847101,0.0001594133960649
DAL193,3p,7,A>C,1114,913,2027,6484405,6362696,12847101,0.0001577787860467
DAL193,3p,8,A>C,1108,1830,2938,6484400,6362644,12847044,0.0002286907400644
DAL193,3p,9,A>C,1376,1280,2656,6484400,6362631,12847031,0.000206740374488
DAL193,3p,10,A>C,1418,1216,2634,6484393,6362640,12847033,0.0002050278846485
DAL193,3p,11,A>C,1314,1262,2576,6484398,6362639,12847037,0.0002005131611281
DAL193,3p,12,A>C,1723,1655,3378,6484368,6362594,12846962,0.0002629415421326
DAL193,3p,13,A>C,1296,1613,2909,6484385,6362543,12846928,0.0002264354560094
DAL193,3p,14,A>C,1169,1336,2505,6484363,6362486,12846849,0.0001949894483853
DAL193,3p,15,A>C,1311,1307,2618,6484332,6362438,12846770,0.0002037866327489
DAL193,3p,16,A>C,1650,1094,2744,6484341,6362460,12846801,0.0002135940301402
DAL193,3p,17,A>C,1334,1529,2863,6484294,6362445,12846739,0.0002228581120858
DAL193,3p,18,A>C,1262,1573,2835,6484244,6362380,12846624,0.0002206805461107
DAL193,3p,19,A>C,1627,1351,2978,6484265,6362400,12846665,0.0002318111354191
DAL193,3p,20,A>C,1268,1212,2480,6484261,6362382,12846643,0.0001930465414194
DAL193,3p,21,A>C,1655,1435,3090,6484248,6362443,12846691,0.0002405288645924
DAL193,3p,22,A>C,1339,1423,2762,6484224,6362407,12846631,0.0002149980021999
DAL193,3p,23,A>C,1332,1193,2525,6484218,6362399,12846617,0.0001965497998422
DAL193,3p,24,A>C,1492,1521,3013,6484164,6362319,12846483,0.0002345389006469
DAL193,3p,25,A>C,1688,1285,2973,6484128,6362355,12846483,0.0002314252079732
DAL193,5p,1,A>C,5,49,54,6484405,6362696,12847101,4.203282904057499e-06
DAL193,5p,2,A>C,77,67,144,6484386,6362681,12847067,1.1208784074995484e-05
DAL193,5p,3,A>C,132,106,238,6484400,6362696,12847096,1.852558741679832e-05
DAL193,5p,4,A>C,244,288,532,6484403,6362696,12847099,4.141012690880642e-05
DAL193,5p,5,A>C,517,679,1196,6484403,6362696,12847099,9.30949469603994e-05
DAL193,5p,6,A>C,882,572,1454,6484404,6362696,12847100,0.0001131772929299
DAL193,5p,7,A>C,936,910,1846,6484404,6362696,12847100,0.0001436900156455
DAL193,5p,8,A>C,1297,1066,2363,6484314,6362693,12847007,0.0001839338921509
DAL193,5p,9,A>C,1395,1339,2734,6484295,6362695,12846990,0.0002128124953782
DAL193,5p,10,A>C,1205,821,2026,6484284,6362694,12846978,0.0001577024573405
DAL193,5p,11,A>C,1116,1330,2446,6484315,6362677,12846992,0.0001903947632255
DAL193,5p,12,A>C,1664,1538,3202,6484218,6362670,12846888,0.0002492432408533
DAL193,5p,13,A>C,1112,1279,2391,6484143,6362652,12846795,0.000186116459397
DAL193,5p,14,A>C,1070,1246,2316,6484145,6362627,12846772,0.0001802787501794
DAL193,5p,15,A>C,1475,1263,2738,6484166,6362534,12846700,0.0002131286633921
DAL193,5p,16,A>C,1516,1155,2671,6484111,6362519,12846630,0.000207914449159
DAL193,5p,17,A>C,1807,1358,3165,6484043,6362598,12846641,0.000246367902707
DAL193,5p,18,A>C,1355,1153,2508,6483967,6362571,12846538,0.0001952276948077
DAL193,5p,19,A>C,1208,1201,2409,6483980,6362593,12846573,0.0001875208275389
DAL193,5p,20,A>C,1229,1157,2386,6483952,6362554,12846506,0.000185731435458
DAL193,5p,21,A>C,1390,1186,2576,6484003,6362532,12846535,0.0002005209965177
DAL193,5p,22,A>C,1466,1848,3314,6484010,6362499,12846509,0.0002579689159132
DAL193,5p,23,A>C,1389,1415,2804,6483966,6362463,12846429,0.0002182707739248
DAL193,5p,24,A>C,1345,1429,2774,6483905,6362426,12846331,0.0002159371418967
DAL193,5p,25,A>C,1204,1222,2426,6483942,6362403,12846345,0.0001888474893053
DAL195,3p,1,A>C,5,7,12,2363278,2267461,4630739,2.5913790433881077e-06
DAL195,3p,2,A>C,25,4,29,2363278,2267460,4630738,6.262500707230683e-06
DAL195,3p,3,A>C,93,72,165,2363278,2267461,4630739,3.563146184658647e-05
DAL195,3p,4,A>C,85,49,134,2363278,2267461,4630739,2.893706598450053e-05
DAL195,3p,5,A>C,248,122,370,2363278,2267461,4630739,7.990085383779997e-05
DAL195,3p,6,A>C,295,113,408,2363278,2267461,4630739,8.810688747519564e-05
DAL195,3p,7,A>C,261,179,440,2363278,2267461,4630739,9.501723159089726e-05
DAL195,3p,8,A>C,246,131,377,2363278,2267413,4630691,8.141333550435561e-05
DAL195,3p,9,A>C,219,175,394,2363276,2267438,4630714,8.50840712684912e-05
DAL195,3p,10,A>C,229,216,445,2363274,2267432,4630706,9.609765767898028e-05
DAL195,3p,11,A>C,303,222,525,2363274,2267431,4630705,0.0001133736655649
DAL195,3p,12,A>C,270,206,476,2363273,2267414,4630687,0.00010279252301
DAL195,3p,13,A>C,306,164,470,2363269,2267412,4630681,0.0001014969504485
DAL195,3p,14,A>C,278,218,496,2363250,2267410,4630660,0.0001071121611174
DAL195,3p,15,A>C,248,202,450,2363254,2267411,4630665,9.71782670523564e-05
DAL195,3p,16,A>C,236,231,467,2363259,2267394,4630653,0.0001008497073738
DAL195,3p,17,A>C,320,234,554,2363234,2267398,4630632,0.0001196380969163
DAL195,3p,18,A>C,285,204,489,2363236,2267374,4630610,0.0001056016377971
DAL195,3p,19,A>C,327,186,513,2363215,2267369,4630584,0.0001107851623035
DAL195,3p,20,A>C,304,185,489,2363222,2267380,4630602,0.0001056018202384
DAL195,3p,21,A>C,324,303,627,2363235,2267382,4630617,0.0001354031223052
DAL195,3p,22,A>C,274,214,488,2363231,2267383,4630614,0.0001053855924937
DAL195,3p,23,A>C,291,259,550,2363219,2267370,4630589,0.0001187753868892
DAL195,3p,24,A>C,273,195,468,2363198,2267373,4630571,0.0001010674493491
DAL195,3p,25,A>C,337,210,547,2363180,2267377,4630557,0.0001181283374764
DAL195,5p,1,A>C,5,32,37,2363278,2267461,4630739,7.990085383779997e-06
DAL195,5p,2,A>C,5,22,27,2363264,2267447,4630711,5.830638102874483e-06
DAL195,5p,3,A>C,11,45,56,2363278,2267459,4630737,1.2093107425448692e-05
DAL195,5p,4,A>C,83,29,112,2363278,2267461,4630739,2.4186204404955668e-05
DAL195,5p,5,A>C,182,126,308,2363277,2267461,4630738,6.651207647679484e-05
DAL195,5p,6,A>C,224,98,322,2363277,2267461,4630738,6.953535268028552e-05
DAL195,5p,7,A>C,189,187,376,2363277,2267461,4630738,8.119656089374955e-05
DAL195,5p,8,A>C,297,210,507,2363212,2267460,4630672,0.0001094873487044
DAL195,5p,9,A>C,268,232,500,2363181,2267461,4630642,0.0001079763885871
DAL195,5p,10,A>C,276,205,481,2363146,2267458,4630604,0.0001038741382333
DAL195,5p,11,A>C,388,230,618,2362948,2267450,4630398,0.0001334658489399
DAL195,5p,12,A>C,381,262,643,2362864,2267454,4630318,0.0001388673520911
DAL195,5p,13,A>C,301,172,473,2363073,2267445,4630518,0.000102148398948
DAL195,5p,14,A>C,429,214,643,2363094,2267434,4630528,0.0001388610542901
DAL195,5p,15,A>C,299,252,551,2363178,2267432,4630610,0.0001189908025076
DAL195,5p,16,A>C,391,270,661,2363170,2267429,4630599,0.0001427461112482
DAL195,5p,17,A>C,318,293,611,2363159,2267431,4630590,0.0001319486285764
DAL195,5p,18,A>C,615,284,899,2363182,2267420,4630602,0.0001941432237104
DAL195,5p,19,A>C,348,320,668,2363138,2267420,4630558,0.0001442590720168
DAL195,5p,20,A>C,278,326,604,2363110,2267401,4630511,0.000130439167513
DAL195,5p,21,A>C,325,257,582,2363086,2267400,4630486,0.0001256887505976
DAL195,5p,22,A>C,372,229,601,2363094,2267388,4630482,0.0001297921037162
DAL195,5p,23,A>C,321,213,534,2363068,2267398,4630466,0.000115323166178
DAL195,5p,24,A>C,395,239,634,2363067,2267402,4630469,0.0001369191760057
DAL195,5p,25,A>C,312,234,546,2363135,2267374,4630509,0.0001179136030185
DAL212,3p,1,A>C,8,6,14,4131322,4008153,8139475,1.7200126543788143e-06
DAL212,3p,2,A>C,21,8,29,4131322,4008153,8139475,3.562883355498973e-06
DAL212,3p,3,A>C,106,117,223,4131322,4008153,8139475,2.7397344423319687e-05
DAL212,3p,4,A>C,101,101,202,4131322,4008153,8139475,2.4817325441751465e-05
DAL212,3p,5,A>C,391,304,695,4131322,4008151,8139473,8.538636346603766e-05
DAL212,3p,6,A>C,422,306,728,4131322,4008151,8139473,8.944068000471284e-05
DAL212,3p,7,A>C,360,391,751,4131322,4008153,8139475,9.226639310274926e-05
DAL212,3p,8,A>C,486,365,851,4131319,4008093,8139412,0.0001045530070231
DAL212,3p,9,A>C,433,493,926,4131316,4008115,8139431,0.0001137671662798
DAL212,3p,10,A>C,544,451,995,4131317,4008102,8139419,0.0001222445975566
DAL212,3p,11,A>C,524,480,1004,4131313,4008105,8139418,0.0001233503427394
DAL212,3p,12,A>C,591,575,1166,4131314,4008034,8139348,0.0001432547176997
DAL212,3p,13,A>C,505,459,964,4131307,4007923,8139230,0.0001184387220904
DAL212,3p,14,A>C,487,459,946,4131271,4007904,8139175,0.0001162279960806
DAL212,3p,15,A>C,643,491,1134,4131254,4007935,8139189,0.0001393259205554
DAL212,3p,16,A>C,503,507,1010,4131236,4007982,8139218,0.0001240905453079
DAL212,3p,17,A>C,493,542,1035,4131249,4007981,8139230,0.0001271619059788
DAL212,3p,18,A>C,592,513,1105,4131222,4007954,8139176,0.0001357631288474
DAL212,3p,19,A>C,604,578,1182,4131233,4007956,8139189,0.0001452233140181
DAL212,3p,20,A>C,568,520,1088,4131221,4007928,8139149,0.000133674908765
DAL212,3p,21,A>C,501,578,1079,4131228,4007917,8139145,0.0001325692072078
DAL212,3p,22,A>C,541,575,1116,4131183,4007898,8139081,0.0001371162174206
DAL212,3p,23,A>C,585,592,1177,4131172,4007904,8139076,0.0001446110098984
DAL212,3p,24,A>C,546,516,1062,4131124,4007904,8139028,0.0001304824114132
DAL212,3p,25,A>C,519,564,1083,4131071,4007924,8138995,0.0001330631116003
DAL212,5p,1,A>C,3,8,11,4131322,4008153,8139475,1.3514385141547826e-06
DAL212,5p,2,A>C,4,96,100,4131307,4008143,8139450,1.2285842409499412e-05
DAL212,5p,3,A>C,15,53,68,4131321,4008153,8139474,8.354348204810287e-06
DAL212,5p,4,A>C,48,38,86,4131322,4008153,8139475,1.0565792019755574e-05
DAL212,5p,5,A>C,425,430,855,4131322,4008153,8139475,0.0001050436299638
DAL212,5p,6,A>C,515,374,889,4131322,4008153,8139475,0.000109220803553
DAL212,5p,7,A>C,525,446,971,4131322,4008153,8139475,0.0001192951633858
DAL212,5p,8,A>C,695,443,1138,4131248,4008153,8139401,0.0001398137283075
DAL212,5p,9,A>C,541,897,1438,4131243,4008153,8139396,0.0001766715859506
DAL212,5p,10,A>C,444,448,892,4131179,4008148,8139327,0.0001095913703921
DAL212,5p,11,A>C,594,515,1109,4131234,4008143,8139377,0.0001362512143128
DAL212,5p,12,A>C,711,968,1679,4131187,4008141,8139328,0.000206282385966
DAL212,5p,13,A>C,700,653,1353,4131181,4008142,8139323,0.0001662300414911
DAL212,5p,14,A>C,484,483,967,4131134,4008108,8139242,0.0001188071321629
DAL212,5p,15,A>C,581,765,1346,4131156,4008091,8139247,0.0001653715632416
DAL212,5p,16,A>C,515,753,1268,4131154,4008081,8139235,0.0001557885968398
DAL212,5p,17,A>C,682,549,1231,4131159,4008081,8139240,0.0001512426221612
DAL212,5p,18,A>C,609,570,1179,4131113,4008066,8139179,0.0001448549048988
DAL212,5p,19,A>C,735,503,1238,4131040,4008052,8139092,0.0001521054191302
DAL212,5p,20,A>C,487,562,1049,4131020,4008040,8139060,0.0001288846623565
DAL212,5p,21,A>C,496,563,1059,4130973,4008040,8139013,0.0001301140568272
DAL212,5p,22,A>C,482,573,1055,4131015,4007967,8138982,0.0001296230904552
DAL212,5p,23,A>C,447,478,925,4131005,4007962,8138967,0.0001136507863958
DAL212,5p,24,A>C,584,562,1146,4131060,4007918,8138978,0.0001408039191161
DAL212,5p,25,A>C,568,506,1074,4131016,4007614,8138630,0.0001319632419707
DAL218,3p,1,A>C,34,10,44,6952891,6658031,13610922,3.232697975934327e-06
DAL218,3p,2,A>C,32,22,54,6952891,6658031,13610922,3.9674020613739465e-06
DAL218,3p,3,A>C,280,350,630,6952891,6658030,13610921,4.628636078337388e-05
DAL218,3p,4,A>C,498,312,810,6952891,6658031,13610922,5.95110309206092e-05
DAL218,3p,5,A>C,1063,1102,2165,6952891,6658031,13610922,0.0001590634344976
DAL218,3p,6,A>C,974,788,1762,6952891,6658030,13610921,0.0001294548693655
DAL218,3p,7,A>C,1007,725,1732,6952891,6658026,13610917,0.0001272507943439
DAL218,3p,8,A>C,1411,910,2321,6952887,6657945,13610832,0.0001705259458055
DAL218,3p,9,A>C,1324,1036,2360,6952882,6657945,13610827,0.0001733913743815
DAL218,3p,10,A>C,1308,1129,2437,6952881,6657960,13610841,0.0001790484511574
DAL218,3p,11,A>C,1399,930,2329,6952866,6657905,13610771,0.0001711144798483
DAL218,3p,12,A>C,1211,1089,2300,6952858,6657882,13610740,0.0001689841992426
DAL218,3p,13,A>C,1175,1069,2244,6952870,6657811,13610681,0.0001648705160307
DAL218,3p,14,A>C,1172,990,2162,6952816,6657779,13610595,0.0001588468395393
DAL218,3p,15,A>C,2043,1127,3170,6952788,6657738,13610526,0.0002329079713745
DAL218,3p,16,A>C,2148,1025,3173,6952760,6657689,13610449,0.0002331297079177
DAL218,3p,17,A>C,1332,1264,2596,6952737,6657651,13610388,0.0001907366637894
DAL218,3p,18,A>C,1428,1267,2695,6952711,6657672,13610383,0.0001980105923543
DAL218,3p,19,A>C,1183,1193,2376,6952716,6657697,13610413,0.0001745722190796
DAL218,3p,20,A>C,1286,3185,4471,6952697,6657752,13610449,0.0003284976123858
DAL218,3p,21,A>C,1294,1498,2792,6952660,6657692,13610352,0.0002051379714499
DAL218,3p,22,A>C,1369,1064,2433,6952654,6657637,13610291,0.0001787617913533
DAL218,3p,23,A>C,1301,1187,2488,6952651,6657632,13610283,0.0001828029586159
DAL218,3p,24,A>C,1551,2368,3919,6952669,6657588,13610257,0.0002879445994296
DAL218,3p,25,A>C,1833,1391,3224,6952605,6657566,13610171,0.0002368816673941
DAL218,5p,1,A>C,9,51,60,6952891,6658031,13610922,4.408224512637719e-06
DAL218,5p,2,A>C,50,38,88,6952874,6658014,13610888,6.465412102428585e-06
DAL218,5p,3,A>C,63,66,129,6952891,6658031,13610922,9.477682702171094e-06
DAL218,5p,4,A>C,210,327,537,6952891,6658031,13610922,3.945360938810758e-05
DAL218,5p,5,A>C,567,749,1316,6952891,6658031,13610922,9.668705764385396e-05
DAL218,5p,6,A>C,1139,818,1957,6952891,6658031,13610922,0.0001437815895205
DAL218,5p,7,A>C,962,698,1660,6952888,6658031,13610919,0.0001219609050645
DAL218,5p,8,A>C,1275,814,2089,6952719,6658029,13610748,0.0001534816455348
DAL218,5p,9,A>C,1625,843,2468,6952736,6658029,13610765,0.0001813270598676
DAL218,5p,10,A>C,1167,703,1870,6952716,6658028,13610744,0.000137391460746
DAL218,5p,11,A>C,1512,1229,2741,6952715,6658016,13610731,0.0002013852158271
DAL218,5p,12,A>C,2172,1011,3183,6952625,6658005,13610630,0.0002338613275065
DAL218,5p,13,A>C,1400,818,2218,6952475,6658005,13610480,0.0001629626581869
DAL218,5p,14,A>C,1620,1304,2924,6952554,6657955,13610509,0.0002148339933502
DAL218,5p,15,A>C,1382,973,2355,6952449,6657923,13610372,0.0001730298040347
DAL218,5p,16,A>C,1736,2038,3774,6952253,6657920,13610173,0.0002772925810715
DAL218,5p,17,A>C,1593,1151,2744,6952350,6657874,13610224,0.0002016131402392
DAL218,5p,18,A>C,1739,1066,2805,6952457,6657843,13610300,0.0002060939141679
DAL218,5p,19,A>C,1775,1088,2863,6952296,6657770,13610066,0.0002103590092803
DAL218,5p,20,A>C,2028,898,2926,6952289,6657772,13610061,0.0002149880151161
DAL218,5p,21,A>C,1680,1224,2904,6952371,6657729,13610100,0.0002133709524544
DAL218,5p,22,A>C,2109,834,2943,6952322,6657786,13610108,0.0002162363443405
DAL218,5p,23,A>C,1517,992,2509,6952288,6657745,13610033,0.0001843492958466
DAL218,5p,24,A>C,2156,934,3090,6952375,6657772,13610147,0.0002270364897601
DAL218,5p,25,A>C,1488,827,2315,6952272,6657720,13609992,0.0001700956179841
DAL224,3p,1,A>C,18,12,30,4609472,4586477,9195949,3.262306043672056e-06
DAL224,3p,2,A>C,30,25,55,4609471,4586476,9195947,5.980895714166252e-06
DAL224,3p,3,A>C,167,164,331,4609472,4586477,9195949,3.5994110015181685e-05
DAL224,3p,4,A>C,148,168,316,4609472,4586477,9195949,3.436295699334566e-05
DAL224,3p,5,A>C,287,475,762,4609472,4586477,9195949,8.286257350927022e-05
DAL224,3p,6,A>C,383,1029,1412,4609472,4586477,9195949,0.0001535458711221
DAL224,3p,7,A>C,267,444,711,4609472,4586476,9195948,7.731666164271481e-05
DAL224,3p,8,A>C,294,450,744,4609469,4586423,9195892,8.090569136740624e-05
DAL224,3p,9,A>C,821,1787,2608,4609466,4586431,9195897,0.0002836047424193
DAL224,3p,10,A>C,595,960,1555,4609461,4586371,9195832,0.0001690983480341
DAL224,3p,11,A>C,584,576,1160,4609461,4586382,9195843,0.0001261439543933
DAL224,3p,12,A>C,473,739,1212,4609458,4586384,9195842,0.0001317986977157
DAL224,3p,13,A>C,552,677,1229,4609454,4586364,9195818,0.0001336477081212
DAL224,3p,14,A>C,597,812,1409,4609412,4586293,9195705,0.0001532237060671
DAL224,3p,15,A>C,1041,621,1662,4609400,4586272,9195672,0.0001807371989779
DAL224,3p,16,A>C,481,829,1310,4609379,4586240,9195619,0.0001424591427722
DAL224,3p,17,A>C,689,640,1329,4609381,4586216,9195597,0.0001445256898491
DAL224,3p,18,A>C,544,681,1225,4609363,4586282,9195645,0.0001332152339504
DAL224,3p,19,A>C,512,1577,2089,4609353,4586195,9195548,0.0002271751504097
DAL224,3p,20,A>C,725,1063,1788,4609344,4586225,9195569,0.0001944414750191
DAL224,3p,21,A>C,848,747,1595,4609343,4586223,9195566,0.0001734531621
DAL224,3p,22,A>C,1498,671,2169,4609324,4586172,9195496,0.00023587634642
DAL224,3p,23,A>C,836,882,1718,4609323,4586083,9195406,0.0001868324247999
DAL224,3p,24,A>C,974,653,1627,4609325,4586202,9195527,0.0001769338505558
DAL224,3p,25,A>C,1239,841,2080,4609265,4586173,9195438,0.0002261991217819
DAL224,5p,1,A>C,11,21,32,4609472,4586477,9195949,3.479793113250193e-06
DAL224,5p,2,A>C,21,33,54,4609461,4586469,9195930,5.872163011245192e-06
DAL224,5p,3,A>C,11,76,87,4609468,4586477,9195945,9.460691641805164e-06
DAL224,5p,4,A>C,78,166,244,4609471,4586477,9195948,2.653342537387119e-05
DAL224,5p,5,A>C,232,248,480,4609471,4586477,9195948,5.2196902374828566e-05
DAL224,5p,6,A>C,275,198,473,4609472,4586477,9195949,5.143569195522941e-05
DAL224,5p,7,A>C,454,396,850,4609471,4586477,9195948,9.243201462209225e-05
DAL224,5p,8,A>C,655,684,1339,4609397,4586477,9195874,0.0001456087806335
DAL224,5p,9,A>C,723,534,1257,4609357,4586473,9195830,0.0001366923920951
DAL224,5p,10,A>C,441,315,756,4609338,4586470,9195808,8.221137283423056e-05
DAL224,5p,11,A>C,1349,519,1868,4609388,4586469,9195857,0.0002031349552303
DAL224,5p,12,A>C,761,776,1537,4609357,4586464,9195821,0.0001671411394371
DAL224,5p,13,A>C,452,951,1403,4609320,4586461,9195781,0.0001525699665966
DAL224,5p,14,A>C,1299,1169,2468,4609270,4586428,9195698,0.0002683863693653
DAL224,5p,15,A>C,530,628,1158,4609299,4586416,9195715,0.0001259282176535
DAL224,5p,16,A>C,690,565,1255,4609292,4586373,9195665,0.0001364773510126
DAL224,5p,17,A>C,1580,595,2175,4609285,4586385,9195670,0.0002365243641844
DAL224,5p,18,A>C,572,1275,1847,4609226,4586351,9195577,0.0002008574339598
DAL224,5p,19,A>C,810,1214,2024,4609203,4586337,9195540,0.0002201067039021
DAL224,5p,20,A>C,2842,1226,4068,4609148,4586313,9195461,0.0004423921758789
DAL224,5p,21,A>C,651,729,1380,4609195,4586347,9195542,0.0001500727200202
DAL224,5p,22,A>C,1991,551,2542,4609138,4586312,9195450,0.0002764410659619
DAL224,5p,23,A>C,826,1311,2137,4609100,4586313,9195413,0.0002323984795462
DAL224,5p,24,A>C,1513,901,2414,4609109,4586316,9195425,0.0002625218518991
DAL224,5p,25,A>C,2611,1865,4476,4609125,4586257,9195382,0.0004867660745361
DAL227,3p,1,A>C,9,17,26,3765386,3771243,7536629,3.449818214482894e-06
DAL227,3p,2,A>C,13,31,44,3765386,3771243,7536629,5.83815390143259e-06
DAL227,3p,3,A>C,95,248,343,3765386,3771243,7536629,4.551106336798587e-05
DAL227,3p,4,A>C,100,130,230,3765386,3771243,7536629,3.051762266657945e-05
DAL227,3p,5,A>C,206,270,476,3765386,3771243,7536629,6.31582103882253e-05
DAL227,3p,6,A>C,348,253,601,3765386,3771243,7536629,7.974387488093152e-05
DAL227,3p,7,A>C,416,160,576,3765386,3771243,7536629,7.642674198239027e-05
DAL227,3p,8,A>C,436,266,702,3765386,3771207,7536593,9.3145536716657e-05
DAL227,3p,9,A>C,278,289,567,3765384,3771218,7536602,7.523284366084344e-05
DAL227,3p,10,A>C,398,366,764,3765382,3771209,7536591,0.0001013720925017
DAL227,3p,11,A>C,375,340,715,3765378,3771214,7536592,9.487046665123972e-05
DAL227,3p,12,A>C,497,355,852,3765377,3771173,7536550,0.0001130490741785
DAL227,3p,13,A>C,360,368,728,3765373,3771183,7536556,9.65958456355927e-05
DAL227,3p,14,A>C,296,317,613,3765341,3771166,7536507,8.133741533047074e-05
DAL227,3p,15,A>C,328,345,673,3765341,3771186,7536527,8.929842618489922e-05
DAL227,3p,16,A>C,481,270,751,3765340,3771079,7536419,9.964944889608713e-05
DAL227,3p,17,A>C,340,411,751,3765328,3771049,7536377,9.96500042394376e-05
DAL227,3p,18,A>C,448,344,792,3765321,3771036,7536357,0.0001050905629868
DAL227,3p,19,A>C,507,380,887,3765313,3771111,7536424,0.0001176950766039
DAL227,3p,20,A>C,670,319,989,3765308,3771082,7536390,0.0001312299390026
DAL227,3p,21,A>C,500,375,875,3765307,3771104,7536411,0.0001161030097748
DAL227,3p,22,A>C,753,282,1035,3765309,3771137,7536446,0.00013733263663
DAL227,3p,23,A>C,675,350,1025,3765319,3771112,7536431,0.0001360060219485
DAL227,3p,24,A>C,687,341,1028,3765312,3771081,7536393,0.0001364047761309
DAL227,3p,25,A>C,673,353,1026,3765249,3771100,7536349,0.0001361401920213
DAL227,5p,1,A>C,10,11,21,3765386,3771243,7536629,2.786391634774645e-06
DAL227,5p,2,A>C,15,29,44,3765373,3771238,7536611,5.8381678449372006e-06
DAL227,5p,3,A>C,25,26,51,3765386,3771243,7536629,6.7669511130241385e-06
DAL227,5p,4,A>C,163,35,198,3765385,3771243,7536628,2.6271696042314944e-05
DAL227,5p,5,A>C,149,154,303,3765386,3771242,7536628,4.020365606475469e-05
DAL227,5p,6,A>C,131,240,371,3765386,3771243,7536629,4.9226252214352064e-05
DAL227,5p,7,A>C,211,284,495,3765386,3771243,7536629,6.567923139111664e-05
DAL227,5p,8,A>C,426,324,750,3765342,3771242,7536584,9.951458114180111e-05
DAL227,5p,9,A>C,426,309,735,3765324,3771243,7536567,9.752450950147462e-05
DAL227,5p,10,A>C,325,261,586,3765318,3771238,7536556,7.775434827260622e-05
DAL227,5p,11,A>C,448,564,1012,3765365,3771237,7536602,0.0001342780207844
DAL227,5p,12,A>C,475,438,913,3765326,3771232,7536558,0.0001211428346998
DAL227,5p,13,A>C,342,243,585,3765325,3771231,7536556,7.762166167145842e-05
DAL227,5p,14,A>C,523,373,896,3765297,3771226,7536523,0.000118887715197
DAL227,5p,15,A>C,459,313,772,3765318,3771201,7536519,0.0001024345589787
DAL227,5p,16,A>C,623,255,878,3765316,3771188,7536504,0.0001164996396207
DAL227,5p,17,A>C,707,332,1039,3765326,3771175,7536501,0.0001378623846795
DAL227,5p,18,A>C,605,406,1011,3765280,3771169,7536449,0.0001341480583229
DAL227,5p,19,A>C,539,311,850,3765279,3771164,7536443,0.0001127853020317
DAL227,5p,20,A>C,690,408,1098,3765254,3771167,7536421,0.0001456924978049
DAL227,5p,21,A>C,529,484,1013,3765270,3771169,7536439,0.0001344136136443
DAL227,5p,22,A>C,513,340,853,3765253,3771158,7536411,0.0001131838483861
DAL227,5p,23,A>C,486,412,898,3765254,3771157,7536411,0.0001191548603174
DAL227,5p,24,A>C,480,308,788,3765270,3771180,7536450,0.0001045585122969
DAL227,5p,25,A>C,444,348,792,3765247,3771148,7536395,0.0001050900330993
WA02,3p,1,A>C,62,27,89,6552698,6754258,13306956,6.688231328036254e-06
WA02,3p,2,A>C,38,59,97,6552698,6754258,13306956,7.289420660893445e-06
WA02,3p,3,A>C,210,125,335,6552698,6754258,13306956,2.517480331339489e-05
WA02,3p,4,A>C,204,154,358,6552698,6754256,13306954,2.690322668884254e-05
WA02,3p,5,A>C,489,561,1050,6552698,6754256,13306954,7.890611179688454e-05
WA02,3p,6,A>C,623,357,980,6552698,6754257,13306955,7.364569880938201e-05
WA02,3p,7,A>C,575,388,963,6552698,6754257,13306955,7.2368171381056e-05
WA02,3p,8,A>C,638,484,1122,6552692,6754207,13306899,8.431716510360528e-05
WA02,3p,9,A>C,719,648,1367,6552688,6754191,13306879,0.0001027288216868
WA02,3p,10,A>C,762,685,1447,6552680,6754207,13306887,0.000108740684429
WA02,3p,11,A>C,632,548,1180,6552667,6754202,13306869,8.86760063543122e-05
WA02,3p,12,A>C,708,589,1297,6552670,6754189,13306859,9.746853107859638e-05
WA02,3p,13,A>C,612,570,1182,6552675,6754177,13306852,8.88264181490859e-05
WA02,3p,14,A>C,638,595,1233,6552653,6754155,13306808,9.265933648400127e-05
WA02,3p,15,A>C,602,518,1120,6552632,6754146,13306778,8.416763246519931e-05
WA02,3p,16,A>C,725,519,1244,6552629,6754119,13306748,9.348640253802055e-05
WA02,3p,17,A>C,684,535,1219,6552608,6754116,13306724,9.16078217298262e-05
WA02,3p,18,A>C,721,549,1270,6552611,6754085,13306696,9.544067137326951e-05
WA02,3p,19,A>C,735,511,1246,6552605,6754056,13306661,9.363731442470804e-05
WA02,3p,20,A>C,775,611,1386,6552618,6754033,13306651,0.0001041584392646
WA02,3p,21,A>C,798,557,1355,6552597,6754089,13306686,0.0001018285093673
WA02,3p,22,A>C,759,622,1381,6552593,6754062,13306655,0.000103782656122
WA02,3p,23,A>C,790,751,1541,6552585,6754052,13306637,0.0001158068714131
WA02,3p,24,A>C,884,629,1513,6552556,6754026,13306582,0.0001137031282714
WA02,3p,25,A>C,789,577,1366,6552517,6754038,13306555,0.0001026561720896
WA02,5p,1,A>C,109,49,158,6552698,6754258,13306956,1.187348932392953e-05
WA02,5p,2,A>C,265,150,415,6552562,6754179,13306741,3.118720053242188e-05
WA02,5p,3,A>C,363,254,617,6552698,6754258,13306956,4.6366727296610885e-05
WA02,5p,4,A>C,506,330,836,6552698,6754258,13306956,6.28242852835765e-05
WA02,5p,5,A>C,796,736,1532,6552698,6754258,13306956,0.0001151277572421
WA02,5p,6,A>C,1066,951,2017,6552697,6754258,13306955,0.0001515748719372
WA02,5p,7,A>C,891,806,1697,6552685,6754258,13306943,0.000127527411818
WA02,5p,8,A>C,1197,832,2029,6552655,6754257,13306912,0.0001524771487178
WA02,5p,9,A>C,1314,700,2014,6552662,6754226,13306888,0.0001513501879628
WA02,5p,10,A>C,1096,864,1960,6552618,6754222,13306840,0.0001472926705363
WA02,5p,11,A>C,839,396,1235,6552625,6754225,13306850,9.280934255665315e-05
WA02,5p,12,A>C,849,530,1379,6552628,6754236,13306864,0.0001036307277206
WA02,5p,13,A>C,825,381,1206,6552614,6754205,13306819,9.063022499967874e-05
WA02,5p,14,A>C,904,522,1426,6552607,6754183,13306790,0.0001071633354099
WA02,5p,15,A>C,869,527,1396,6552586,6754168,13306754,0.0001049091311074
WA02,5p,16,A>C,939,547,1486,6552525,6754178,13306703,0.0001116730417745
WA02,5p,17,A>C,734,623,1357,6552567,6754148,13306715,0.0001019785875026
WA02,5p,18,A>C,853,601,1454,6552548,6754087,13306635,0.0001092687971076
WA02,5p,19,A>C,813,500,1313,6552516,6754124,13306640,9.867254242994474e-05
WA02,5p,20,A>C,707,533,1240,6552507,6754132,13306639,9.318656649511572e-05
WA02,5p,21,A>C,1075,571,1646,6552521,6754152,13306673,0.0001236973359155
WA02,5p,22,A>C,862,570,1432,6552516,6754117,13306633,0.0001076155027346
WA02,5p,23,A>C,756,556,1312,6552465,6754131,13306596,9.859771800391323e-05
WA02,5p,24,A>C,844,564,1408,6552457,6754135,13306592,0.0001058122169823
WA02,5p,25,A>C,923,647,1570,6552470,6754083,13306553,0.0001179869797985
WA03,3p,1,A>C,79,37,116,5399458,5543742,10943200,1.0600190072373712e-05
WA03,3p,2,A>C,74,68,142,5399458,5543742,10943200,1.297609474376782e-05
WA03,3p,3,A>C,362,250,612,5399458,5543742,10943200,5.5925140726661306e-05
WA03,3p,4,A>C,505,321,826,5399458,5543736,10943194,7.548070517620358e-05
WA03,3p,5,A>C,1081,985,2066,5399458,5543740,10943198,0.0001887930749311
WA03,3p,6,A>C,1037,939,1976,5399458,5543741,10943199,0.0001805687715264
WA03,3p,7,A>C,1236,960,2196,5399458,5543739,10943197,0.0002006726187968
WA03,3p,8,A>C,1315,1103,2418,5399449,5543673,10943122,0.0002209607093843
WA03,3p,9,A>C,1611,1413,3024,5399436,5543670,10943106,0.0002763383631667
WA03,3p,10,A>C,1521,1193,2714,5399438,5543654,10943092,0.0002480103429633
WA03,3p,11,A>C,1460,1017,2477,5399404,5543644,10943048,0.0002263537544567
WA03,3p,12,A>C,1368,1206,2574,5399397,5543595,10942992,0.000235219033332
WA03,3p,13,A>C,1490,1056,2546,5399378,5543551,10942929,0.0002326616575872
WA03,3p,14,A>C,1176,1226,2402,5399356,5543493,10942849,0.0002195040797876
WA03,3p,15,A>C,1639,1203,2842,5399349,5543505,10942854,0.0002597128683248
WA03,3p,16,A>C,1636,1142,2778,5399342,5543495,10942837,0.0002538646970616
WA03,3p,17,A>C,1333,1244,2577,5399346,5543438,10942784,0.0002354976576344
WA03,3p,18,A>C,1483,1279,2762,5399325,5543443,10942768,0.000252404144911
WA03,3p,19,A>C,1472,1259,2731,5399297,5543425,10942722,0.0002495722727855
WA03,3p,20,A>C,1336,1103,2439,5399252,5543409,10942661,0.0002228891126207
WA03,3p,21,A>C,1422,1404,2826,5399248,5543303,10942551,0.0002582578778933
WA03,3p,22,A>C,1490,1290,2780,5399256,5543263,10942519,0.0002540548478828
WA03,3p,23,A>C,1610,1131,2741,5399255,5543267,10942522,0.000250490700407
WA03,3p,24,A>C,1724,1285,3009,5399198,5543130,10942328,0.00027498718737
WA03,3p,25,A>C,1472,1398,2870,5399050,5543142,10942192,0.000262287483166
WA03,5p,1,A>C,126,53,179,5399457,5543742,10943199,1.63571913477951e-05
WA03,5p,2,A>C,242,154,396,5399258,5543638,10942896,3.618786105615917e-05
WA03,5p,3,A>C,422,206,628,5399457,5543742,10943199,5.738724115315823e-05
WA03,5p,4,A>C,624,362,986,5399458,5543742,10943200,9.010161561517656e-05
WA03,5p,5,A>C,1339,1114,2453,5399456,5543740,10943196,0.000224157549586
WA03,5p,6,A>C,1522,1194,2716,5399452,5543742,10943194,0.0002481907932912
WA03,5p,7,A>C,1519,1109,2628,5399453,5543742,10943195,0.0002401492434339
WA03,5p,8,A>C,2220,1203,3423,5399403,5543732,10943135,0.0003127988460345
WA03,5p,9,A>C,2397,1373,3770,5399319,5543732,10943051,0.0003445108681299
WA03,5p,10,A>C,1931,1175,3106,5399344,5543717,10943061,0.0002838328325136
WA03,5p,11,A>C,1805,1145,2950,5399321,5543705,10943026,0.0002695780856227
WA03,5p,12,A>C,2239,1415,3654,5399213,5543665,10942878,0.0003339158126408
WA03,5p,13,A>C,1878,1047,2925,5399156,5543662,10942818,0.0002672986062639
WA03,5p,14,A>C,1832,1493,3325,5399124,5543629,10942753,0.0003038540667051
WA03,5p,15,A>C,1861,1286,3147,5399092,5543505,10942597,0.0002875916932698
WA03,5p,16,A>C,2401,1353,3754,5399083,5543501,10942584,0.0003430633934361
WA03,5p,17,A>C,2062,1327,3389,5399113,5543491,10942604,0.0003097069034025
WA03,5p,18,A>C,1710,1299,3009,5399074,5543600,10942674,0.0002749784924598
WA03,5p,19,A>C,1913,1247,3160,5399071,5543546,10942617,0.0002887791832611
WA03,5p,20,A>C,1770,1208,2978,5399050,5543533,10942583,0.0002721478100737
WA03,5p,21,A>C,1844,1462,3306,5399034,5543509,10942543,0.0003021235557401
WA03,5p,22,A>C,1977,1231,3208,5398989,5543454,10942443,0.0002931703642413
WA03,5p,23,A>C,2012,1336,3348,5398935,5543457,10942392,0.0003059660081634
WA03,5p,24,A>C,2173,1413,3586,5398952,5543428,10942380,0.0003277166393417
WA03,5p,25,A>C,1853,1301,3154,5398991,5543444,10942435,0.0002882356623548
WA07,3p,1,A>C,66,29,95,5691729,6013979,11705708,8.11569876849824e-06
WA07,3p,2,A>C,94,35,129,5691729,6013979,11705708,1.1020264643539716e-05
WA07,3p,3,A>C,236,190,426,5691729,6013979,11705708,3.6392501846107896e-05
WA07,3p,4,A>C,201,303,504,5691729,6013979,11705708,4.305591767708541e-05
WA07,3p,5,A>C,417,439,856,5691729,6013979,11705708,7.312671732457362e-05
WA07,3p,6,A>C,510,465,975,5691729,6013979,11705708,8.329269788721879e-05
WA07,3p,7,A>C,545,489,1034,5691729,6013979,11705708,8.833297396449664e-05
WA07,3p,8,A>C,567,618,1185,5691713,6013800,11705513,0.0001012343500024
WA07,3p,9,A>C,493,500,993,5691720,6013901,11705621,8.483103972014812e-05
WA07,3p,10,A>C,669,744,1413,5691718,6013892,11705610,0.0001207113512239
WA07,3p,11,A>C,708,445,1153,5691711,6013883,11705594,9.849991380189676e-05
WA07,3p,12,A>C,621,481,1102,5691705,6013884,11705589,9.414306277112585e-05
WA07,3p,13,A>C,623,518,1141,5691711,6013848,11705559,9.747505437373816e-05
WA07,3p,14,A>C,623,386,1009,5691695,6013877,11705572,8.619826523641903e-05
WA07,3p,15,A>C,515,672,1187,5691211,6013856,11705067,0.0001014090735234
WA07,3p,16,A>C,573,770,1343,5691636,6013850,11705486,0.0001147325279787
WA07,3p,17,A>C,692,521,1213,5691662,6013813,11705475,0.0001036267216836
WA07,3p,18,A>C,533,443,976,5691639,6013769,11705408,8.338026320825382e-05
WA07,3p,19,A>C,547,562,1109,5691628,6013742,11705370,9.474284025195274e-05
WA07,3p,20,A>C,552,561,1113,5691604,6013772,11705376,9.50845150125891e-05
WA07,3p,21,A>C,666,593,1259,5691611,6013735,11705346,0.0001075576920152
WA07,3p,22,A>C,666,688,1354,5691577,6013736,11705313,0.000115673967881
WA07,3p,23,A>C,831,639,1470,5691568,6013670,11705238,0.000125584802291
WA07,3p,24,A>C,802,767,1569,5691554,6013661,11705215,0.0001340428176671
WA07,3p,25,A>C,791,629,1420,5691455,6013662,11705117,0.0001213144644346
WA07,5p,1,A>C,106,20,126,5691729,6013979,11705708,1.0763979419271353e-05
WA07,5p,2,A>C,274,100,374,5691636,6013923,11705559,3.1950631319700324e-05
WA07,5p,3,A>C,346,194,540,5691729,6013979,11705708,4.613134036830579e-05
WA07,5p,4,A>C,461,241,702,5691728,6013979,11705707,5.997074760200303e-05
WA07,5p,5,A>C,664,555,1219,5691729,6013978,11705707,0.0001041372383573
WA07,5p,6,A>C,934,767,1701,5691728,6013979,11705707,0.000145313734574
WA07,5p,7,A>C,760,629,1389,5691728,6013979,11705707,0.0001186600689731
WA07,5p,8,A>C,1183,607,1790,5691579,6013975,11705554,0.0001529188622768
WA07,5p,9,A>C,1119,603,1722,5691672,6013971,11705643,0.0001471085356011
WA07,5p,10,A>C,1050,627,1677,5691582,6013961,11705543,0.0001432654597911
WA07,5p,11,A>C,664,444,1108,5691326,6013942,11705268,9.465823422411176e-05
WA07,5p,12,A>C,701,378,1079,5691520,6013938,11705458,9.217922100954956e-05
WA07,5p,13,A>C,565,413,978,5691511,6013949,11705460,8.355075323823242e-05
WA07,5p,14,A>C,576,501,1077,5691556,6013950,11705506,9.200798325164243e-05
WA07,5p,15,A>C,608,452,1060,5691563,6013633,11705196,9.055807352563768e-05
WA07,5p,16,A>C,795,440,1235,5691534,6013925,11705459,0.0001055063282866
WA07,5p,17,A>C,648,514,1162,5691561,6013916,11705477,9.926976918582644e-05
WA07,5p,18,A>C,1018,463,1481,5691474,6013905,11705379,0.0001265230284299
WA07,5p,19,A>C,613,473,1086,5691482,6013884,11705366,9.277796183391446e-05
WA07,5p,20,A>C,644,816,1460,5691421,6013876,11705297,0.0001247298552099
WA07,5p,21,A>C,543,473,1016,5691379,6013853,11705232,8.679879219822384e-05
WA07,5p,22,A>C,968,510,1478,5691396,6013861,11705257,0.0001262680520384
WA07,5p,23,A>C,746,475,1221,5691314,6013795,11705109,0.0001043134241637
WA07,5p,24,A>C,846,572,1418,5691332,6013785,11705117,0.0001211435989917
WA07,5p,25,A>C,1047,625,1672,5691334,6013719,11705053,0.0001428442912646
WA08,3p,1,A>C,56,46,102,6798117,7189085,13987202,7.29238056331781e-06
WA08,3p,2,A>C,69,43,112,6798117,7189085,13987202,8.00731983423132e-06
WA08,3p,3,A>C,243,263,506,6798117,7189085,13987202,3.6175927108223646e-05
WA08,3p,4,A>C,217,209,426,6798117,7189081,13987198,3.045642165071232e-05
WA08,3p,5,A>C,648,536,1184,6798117,7189085,13987202,8.464880967615968e-05
WA08,3p,6,A>C,624,352,976,6798117,7189085,13987202,6.977807284115865e-05
WA08,3p,7,A>C,611,473,1084,6798117,7189084,13987201,7.749942250776263e-05
WA08,3p,8,A>C,1003,545,1548,6798110,7189053,13987163,0.0001106729077226
WA08,3p,9,A>C,1315,699,2014,6798103,7189051,13987154,0.0001439892632911
WA08,3p,10,A>C,959,693,1652,6798074,7189042,13987116,0.0001181086937435
WA08,3p,11,A>C,1001,507,1508,6798109,7189046,13987155,0.0001078132043292
WA08,3p,12,A>C,880,617,1497,6798091,7189018,13987109,0.0001070271204721
WA08,3p,13,A>C,1257,584,1841,6798090,7189013,13987103,0.000131621251377
WA08,3p,14,A>C,921,615,1536,6798067,7188981,13987048,0.0001098158810922
WA08,3p,15,A>C,770,555,1325,6798069,7188978,13987047,9.473050315767152e-05
WA08,3p,16,A>C,812,526,1338,6798049,7188961,13987010,9.566018755974293e-05
WA08,3p,17,A>C,751,639,1390,6798000,7188943,13986943,9.937839883954628e-05
WA08,3p,18,A>C,791,673,1464,6798023,7188956,13986979,0.0001046687780113
WA08,3p,19,A>C,751,508,1259,6798028,7188946,13986974,9.001232146424237e-05
WA08,3p,20,A>C,821,512,1333,6798009,7188917,13986926,9.530328536806444e-05
WA08,3p,21,A>C,925,554,1479,6798010,7188926,13986936,0.0001057415290954
WA08,3p,22,A>C,819,640,1459,6798012,7188920,13986932,0.0001043116531917
WA08,3p,23,A>C,832,718,1550,6798009,7188864,13986873,0.0001108181936019
WA08,3p,24,A>C,857,693,1550,6798015,7188867,13986882,0.0001108181222948
WA08,3p,25,A>C,865,578,1443,6797966,7188892,13986858,0.0001031682741041
WA08,5p,1,A>C,175,35,210,6798116,7189085,13987201,1.5013725762573942e-05
WA08,5p,2,A>C,443,181,624,6797941,7188997,13986938,4.461305254945721e-05
WA08,5p,3,A>C,551,229,780,6798117,7189084,13987201,5.5765267118131785e-05
WA08,5p,4,A>C,605,294,899,6798115,7189085,13987200,6.427304964539007e-05
WA08,5p,5,A>C,1004,827,1831,6798116,7189084,13987200,0.0001309053992221
WA08,5p,6,A>C,1428,1058,2486,6798112,7189085,13987197,0.0001777339662835
WA08,5p,7,A>C,1205,854,2059,6798110,7189085,13987195,0.0001472060695514
WA08,5p,8,A>C,1406,824,2230,6798069,7189064,13987133,0.0001594322439058
WA08,5p,9,A>C,1532,791,2323,6798054,7189067,13987121,0.0001660813544116
WA08,5p,10,A>C,1471,901,2372,6798015,7189037,13987052,0.0001695854137097
WA08,5p,11,A>C,945,440,1385,6797997,7189047,13987044,9.90202075577942e-05
WA08,5p,12,A>C,951,432,1383,6798016,7189056,13987072,9.88770201511796e-05
WA08,5p,13,A>C,921,477,1398,6797995,7189043,13987038,9.994968198413417e-05
WA08,5p,14,A>C,1008,658,1666,6797984,7189041,13987025,0.0001191103898076
WA08,5p,15,A>C,826,589,1415,6797997,7189013,13987010,0.0001011652955134
WA08,5p,16,A>C,886,626,1512,6797921,7188997,13986918,0.0001081010126748
WA08,5p,17,A>C,743,640,1383,6797959,7188875,13986834,9.887870264278536e-05
WA08,5p,18,A>C,960,524,1484,6797991,7188972,13986963,0.0001060988007189
WA08,5p,19,A>C,813,484,1297,6797966,7188988,13986954,9.272926757319712e-05
WA08,5p,20,A>C,870,654,1524,6797883,7188971,13986854,0.0001089594557861
WA08,5p,21,A>C,985,511,1496,6797885,7188979,13986864,0.000106957499551
WA08,5p,22,A>C,940,612,1552,6797887,7188939,13986826,0.0001109615576829
WA08,5p,23,A>C,850,710,1560,6797851,7188919,13986770,0.0001115339710311
WA08,5p,24,A>C,933,680,1613,6797841,7188876,13986717,0.0001153237031963
WA08,5p,25,A>C,879,763,1642,6797835,7188817,13986652,0.0001173976445542
WA09,3p,1,A>C,78,37,115,4741672,4881751,9623423,1.1950009887334269e-05
WA09,3p,2,A>C,82,61,143,4741672,4881751,9623423,1.4859577512076524e-05
WA09,3p,3,A>C,252,162,414,4741672,4881751,9623423,4.3020035594403365e-05
WA09,3p,4,A>C,299,252,551,4741672,4881748,9623420,5.725615217874727e-05
WA09,3p,5,A>C,1015,1032,2047,4741672,4881751,9623423,0.0002127101759945
WA09,3p,6,A>C,1086,926,2012,4741672,4881751,9623423,0.0002090732164636
WA09,3p,7,A>C,1023,962,1985,4741672,4881748,9623420,0.00020626762627
WA09,3p,8,A>C,1528,1137,2665,4741663,4881718,9623381,0.0002769296986163
WA09,3p,9,A>C,1315,1368,2683,4741664,4881723,9623387,0.0002787999692831
WA09,3p,10,A>C,1373,1364,2737,4741658,4881705,9623363,0.000284412008567
WA09,3p,11,A>C,1443,1421,2864,4741648,4881712,9623360,0.0002976091510657
WA09,3p,12,A>C,1374,1419,2793,4741642,4881680,9623322,0.0002902324166228
WA09,3p,13,A>C,1373,1480,2853,4741628,4881645,9623273,0.0002964687793851
WA09,3p,14,A>C,1353,1299,2652,4741616,4881571,9623187,0.0002755843776079
WA09,3p,15,A>C,1445,1463,2908,4741598,4881557,9623155,0.0003021877959982
WA09,3p,16,A>C,1503,1569,3072,4741586,4881546,9623132,0.0003192307868165
WA09,3p,17,A>C,1341,1326,2667,4741582,4881528,9623110,0.0002771453303557
WA09,3p,18,A>C,1400,1394,2794,4741560,4881490,9623050,0.0002903445373348
WA09,3p,19,A>C,1464,1869,3333,4741552,4881442,9622994,0.0003463579006699
WA09,3p,20,A>C,1305,1856,3161,4741534,4881501,9623035,0.0003284826460674
WA09,3p,21,A>C,1394,2416,3810,4741546,4881493,9623039,0.0003959248216701
WA09,3p,22,A>C,1399,2003,3402,4741524,4881498,9623022,0.0003535271975892
WA09,3p,23,A>C,1451,1930,3381,4741501,4881486,9622987,0.0003513462088226
WA09,3p,24,A>C,1311,2304,3615,4741491,4881450,9622941,0.0003756647785744
WA09,3p,25,A>C,1479,1349,2828,4741451,4881469,9622920,0.0002938816907965
WA09,5p,1,A>C,105,52,157,4741672,4881751,9623423,1.6314361324447653e-05
WA09,5p,2,A>C,247,157,404,4741495,4881667,9623162,4.19820429085575e-05
WA09,5p,3,A>C,306,251,557,4741672,4881750,9623422,5.787961912093224e-05
WA09,5p,4,A>C,441,297,738,4741672,4881751,9623423,7.668788953784947e-05
WA09,5p,5,A>C,1111,832,1943,4741671,4881751,9623422,0.0002019032315116
WA09,5p,6,A>C,1271,1079,2350,4741669,4881751,9623420,0.0002441959303449
WA09,5p,7,A>C,1184,901,2085,4741667,4881751,9623418,0.0002166589874824
WA09,5p,8,A>C,1818,1295,3113,4741639,4881744,9623383,0.0003234829165585
WA09,5p,9,A>C,1992,1148,3140,4741618,4881747,9623365,0.0003262891930213
WA09,5p,10,A>C,1476,1256,2732,4741622,4881737,9623359,0.0002838925576817
WA09,5p,11,A>C,1532,1017,2549,4741614,4881733,9623347,0.0002648766588173
WA09,5p,12,A>C,2176,1093,3269,4741580,4881734,9623314,0.0003396958677644
WA09,5p,13,A>C,1451,986,2437,4741530,4881708,9623238,0.0002532411647721
WA09,5p,14,A>C,1465,955,2420,4741498,4881705,9623203,0.0002514755222351
WA09,5p,15,A>C,1515,1127,2642,4741496,4881672,9623168,0.0002745457628922
WA09,5p,16,A>C,1613,1117,2730,4741451,4881636,9623087,0.0002836927484912
WA09,5p,17,A>C,1470,1197,2667,4741476,4881638,9623114,0.0002771452151559
WA09,5p,18,A>C,1903,1100,3003,4741455,4881610,9623065,0.0003120627367683
WA09,5p,19,A>C,1492,1242,2734,4741379,4881580,9622959,0.0002841121945962
WA09,5p,20,A>C,1498,1243,2741,4741390,4881557,9622947,0.0002848399767763
WA09,5p,21,A>C,2076,1291,3367,4741379,4881587,9622966,0.0003498921226574
WA09,5p,22,A>C,1813,1239,3052,4741354,4881580,9622934,0.0003171589870615
WA09,5p,23,A>C,1657,1262,2919,4741312,4881565,9622877,0.0003033396353294
WA09,5p,24,A>C,1717,1380,3097,4741363,4881548,9622911,0.0003218360847356
WA09,5p,25,A>C,1532,1221,2753,4741301,4881503,9622804,0.000286091247416
WA11,3p,1,A>C,102,45,147,9756642,10108269,19864911,7.399982813917465e-06
WA11,3p,2,A>C,113,84,197,9756642,10108269,19864911,9.916983771032247e-06
WA11,3p,3,A>C,366,504,870,9756642,10108269,19864911,4.379581665379724e-05
WA11,3p,4,A>C,610,401,1011,9756642,10108267,19864909,5.089376447684709e-05
WA11,3p,5,A>C,1151,1202,2353,9756642,10108269,19864911,0.0001184500650418
WA11,3p,6,A>C,1214,1706,2920,9756642,10108269,19864911,0.0001469928558955
WA11,3p,7,A>C,1072,1181,2253,9756642,10108265,19864907,0.000113416085965
WA11,3p,8,A>C,1289,2254,3543,9756629,10108160,19864789,0.00017835578319
WA11,3p,9,A>C,1357,1356,2713,9756610,10108092,19864702,0.0001365739088358
WA11,3p,10,A>C,1524,1273,2797,9756615,10107969,19864584,0.0001408033513311
WA11,3p,11,A>C,1436,1317,2753,9756587,10107918,19864505,0.0001385889051854
WA11,3p,12,A>C,1345,1259,2604,9756581,10108019,19864600,0.0001310874621185
WA11,3p,13,A>C,1336,1235,2571,9756565,10107963,19864528,0.0001294266845907
WA11,3p,14,A>C,1398,1382,2780,9756515,10107914,19864429,0.000139948648914
WA11,3p,15,A>C,2328,1236,3564,9756471,10107972,19864443,0.0001794160551091
WA11,3p,16,A>C,2002,1136,3138,9756477,10108011,19864488,0.0001579703438618
WA11,3p,17,A>C,1372,1109,2481,9756469,10108044,19864513,0.0001248960898261
WA11,3p,18,A>C,1497,1101,2598,9756421,10108016,19864437,0.0001307864904502
WA11,3p,19,A>C,2277,1247,3524,9756438,10108000,19864438,0.0001774024515568
WA11,3p,20,A>C,1395,1299,2694,9756433,10107963,19864396,0.0001356195275204
WA11,3p,21,A>C,1563,1373,2936,9756421,10107904,19864325,0.0001478026562694
WA11,3p,22,A>C,1446,1436,2882,9756405,10107842,19864247,0.0001450847847391
WA11,3p,23,A>C,1617,1254,2871,9756375,10107816,19864191,0.0001445314334724
WA11,3p,24,A>C,1630,1474,3104,9756358,10107704,19864062,0.0001562620978528
WA11,3p,25,A>C,1688,1579,3267,9756281,10107693,19863974,0.0001644686002911
WA11,5p,1,A>C,166,56,222,9756641,10108269,19864910,1.117548481216376e-05
WA11,5p,2,A>C,630,210,840,9756471,10108196,19864667,4.228613547863652e-05
WA11,5p,3,A>C,689,350,1039,9756642,10108269,19864911,5.230327988884521e-05
WA11,5p,4,A>C,1194,489,1683,9756638,10108269,19864907,8.472226927616626e-05
WA11,5p,5,A>C,2063,1637,3700,9756638,10108267,19864905,0.0001862581270839
WA11,5p,6,A>C,2259,1630,3889,9756642,10108269,19864911,0.0001957723344443
WA11,5p,7,A>C,2094,1439,3533,9756629,10108269,19864898,0.0001778514040192
WA11,5p,8,A>C,2981,1464,4445,9756500,10108261,19864761,0.0002237630747231
WA11,5p,9,A>C,2626,1390,4016,9756493,10108240,19864733,0.0002021673284005
WA11,5p,10,A>C,2289,1624,3913,9756446,10108197,19864643,0.0001969831524281
WA11,5p,11,A>C,1779,1199,2978,9756457,10108195,19864652,0.0001499145316011
WA11,5p,12,A>C,1977,1195,3172,9756411,10108221,19864632,0.0001596807834144
WA11,5p,13,A>C,1829,898,2727,9756334,10108178,19864512,0.0001372799895612
WA11,5p,14,A>C,1855,1120,2975,9756261,10108167,19864428,0.0001497651983736
WA11,5p,15,A>C,1664,1189,2853,9756237,10108096,19864333,0.0001436242535805
WA11,5p,16,A>C,2209,1179,3388,9756275,10108079,19864354,0.0001705567671619
WA11,5p,17,A>C,2578,1328,3906,9756369,10108078,19864447,0.0001966327076711
WA11,5p,18,A>C,2191,1487,3678,9756327,10108075,19864402,0.0001851553346534
WA11,5p,19,A>C,1905,1480,3385,9756284,10108088,19864372,0.0001704055884575
WA11,5p,20,A>C,1929,4571,6500,9756292,10108082,19864374,0.0003272189700012
WA11,5p,21,A>C,1766,1907,3673,9756251,10108036,19864287,0.0001849046985678
WA11,5p,22,A>C,2394,1714,4108,9756136,10108029,19864165,0.0002068045649036
WA11,5p,23,A>C,2746,1520,4266,9756095,10108016,19864111,0.0002147591704456
WA11,5p,24,A>C,2172,1623,3795,9756046,10108010,19864056,0.0001910485955134
WA11,5p,25,A>C,2028,1880,3908,9756056,10107943,19863999,0.0001967378270609
WA12,3p,1,A>C,64,31,95,6632243,6940679,13572922,6.999229790018686e-06
WA12,3p,2,A>C,85,69,154,6632243,6940679,13572922,1.1346119870135554e-05
WA12,3p,3,A>C,227,235,462,6632243,6940679,13572922,3.403835961040666e-05
WA12,3p,4,A>C,281,211,492,6632243,6940676,13572919,3.6248650713969486e-05
WA12,3p,5,A>C,868,966,1834,6632243,6940678,13572921,0.0001351219829541
WA12,3p,6,A>C,913,815,1728,6632243,6940679,13572922,0.0001273123060752
WA12,3p,7,A>C,977,951,1928,6632243,6940676,13572919,0.0001420475580823
WA12,3p,8,A>C,986,991,1977,6632240,6940664,13572904,0.0001456578489024
WA12,3p,9,A>C,1135,1226,2361,6632231,6940656,13572887,0.0001739497278655
WA12,3p,10,A>C,1391,1177,2568,6632228,6940644,13572872,0.000189200929619
WA12,3p,11,A>C,1160,1221,2381,6632231,6940642,13572873,0.00017542343467
WA12,3p,12,A>C,1067,1788,2855,6632223,6940615,13572838,0.0002103465760071
WA12,3p,13,A>C,1271,1277,2548,6632204,6940591,13572795,0.0001877284671285
WA12,3p,14,A>C,1122,1196,2318,6632209,6940533,13572742,0.0001707834717553
WA12,3p,15,A>C,1406,1246,2652,6632188,6940474,13572662,0.0001953927681983
WA12,3p,16,A>C,1205,1616,2821,6632187,6940478,13572665,0.0002078442221921
WA12,3p,17,A>C,1166,1000,2166,6632168,6940473,13572641,0.0001595857431136
WA12,3p,18,A>C,1274,1653,2927,6632160,6940482,13572642,0.0002156544024369
WA12,3p,19,A>C,1271,1447,2718,6632121,6940435,13572556,0.0002002570481197
WA12,3p,20,A>C,1159,1326,2485,6632105,6940432,13572537,0.0001830903094977
WA12,3p,21,A>C,1370,1418,2788,6632096,6940454,13572550,0.0002054146052142
WA12,3p,22,A>C,1158,1364,2522,6632039,6940438,13572477,0.0001858172240778
WA12,3p,23,A>C,1312,1159,2471,6631950,6940459,13572409,0.0001820605317744
WA12,3p,24,A>C,1152,1371,2523,6631933,6940411,13572344,0.0001858927242044
WA12,3p,25,A>C,1181,1361,2542,6631986,6940428,13572414,0.0001872916638116
WA12,5p,1,A>C,92,52,144,6632243,6940679,13572922,1.060935883960727e-05
WA12,5p,2,A>C,223,129,352,6631949,6940524,13572473,2.59348462140982e-05
WA12,5p,3,A>C,367,248,615,6632242,6940678,13572920,4.531081005413721e-05
WA12,5p,4,A>C,534,280,814,6632242,6940679,13572921,5.997235230353142e-05
WA12,5p,5,A>C,1131,738,1869,6632242,6940677,13572919,0.0001377006670414
WA12,5p,6,A>C,1467,904,2371,6632242,6940679,13572921,0.0001746860532084
WA12,5p,7,A>C,1376,920,2296,6632238,6940679,13572917,0.0001691603949246
WA12,5p,8,A>C,1776,958,2734,6632204,6940670,13572874,0.0002014311780983
WA12,5p,9,A>C,2157,955,3112,6632209,6940675,13572884,0.0002292806746156
WA12,5p,10,A>C,1713,1108,2821,6632199,6940665,13572864,0.0002078411748618
WA12,5p,11,A>C,1294,871,2165,6632166,6940667,13572833,0.0001595098090428
WA12,5p,12,A>C,1717,1102,2819,6632126,6940660,13572786,0.0002076950155995
WA12,5p,13,A>C,1268,1029,2297,6632065,6940658,13572723,0.0001692364899806
WA12,5p,14,A>C,1191,908,2099,6632026,6940638,13572664,0.0001546490799448
WA12,5p,15,A>C,1285,1022,2307,6631987,6940631,13572618,0.0001699745767544
WA12,5p,16,A>C,1269,1091,2360,6631930,6940590,13572520,0.0001738807531689
WA12,5p,17,A>C,1267,1001,2268,6631958,6940621,13572579,0.0001671016245328
WA12,5p,18,A>C,1419,982,2401,6632019,6940577,13572596,0.0001769005723002
WA12,5p,19,A>C,1230,1096,2326,6631996,6940532,13572528,0.0001713755904574
WA12,5p,20,A>C,1308,1350,2658,6631973,6940532,13572505,0.0001958370986048
WA12,5p,21,A>C,1364,993,2357,6631936,6940534,13572470,0.000173660358063
WA12,5p,22,A>C,1443,1083,2526,6631921,6940529,13572450,0.0001861123083894
WA12,5p,23,A>C,1332,990,2322,6631926,6940534,13572460,0.0001710817346302
WA12,5p,24,A>C,1233,1156,2389,6631934,6940518,13572452,0.0001760183053143
WA12,5p,25,A>C,1307,1171,2478,6631933,6940515,13572448,0.0001825757593619
WA13,3p,1,A>C,20,16,36,5896847,6081528,11978375,3.005416010101537e-06
WA13,3p,2,A>C,30,25,55,5896847,6081528,11978375,4.591607793210682e-06
WA13,3p,3,A>C,279,87,366,5896847,6081528,11978375,3.055506276936563e-05
WA13,3p,4,A>C,93,55,148,5896847,6081522,11978369,1.2355605341595338e-05
WA13,3p,5,A>C,239,137,376,5896847,6081527,11978374,3.13899031704971e-05
WA13,3p,6,A>C,109,96,205,5896847,6081528,11978375,1.7114174501967088e-05
WA13,3p,7,A>C,319,149,468,5896847,6081528,11978375,3.907040813131998e-05
WA13,3p,8,A>C,225,201,426,5896845,6081521,11978366,3.5564116174109226e-05
WA13,3p,9,A>C,479,207,686,5896842,6081517,11978359,5.7269948245832336e-05
WA13,3p,10,A>C,442,320,762,5896843,6081517,11978360,6.36147185424382e-05
WA13,3p,11,A>C,204,151,355,5896841,6081492,11978333,2.963684512694713e-05
WA13,3p,12,A>C,180,151,331,5896836,6081505,11978341,2.7633208972761754e-05
WA13,3p,13,A>C,170,211,381,5896834,6081495,11978329,3.18074415888894e-05
WA13,3p,14,A>C,134,145,279,5896832,6081501,11978333,2.329205574765704e-05
WA13,3p,15,A>C,167,242,409,5896825,6081505,11978330,3.414499350076346e-05
WA13,3p,16,A>C,228,184,412,5896830,6081509,11978339,3.439541993259666e-05
WA13,3p,17,A>C,244,161,405,5896823,6081499,11978322,3.381107971550606e-05
WA13,3p,18,A>C,195,170,365,5896827,6081499,11978326,3.0471703642061504e-05
WA13,3p,19,A>C,209,219,428,5896822,6081480,11978302,3.573127476665724e-05
WA13,3p,20,A>C,157,434,591,5896818,6081448,11978266,4.933936180746028e-05
WA13,3p,21,A>C,204,389,593,5896824,6081466,11978290,4.9506231690834e-05
WA13,3p,22,A>C,272,233,505,5896824,6081460,11978284,4.215962820717893e-05
WA13,3p,23,A>C,191,228,419,5896819,6081454,11978273,3.498000087324776e-05
WA13,3p,24,A>C,258,203,461,5896803,6081440,11978243,3.848644580010608e-05
WA13,3p,25,A>C,285,183,468,5896783,6081437,11978220,3.907091370838071e-05
WA13,5p,1,A>C,96,22,118,5896847,6081528,11978375,9.851085810888373e-06
WA13,5p,2,A>C,228,77,305,5896725,6081443,11978168,2.5462992337392496e-05
WA13,5p,3,A>C,386,156,542,5896847,6081528,11978375,4.524820770763981e-05
WA13,5p,4,A>C,387,243,630,5896841,6081528,11978369,5.259480652165583e-05
WA13,5p,5,A>C,448,408,856,5896841,6081528,11978369,7.146214981355142e-05
WA13,5p,6,A>C,680,767,1447,5896841,6081528,11978369,0.00012080108736
WA13,5p,7,A>C,570,661,1231,5896845,6081528,11978373,0.0001027685479488
WA13,5p,8,A>C,716,381,1097,5896843,6081526,11978369,9.158175040358166e-05
WA13,5p,9,A>C,934,335,1269,5896837,6081518,11978355,0.0001059410912433
WA13,5p,10,A>C,745,475,1220,5896833,6081518,11978351,0.0001018504132997
WA13,5p,11,A>C,214,117,331,5896827,6081513,11978340,2.763321127969318e-05
WA13,5p,12,A>C,214,126,340,5896822,6081502,11978324,2.8384605392206788e-05
WA13,5p,13,A>C,270,8691,8961,5896809,6081508,11978317,0.000748101757534
WA13,5p,14,A>C,192,8668,8860,5896802,6081520,11978322,0.0007396695463688
WA13,5p,15,A>C,230,160,390,5896798,6081508,11978306,3.255886099420068e-05
WA13,5p,16,A>C,180,82,262,5896754,6081491,11978245,2.187298723644407e-05
WA13,5p,17,A>C,245,267,512,5896805,6081514,11978319,4.274389419750801e-05
WA13,5p,18,A>C,238,181,419,5896796,6081504,11978300,3.497992202566307e-05
WA13,5p,19,A>C,246,111,357,5896797,6081472,11978269,2.9803972510552238e-05
WA13,5p,20,A>C,238,125,363,5896788,6081482,11978270,3.03048770815819e-05
WA13,5p,21,A>C,246,103,349,5896782,6081484,11978266,2.91361036731026e-05
WA13,5p,22,A>C,273,152,425,5896771,6081483,11978254,3.548096408708648e-05
WA13,5p,23,A>C,258,164,422,5896768,6081501,11978269,3.523046610491049e-05
WA13,5p,24,A>C,311,257,568,5896781,6081498,11978279,4.741916597534588e-05
WA13,5p,25,A>C,271,135,406,5896769,6081462,11978231,3.389482136385581e-05
WA14,3p,1,A>C,56,75,131,6684341,7140972,13825313,9.47537317961626e-06
WA14,3p,2,A>C,133,114,247,6684341,7140972,13825313,1.786577996461997e-05
WA14,3p,3,A>C,406,241,647,6684341,7140972,13825313,4.6798217154287934e-05
WA14,3p,4,A>C,312,386,698,6684341,7140971,13825312,5.04871065477582e-05
WA14,3p,5,A>C,1098,689,1787,6684341,7140970,13825311,0.0001292556818432
WA14,3p,6,A>C,1037,567,1604,6684341,7140971,13825312,0.0001160190815223
WA14,3p,7,A>C,1013,874,1887,6684341,7140969,13825310,0.0001364888020594
WA14,3p,8,A>C,1272,915,2187,6684326,7140932,13825258,0.0001581887296425
WA14,3p,9,A>C,1453,901,2354,6684323,7140920,13825243,0.0001702682549594
WA14,3p,10,A>C,1292,1088,2380,6684256,7140912,13825168,0.0001721498067871
WA14,3p,11,A>C,1199,869,2068,6684256,7140894,13825150,0.000149582463843
WA14,3p,12,A>C,1466,883,2349,6684291,7140849,13825140,0.0001699078635008
WA14,3p,13,A>C,1250,832,2082,6684289,7140794,13825083,0.0001505958409074
WA14,3p,14,A>C,1784,782,2566,6684291,7140742,13825033,0.0001856053435821
WA14,3p,15,A>C,1765,810,2575,6684271,7140702,13824973,0.0001862571449506
WA14,3p,16,A>C,1392,1226,2618,6684263,7140648,13824911,0.0001893683076874
WA14,3p,17,A>C,1481,1103,2584,6684212,7140653,13824865,0.0001869096009255
WA14,3p,18,A>C,1140,1006,2146,6684177,7140647,13824824,0.0001552280159226
WA14,3p,19,A>C,1307,1247,2554,6684172,7140542,13824714,0.0001847416156312
WA14,3p,20,A>C,1208,1185,2393,6684176,7140544,13824720,0.0001730957299677
WA14,3p,21,A>C,1240,1242,2482,6684132,7140443,13824575,0.0001795353564214
WA14,3p,22,A>C,1531,1993,3524,6684105,7140560,13824665,0.0002549067192586
WA14,3p,23,A>C,1407,2330,3737,6683638,7140562,13824200,0.0002703230566687
WA14,3p,24,A>C,1502,1492,2994,6683623,7140532,13824155,0.0002165774327617
WA14,3p,25,A>C,1878,1052,2930,6683613,7140513,13824126,0.000211948299661
WA14,5p,1,A>C,136,43,179,6684341,7140972,13825313,1.2947265642376416e-05
WA14,5p,2,A>C,279,140,419,6684184,7140911,13825095,3.0307205845601784e-05
WA14,5p,3,A>C,356,260,616,6684338,7140972,13825310,4.455596294043317e-05
WA14,5p,4,A>C,760,292,1052,6684341,7140972,13825313,7.609230980882675e-05
WA14,5p,5,A>C,1307,898,2205,6684341,7140972,13825313,0.000159490060008
WA14,5p,6,A>C,1335,1450,2785,6684340,7140972,13825312,0.0002014421085035
WA14,5p,7,A>C,1325,1030,2355,6684336,7140972,13825308,0.0001703397855584
WA14,5p,8,A>C,1801,1001,2802,6684277,7140970,13825247,0.000202672690043
WA14,5p,9,A>C,2041,1111,3152,6684241,7140959,13825200,0.0002279894685067
WA14,5p,10,A>C,2744,1171,3915,6684210,7140628,13824838,0.00028318595849
WA14,5p,11,A>C,1882,869,2751,6684218,7140646,13824864,0.0001989892992799
WA14,5p,12,A>C,1588,747,2335,6684139,7140917,13825056,0.0001688962417222
WA14,5p,13,A>C,2199,950,3149,6684018,7140931,13824949,0.0002277766087961
WA14,5p,14,A>C,1523,861,2384,6683951,7140942,13824893,0.0001724425642932
WA14,5p,15,A>C,1422,805,2227,6684030,7140908,13824938,0.0001610857133681
WA14,5p,16,A>C,1419,651,2070,6683910,7140868,13824778,0.0001497311566232
WA14,5p,17,A>C,1256,893,2149,6683904,7140873,13824777,0.0001554455453422
WA14,5p,18,A>C,1315,1338,2653,6683891,7140646,13824537,0.0001919051610914
WA14,5p,19,A>C,1189,1424,2613,6683958,7140595,13824553,0.0001890115362138
WA14,5p,20,A>C,1273,1416,2689,6683860,7140558,13824418,0.000194510900929
WA14,5p,21,A>C,1270,1249,2519,6683480,7140494,13823974,0.00018221967142
WA14,5p,22,A>C,1392,1274,2666,6683768,7140398,13824166,0.0001928506934884
WA14,5p,23,A>C,1102,1227,2329,6683762,7140257,13824019,0.0001684748841852
WA14,5p,24,A>C,1132,1372,2504,6683714,7140421,13824135,0.0001811324903872
WA14,5p,25,A>C,1300,1166,2466,6683731,7140511,13824242,0.0001783822939442
WA18,3p,1,A>C,117,66,183,14112928,14131239,28244167,6.479213920523838e-06
WA18,3p,2,A>C,144,108,252,14112928,14131239,28244167,8.922196218426268e-06
WA18,3p,3,A>C,1076,806,1882,14112928,14131239,28244167,6.663322731380253e-05
WA18,3p,4,A>C,966,672,1638,14112928,14131238,28244166,5.799427747308949e-05
WA18,3p,5,A>C,1798,1094,2892,14112928,14131239,28244167,0.0001023928232686
WA18,3p,6,A>C,1814,4207,6021,14112928,14131239,28244167,0.0002131767596473
WA18,3p,7,A>C,2358,1878,4236,14112928,14131237,28244165,0.0001499778803869
WA18,3p,8,A>C,2409,1940,4349,14112927,14131187,28244114,0.0001539789847895
WA18,3p,9,A>C,2498,2708,5206,14112909,14131177,28244086,0.0001843217727066
WA18,3p,10,A>C,2295,5314,7609,14112909,14131197,28244106,0.000269401339876
WA18,3p,11,A>C,2043,2505,4548,14112900,14131167,28244067,0.0001610249685358
WA18,3p,12,A>C,1906,2634,4540,14112895,14131136,28244031,0.0001607419280909
WA18,3p,13,A>C,2507,3350,5857,14112898,14131061,28243959,0.0002073717781561
WA18,3p,14,A>C,2500,2995,5495,14112830,14131006,28243836,0.0001945557253625
WA18,3p,15,A>C,2556,2396,4952,14112809,14130957,28243766,0.0001753307260795
WA18,3p,16,A>C,2318,1995,4313,14112765,14130927,28243692,0.0001527066645536
WA18,3p,17,A>C,2416,1992,4408,14112743,14130850,28243593,0.0001560707945338
WA18,3p,18,A>C,2353,2447,4800,14112708,14130769,28243477,0.0001699507465033
WA18,3p,19,A>C,2451,2753,5204,14112724,14130771,28243495,0.0001842548169056
WA18,3p,20,A>C,2035,2821,4856,14112697,14130797,28243494,0.0001719334017243
WA18,3p,21,A>C,2539,2514,5053,14112659,14130783,28243442,0.0001789087888083
WA18,3p,22,A>C,2775,2396,5171,14112575,14130715,28243290,0.0001830877351753
WA18,3p,23,A>C,2690,2820,5510,14112548,14130648,28243196,0.0001950912354253
WA18,3p,24,A>C,2716,3578,6294,14112551,14130690,28243241,0.0002228497784655
WA18,3p,25,A>C,2501,2669,5170,14112486,14130651,28243137,0.0001830533201747
WA18,5p,1,A>C,221,94,315,14112926,14131239,28244165,1.1152746062770842e-05
WA18,5p,2,A>C,716,427,1143,14112820,14131183,28244003,4.046876783011247e-05
WA18,5p,3,A>C,945,452,1397,14112928,14131239,28244167,4.9461540147386894e-05
WA18,5p,4,A>C,1739,965,2704,14112928,14131239,28244167,9.573658164533584e-05
WA18,5p,5,A>C,2820,1430,4250,14112925,14131239,28244164,0.0001504735633173
WA18,5p,6,A>C,2952,2040,4992,14112927,14131239,28244166,0.0001767444646798
WA18,5p,7,A>C,2684,2014,4698,14112921,14131239,28244160,0.0001663352707249
WA18,5p,8,A>C,4028,1793,5821,14112828,14131230,28244058,0.0002060964469057
WA18,5p,9,A>C,3882,2400,6282,14112833,14131230,28244063,0.0002224184247146
WA18,5p,10,A>C,3323,2644,5967,14112791,14131213,28244004,0.000211266079696
WA18,5p,11,A>C,2592,1818,4410,14112776,14131211,28243987,0.0001561394288986
WA18,5p,12,A>C,2993,2242,5235,14112682,14131223,28243905,0.0001853497241263
WA18,5p,13,A>C,2655,2020,4675,14112608,14131206,28243814,0.0001655229707999
WA18,5p,14,A>C,2768,1730,4498,14112535,14131179,28243714,0.0001592566756624
WA18,5p,15,A>C,3068,2258,5326,14112545,14131148,28243693,0.0001885730736416
WA18,5p,16,A>C,2740,2594,5334,14112522,14131083,28243605,0.0001888569111485
WA18,5p,17,A>C,2479,2095,4574,14112485,14130990,28243475,0.0001619489103235
WA18,5p,18,A>C,2652,2345,4997,14112481,14130987,28243468,0.0001769258647698
WA18,5p,19,A>C,2790,3002,5792,14112359,14130867,28243226,0.0002050757232902
WA18,5p,20,A>C,2667,2074,4741,14112397,14130866,28243263,0.0001678630404709
WA18,5p,21,A>C,2620,2033,4653,14112347,14130679,28243026,0.0001647486356454
WA18,5p,22,A>C,2593,2455,5048,14112376,14129592,28241968,0.0001787410848988
WA18,5p,23,A>C,2557,1916,4473,14112288,14129275,28241563,0.0001583835852144
WA18,5p,24,A>C,2620,3234,5854,14112253,14129481,28241734,0.0002072818899859
WA18,5p,25,A>C,3292,2945,6237,14112273,14130551,28242824,0.0002208348570242
WA22,3p,1,A>C,16,4,20,1513709,1653397,3167106,6.314913362546122e-06
WA22,3p,2,A>C,6,10,16,1513709,1653396,3167105,5.051932285162633e-06
WA22,3p,3,A>C,36,41,77,1513709,1653396,3167105,2.431242412234517e-05
WA22,3p,4,A>C,59,43,102,1513709,1653394,3167103,3.220608865578417e-05
WA22,3p,5,A>C,108,105,213,1513709,1653397,3167106,6.725382731111621e-05
WA22,3p,6,A>C,142,175,317,1513709,1653397,3167106,0.0001000913767963
WA22,3p,7,A>C,89,142,231,1513709,1653397,3167106,7.293724933740772e-05
WA22,3p,8,A>C,123,225,348,1513709,1653395,3167104,0.0001098795618962
WA22,3p,9,A>C,109,279,388,1513709,1653397,3167106,0.0001225093192333
WA22,3p,10,A>C,173,242,415,1513706,1653396,3167102,0.0001310346177672
WA22,3p,11,A>C,135,163,298,1513685,1653390,3167075,9.409313009638232e-05
WA22,3p,12,A>C,157,155,312,1513662,1653379,3167041,9.851467031844552e-05
WA22,3p,13,A>C,170,174,344,1513689,1653380,3167069,0.0001086177787727
WA22,3p,14,A>C,189,175,364,1513686,1653352,3167038,0.00011493389091
WA22,3p,15,A>C,162,157,319,1513677,1653343,3167020,0.0001007256032484
WA22,3p,16,A>C,110,227,337,1513637,1653341,3166978,0.0001064105907903
WA22,3p,17,A>C,161,172,333,1513671,1653319,3166990,0.0001051471586585
WA22,3p,18,A>C,149,125,274,1513665,1653288,3166953,8.651849269629198e-05
WA22,3p,19,A>C,135,292,427,1513662,1653275,3166937,0.0001348305949881
WA22,3p,20,A>C,137,184,321,1513684,1653304,3166988,0.0001013581358691
WA22,3p,21,A>C,189,217,406,1513677,1653327,3167004,0.0001281968699755
WA22,3p,22,A>C,137,203,340,1513684,1653356,3167040,0.000107355764373
WA22,3p,23,A>C,144,182,326,1513676,1653329,3167005,0.0001029363704825
WA22,3p,24,A>C,272,155,427,1513672,1653285,3166957,0.0001348297435045
WA22,3p,25,A>C,178,165,343,1513669,1653296,3166965,0.0001083055859474
WA22,5p,1,A>C,28,12,40,1513709,1653397,3167106,1.2629826725092244e-05
WA22,5p,2,A>C,76,62,138,1513674,1653378,3167052,4.357364514381197e-05
WA22,5p,3,A>C,105,78,183,1513709,1653397,3167106,5.778145726729702e-05
WA22,5p,4,A>C,111,142,253,1513709,1653397,3167106,7.988365403620845e-05
WA22,5p,5,A>C,181,224,405,1513708,1653396,3167104,0.0001278770763448
WA22,5p,6,A>C,207,317,524,1513704,1653397,3167101,0.0001654509913008
WA22,5p,7,A>C,271,311,582,1513707,1653397,3167104,0.0001837640948955
WA22,5p,8,A>C,272,229,501,1513692,1653397,3167089,0.0001581894288414
WA22,5p,9,A>C,241,243,484,1513700,1653389,3167089,0.0001528217236711
WA22,5p,10,A>C,269,344,613,1513705,1653389,3167094,0.0001935528279236
WA22,5p,11,A>C,140,114,254,1513699,1653381,3167080,8.020005809767988e-05
WA22,5p,12,A>C,184,186,370,1513692,1653345,3167037,0.0001168284424842
WA22,5p,13,A>C,143,156,299,1513697,1653377,3167074,9.440890866459072e-05
WA22,5p,14,A>C,156,136,292,1513677,1653376,3167053,9.2199278003873e-05
WA22,5p,15,A>C,140,187,327,1513695,1653381,3167076,0.000103249811498
WA22,5p,16,A>C,167,272,439,1513668,1653368,3167036,0.0001386154120129
WA22,5p,17,A>C,163,200,363,1513675,1653395,3167070,0.0001146169803635
WA22,5p,18,A>C,185,90,275,1513651,1653392,3167043,8.683178599090697e-05
WA22,5p,19,A>C,151,115,266,1513674,1653350,3167024,8.399052233263784e-05
WA22,5p,20,A>C,219,215,434,1513678,1653356,3167034,0.0001370367353176
WA22,5p,21,A>C,151,172,323,1513690,1653371,3167061,0.0001019872998972
WA22,5p,22,A>C,164,268,432,1513691,1653380,3167071,0.0001364036360409
WA22,5p,23,A>C,122,285,407,1513634,1653393,3167027,0.0001285116925116
WA22,5p,24,A>C,131,200,331,1513632,1653375,3167007,0.0001045150831684
WA22,5p,25,A>C,170,235,405,1513644,1653364,3167008,0.0001278809526215
WA25,3p,1,A>C,17,21,38,3375244,3569089,6944333,5.472087816065272e-06
WA25,3p,2,A>C,46,55,101,3375244,3569089,6944333,1.4544233405857696e-05
WA25,3p,3,A>C,296,185,481,3375244,3569089,6944333,6.926511156651042e-05
WA25,3p,4,A>C,225,253,478,3375244,3569087,6944331,6.883312445792114e-05
WA25,3p,5,A>C,364,341,705,3375244,3569089,6944333,0.0001015216292191
WA25,3p,6,A>C,311,412,723,3375244,3569089,6944333,0.0001041136708161
WA25,3p,7,A>C,363,412,775,3375244,3569089,6944333,0.0001116017909855
WA25,3p,8,A>C,345,423,768,3375239,3569076,6944315,0.0001105940614733
WA25,3p,9,A>C,352,494,846,3375240,3569076,6944316,0.0001218262532983
WA25,3p,10,A>C,311,696,1007,3375240,3569075,6944315,0.0001450107029995
WA25,3p,11,A>C,471,729,1200,3375233,3569054,6944287,0.0001728039178104
WA25,3p,12,A>C,383,442,825,3375226,3569069,6944295,0.000118802556631
WA25,3p,13,A>C,356,825,1181,3375230,3569053,6944283,0.0001700679537397
WA25,3p,14,A>C,589,499,1088,3375223,3569037,6944260,0.0001566761613188
WA25,3p,15,A>C,411,605,1016,3375218,3569039,6944257,0.0001463079491441
WA25,3p,16,A>C,355,773,1128,3375196,3569030,6944226,0.0001624371096217
WA25,3p,17,A>C,358,544,902,3375198,3569022,6944220,0.0001298921981158
WA25,3p,18,A>C,358,695,1053,3375213,3569006,6944219,0.000151636922741
WA25,3p,19,A>C,493,807,1300,3375204,3569005,6944209,0.0001872063470439
WA25,3p,20,A>C,627,588,1215,3375190,3568979,6944169,0.0001749669398887
WA25,3p,21,A>C,542,564,1106,3375199,3568998,6944197,0.000159269675097
WA25,3p,22,A>C,390,730,1120,3375179,3568994,6944173,0.000161286304359
WA25,3p,23,A>C,582,603,1185,3375175,3568972,6944147,0.0001706473091655
WA25,3p,24,A>C,385,610,995,3375177,3568962,6944139,0.0001432863023047
WA25,3p,25,A>C,493,584,1077,3375156,3568970,6944126,0.0001550951120414
WA25,5p,1,A>C,110,24,134,3375244,3569089,6944333,1.929630966717754e-05
WA25,5p,2,A>C,204,86,290,3375147,3569045,6944192,4.176151811470651e-05
WA25,5p,3,A>C,270,104,374,3375243,3569089,6944332,5.385687205047224e-05
WA25,5p,4,A>C,381,196,577,3375243,3569089,6944332,8.308934538268044e-05
WA25,5p,5,A>C,549,326,875,3375244,3569088,6944332,0.000126002040225
WA25,5p,6,A>C,667,652,1319,3375244,3569089,6944333,0.0001899390481418
WA25,5p,7,A>C,616,763,1379,3375242,3569089,6944331,0.0001985792439905
WA25,5p,8,A>C,848,451,1299,3375221,3569088,6944309,0.0001870596484113
WA25,5p,9,A>C,791,402,1193,3375227,3569087,6944314,0.0001717952270015
WA25,5p,10,A>C,675,564,1239,3375217,3569085,6944302,0.000178419659744
WA25,5p,11,A>C,419,306,725,3375193,3569088,6944281,0.0001044024572162
WA25,5p,12,A>C,526,282,808,3375142,3569084,6944226,0.0001163556600836
WA25,5p,13,A>C,468,315,783,3375133,3569081,6944214,0.0001127557416865
WA25,5p,14,A>C,379,352,731,3375151,3569071,6944222,0.0001052673719244
WA25,5p,15,A>C,405,264,669,3375137,3569055,6944192,9.633950213358155e-05
WA25,5p,16,A>C,325,385,710,3375081,3569035,6944116,0.0001022448357717
WA25,5p,17,A>C,461,388,849,3375076,3568871,6943947,0.0001222647580691
WA25,5p,18,A>C,423,820,1243,3375102,3568996,6944098,0.0001790009299983
WA25,5p,19,A>C,431,425,856,3375134,3569021,6944155,0.0001232691378576
WA25,5p,20,A>C,452,474,926,3375145,3569019,6944164,0.0001333493851815
WA25,5p,21,A>C,504,599,1103,3375130,3569013,6944143,0.0001588388948787
WA25,5p,22,A>C,443,570,1013,3375139,3569001,6944140,0.0001458783953088
WA25,5p,23,A>C,399,668,1067,3375144,3569002,6944146,0.0001536546034602
WA25,5p,24,A>C,481,455,936,3375124,3568967,6944091,0.0001347908603156
WA25,5p,25,A>C,626,523,1149,3375125,3568950,6944075,0.0001654648027275
WA26,3p,1,A>C,24,12,36,2709623,2900126,5609749,6.417399423753184e-06
WA26,3p,2,A>C,37,20,57,2709623,2900126,5609749,1.016088242094254e-05
WA26,3p,3,A>C,134,81,215,2709623,2900126,5609749,3.8326135447414845e-05
WA26,3p,4,A>C,149,90,239,2709623,2900126,5609749,4.260440172991697e-05
WA26,3p,5,A>C,398,261,659,2709623,2900126,5609749,0.0001174740616737
WA26,3p,6,A>C,424,243,667,2709623,2900126,5609749,0.0001189001504345
WA26,3p,7,A>C,416,211,627,2709623,2900126,5609749,0.0001117697066303
WA26,3p,8,A>C,329,453,782,2709619,2900114,5609733,0.0001394005739667
WA26,3p,9,A>C,388,434,822,2709613,2900111,5609724,0.0001465312731963
WA26,3p,10,A>C,558,314,872,2709609,2900074,5609683,0.0001554455037833
WA26,3p,11,A>C,530,232,762,2709594,2900076,5609670,0.0001358368674093
WA26,3p,12,A>C,575,249,824,2709607,2900081,5609688,0.0001468887396233
WA26,3p,13,A>C,365,260,625,2709604,2900084,5609688,0.0001114143959521
WA26,3p,14,A>C,258,404,662,2709584,2900069,5609653,0.0001180108644866
WA26,3p,15,A>C,331,245,576,2709593,2900082,5609675,0.0001026797452615
WA26,3p,16,A>C,307,241,548,2709580,2900075,5609655,9.768871704231366e-05
WA26,3p,17,A>C,353,280,633,2709570,2900078,5609648,0.0001128413048376
WA26,3p,18,A>C,318,311,629,2709582,2900059,5609641,0.0001121283875385
WA26,3p,19,A>C,272,337,609,2709567,2900016,5609583,0.0001085642194794
WA26,3p,20,A>C,319,258,577,2709563,2899983,5609546,0.0001028603740837
WA26,3p,21,A>C,362,343,705,2709562,2900021,5609583,0.0001256777910229
WA26,3p,22,A>C,305,315,620,2709522,2900007,5609529,0.0001105262135198
WA26,3p,23,A>C,313,306,619,2709541,2899974,5609515,0.0001103482208354
WA26,3p,24,A>C,402,342,744,2709558,2899951,5609509,0.0001326319291046
WA26,3p,25,A>C,372,415,787,2709500,2900002,5609502,0.0001402976592217
WA26,5p,1,A>C,97,29,126,2709622,2900126,5609748,2.246090198704113e-05
WA26,5p,2,A>C,193,75,268,2709554,2900092,5609646,4.777485067685198e-05
WA26,5p,3,A>C,239,98,337,2709623,2900126,5609749,6.007398905013397e-05
WA26,5p,4,A>C,231,221,452,2709623,2900126,5609749,8.057401498712331e-05
WA26,5p,5,A>C,385,386,771,2709623,2900125,5609748,0.0001374393288254
WA26,5p,6,A>C,613,533,1146,2709621,2900126,5609747,0.0002042872878224
WA26,5p,7,A>C,496,552,1048,2709622,2900126,5609748,0.0001868176609715
WA26,5p,8,A>C,558,424,982,2709609,2900124,5609733,0.0001750528946743
WA26,5p,9,A>C,567,383,950,2709594,2900123,5609717,0.0001693490063759
WA26,5p,10,A>C,569,569,1138,2709601,2900123,5609724,0.0002028620302888
WA26,5p,11,A>C,314,251,565,2709605,2900103,5609708,0.0001007182548539
WA26,5p,12,A>C,457,351,808,2709595,2900107,5609702,0.0001440361716183
WA26,5p,13,A>C,356,385,741,2709592,2900104,5609696,0.0001320927194628
WA26,5p,14,A>C,264,415,679,2709563,2900089,5609652,0.0001210413765417
WA26,5p,15,A>C,256,286,542,2709545,2900085,5609630,9.661956314409328e-05
WA26,5p,16,A>C,271,424,695,2709540,2900076,5609616,0.0001238943984757
WA26,5p,17,A>C,279,567,846,2709554,2900055,5609609,0.0001508126502221
WA26,5p,18,A>C,217,361,578,2709554,2900082,5609636,0.0001030369884962
WA26,5p,19,A>C,388,490,878,2709570,2900086,5609656,0.0001565158362651
WA26,5p,20,A>C,303,275,578,2709563,2900082,5609645,0.0001030368231857
WA26,5p,21,A>C,278,346,624,2709545,2900061,5609606,0.0001112377589442
WA26,5p,22,A>C,442,487,929,2709542,2900059,5609601,0.0001656089265528
WA26,5p,23,A>C,312,358,670,2709528,2900065,5609593,0.0001194382551461
WA26,5p,24,A>C,370,421,791,2709495,2900057,5609552,0.0001410094781187
WA26,5p,25,A>C,377,282,659,2709506,2900041,5609547,0.0001174782919191
