Sample,End,Position,Substitution,Pos_Count,Neg_Count,Combined_Count,Pos_Total,Neg_Total,Combined_Total,Frequency
DAL192,3p,1,A>T,9,6,15,6350003,6167708,12517711,1.1983021496502036e-06
DAL192,3p,2,A>T,10,3,13,6350003,6167706,12517709,1.0385286956263325e-06
DAL192,3p,3,A>T,88,165,253,6350003,6167708,12517711,2.02113629241001e-05
DAL192,3p,4,A>T,139,123,262,6350003,6167708,12517711,2.0930344213890224e-05
DAL192,3p,5,A>T,169,142,311,6350003,6167708,12517711,2.4844797902747557e-05
DAL192,3p,6,A>T,189,166,355,6350003,6167708,12517711,2.835981754172149e-05
DAL192,3p,7,A>T,237,189,426,6350003,6167708,12517711,3.403178105006578e-05
DAL192,3p,8,A>T,266,191,457,6350003,6167618,12517621,3.650853464887617e-05
DAL192,3p,9,A>T,247,252,499,6350003,6167637,12517640,3.9863744284066325e-05
DAL192,3p,10,A>T,268,365,633,6350003,6167645,12517648,5.056860522040562e-05
DAL192,3p,11,A>T,247,356,603,6349987,6167644,12517631,4.817205428087791e-05
DAL192,3p,12,A>T,288,335,623,6349997,6167646,12517643,4.976975297985412e-05
DAL192,3p,13,A>T,373,320,693,6349992,6167621,12517613,5.53619927377528e-05
DAL192,3p,14,A>T,362,405,767,6349967,6167610,12517577,6.127383917830103e-05
DAL192,3p,15,A>T,367,433,800,6349968,6167615,12517583,6.39101014948333e-05
DAL192,3p,16,A>T,233,303,536,6349943,6167587,12517530,4.281994930309734e-05
DAL192,3p,17,A>T,425,468,893,6349922,6167606,12517528,7.133996424853214e-05
DAL192,3p,18,A>T,509,406,915,6349922,6167564,12517486,7.309774502643742e-05
DAL192,3p,19,A>T,545,669,1214,6349921,6167519,12517440,9.698468696474678e-05
DAL192,3p,20,A>T,460,391,851,6349910,6167516,12517426,6.798522316009698e-05
DAL192,3p,21,A>T,811,360,1171,6349882,6167507,12517389,9.354986091748048e-05
DAL192,3p,22,A>T,702,344,1046,6349894,6167488,12517382,8.356379952293539e-05
DAL192,3p,23,A>T,573,412,985,6349902,6167465,12517367,7.869067033026994e-05
DAL192,3p,24,A>T,580,498,1078,6349899,6167465,12517364,8.612036847374575e-05
DAL192,3p,25,A>T,789,420,1209,6349856,6167384,12517240,9.658678750267632e-05
DAL192,5p,1,A>T,7,9,16,6350003,6167708,12517711,1.2781889596268838e-06
DAL192,5p,2,A>T,10,15,25,6349992,6167694,12517686,1.997174238113977e-06
DAL192,5p,3,A>T,12,28,40,6350003,6167707,12517710,3.1954726543433264e-06
DAL192,5p,4,A>T,71,35,106,6350003,6167708,12517711,8.468001857528106e-06
DAL192,5p,5,A>T,193,158,351,6350003,6167707,12517710,2.804027254186269e-05
DAL192,5p,6,A>T,221,174,395,6350002,6167707,12517709,3.1555294982492404e-05
DAL192,5p,7,A>T,403,365,768,6350002,6167708,12517710,6.135307496339186e-05
DAL192,5p,8,A>T,380,325,705,6349926,6167708,12517634,5.632054747726288e-05
DAL192,5p,9,A>T,442,496,938,6349914,6167708,12517622,7.493436053589092e-05
DAL192,5p,10,A>T,362,311,673,6349896,6167708,12517604,5.376428268540848e-05
DAL192,5p,11,A>T,239,354,593,6349942,6167706,12517648,4.737311673886341e-05
DAL192,5p,12,A>T,617,475,1092,6349906,6167700,12517606,8.7237128249603e-05
DAL192,5p,13,A>T,374,399,773,6349906,6167705,12517611,6.1752997436971e-05
DAL192,5p,14,A>T,421,420,841,6349889,6167679,12517568,6.718557470588535e-05
DAL192,5p,15,A>T,356,511,867,6349890,6167649,12517539,6.926281595767347e-05
DAL192,5p,16,A>T,486,387,873,6349904,6167639,12517543,6.97421211175388e-05
DAL192,5p,17,A>T,398,383,781,6349778,6167623,12517401,6.23931437524451e-05
DAL192,5p,18,A>T,417,562,979,6349859,6167631,12517490,7.821056777357123e-05
DAL192,5p,19,A>T,588,502,1090,6349822,6167638,12517460,8.707836893427261e-05
DAL192,5p,20,A>T,389,657,1046,6349836,6167621,12517457,8.356329883937288e-05
DAL192,5p,21,A>T,547,665,1212,6349784,6167624,12517408,9.682515741278068e-05
DAL192,5p,22,A>T,405,660,1065,6349783,6167584,12517367,8.508179076318526e-05
DAL192,5p,23,A>T,465,602,1067,6349801,6167567,12517368,8.524156196414454e-05
DAL192,5p,24,A>T,496,612,1108,6349759,6167564,12517323,8.851732914457827e-05
DAL192,5p,25,A>T,486,604,1090,6349777,6167551,12517328,8.707928720889954e-05
DAL193,3p,1,A>T,21,6,27,6484405,6362696,12847101,2.101641452028749e-06
DAL193,3p,2,A>T,32,8,40,6484402,6362696,12847098,3.113543618955814e-06
DAL193,3p,3,A>T,197,397,594,6484405,6362696,12847101,4.623611194463249e-05
DAL193,3p,4,A>T,199,250,449,6484405,6362696,12847101,3.494951896151513e-05
DAL193,3p,5,A>T,698,1092,1790,6484405,6362696,12847101,0.0001393310444122
DAL193,3p,6,A>T,883,1414,2297,6484405,6362696,12847101,0.000178795200567
DAL193,3p,7,A>T,659,1106,1765,6484405,6362696,12847101,0.0001373850801048
DAL193,3p,8,A>T,875,1217,2092,6484400,6362644,12847044,0.0001628390157299
DAL193,3p,9,A>T,957,1690,2647,6484400,6362631,12847031,0.0002060398235203
DAL193,3p,10,A>T,1336,1264,2600,6484393,6362640,12847033,0.0002023813591823
DAL193,3p,11,A>T,951,1338,2289,6484398,6362639,12847037,0.0001781733795893
DAL193,3p,12,A>T,1321,1440,2761,6484368,6362594,12846962,0.000214914623395
DAL193,3p,13,A>T,1119,1208,2327,6484385,6362543,12846928,0.0001811327968834
DAL193,3p,14,A>T,841,1457,2298,6484363,6362486,12846849,0.0001788765478601
DAL193,3p,15,A>T,1439,1444,2883,6484332,6362438,12846770,0.0002244143858728
DAL193,3p,16,A>T,1088,1328,2416,6484341,6362460,12846801,0.0001880623822226
DAL193,3p,17,A>T,1158,1219,2377,6484294,6362445,12846739,0.0001850274999748
DAL193,3p,18,A>T,1714,1342,3056,6484244,6362380,12846624,0.0002378835093173
DAL193,3p,19,A>T,1300,1222,2522,6484265,6362400,12846665,0.0001963155418157
DAL193,3p,20,A>T,1147,1182,2329,6484261,6362382,12846643,0.00018129249797
DAL193,3p,21,A>T,1408,1485,2893,6484248,6362443,12846691,0.0002251941764614
DAL193,3p,22,A>T,1296,1586,2882,6484224,6362407,12846631,0.0002243389726069
DAL193,3p,23,A>T,1419,1228,2647,6484218,6362399,12846617,0.0002060464634385
DAL193,3p,24,A>T,1496,1786,3282,6484164,6362319,12846483,0.0002554784838776
DAL193,3p,25,A>T,1212,1179,2391,6484128,6362355,12846483,0.0001861209795708
DAL193,5p,1,A>T,5,22,27,6484405,6362696,12847101,2.101641452028749e-06
DAL193,5p,2,A>T,34,68,102,6484386,6362681,12847067,7.939555386455134e-06
DAL193,5p,3,A>T,53,69,122,6484400,6362696,12847096,9.496309516173928e-06
DAL193,5p,4,A>T,164,152,316,6484403,6362696,12847099,2.459699267515569e-05
DAL193,5p,5,A>T,896,762,1658,6484403,6362696,12847099,0.0001290563729601
DAL193,5p,6,A>T,822,1055,1877,6484404,6362696,12847100,0.0001461030115745
DAL193,5p,7,A>T,1520,1573,3093,6484404,6362696,12847100,0.0002407547228557
DAL193,5p,8,A>T,1133,1249,2382,6484314,6362693,12847007,0.0001854128358457
DAL193,5p,9,A>T,1562,1525,3087,6484295,6362695,12846990,0.0002402897488049
DAL193,5p,10,A>T,1186,1349,2535,6484284,6362694,12846978,0.0001973226699695
DAL193,5p,11,A>T,1516,1049,2565,6484315,6362677,12846992,0.0001996576319188
DAL193,5p,12,A>T,1753,1623,3376,6484218,6362670,12846888,0.0002627873769896
DAL193,5p,13,A>T,1792,1489,3281,6484143,6362652,12846795,0.0002553944388464
DAL193,5p,14,A>T,1513,1309,2822,6484145,6362627,12846772,0.0002196660764276
DAL193,5p,15,A>T,1429,1614,3043,6484166,6362534,12846700,0.0002368701689928
DAL193,5p,16,A>T,1532,1323,2855,6484111,6362519,12846630,0.0002222372715646
DAL193,5p,17,A>T,1461,1296,2757,6484043,6362598,12846641,0.0002146086280452
DAL193,5p,18,A>T,1521,1488,3009,6483967,6362571,12846538,0.0002342265285791
DAL193,5p,19,A>T,1494,1262,2756,6483980,6362593,12846573,0.0002145319222488
DAL193,5p,20,A>T,1416,1258,2674,6483952,6362554,12846506,0.0002081499825711
DAL193,5p,21,A>T,1768,1711,3479,6484003,6362532,12846535,0.0002708123241014
DAL193,5p,22,A>T,1237,1467,2704,6484010,6362499,12846509,0.0002104851987415
DAL193,5p,23,A>T,1221,1495,2716,6483966,6362463,12846429,0.0002114206212481
DAL193,5p,24,A>T,1427,1610,3037,6483905,6362426,12846331,0.0002364099134608
DAL193,5p,25,A>T,1376,1517,2893,6483942,6362403,12846345,0.0002252002417808
DAL195,3p,1,A>T,5,11,16,2363278,2267461,4630739,3.4551720578508096e-06
DAL195,3p,2,A>T,3,5,8,2363278,2267460,4630738,1.727586401994671e-06
DAL195,3p,3,A>T,179,67,246,2363278,2267461,4630739,5.31232703894562e-05
DAL195,3p,4,A>T,55,35,90,2363278,2267461,4630739,1.9435342825410803e-05
DAL195,3p,5,A>T,174,195,369,2363278,2267461,4630739,7.968490558418429e-05
DAL195,3p,6,A>T,176,209,385,2363278,2267461,4630739,8.31400776420351e-05
DAL195,3p,7,A>T,120,192,312,2363278,2267461,4630739,6.737585512809079e-05
DAL195,3p,8,A>T,212,194,406,2363278,2267413,4630691,8.767589977392143e-05
DAL195,3p,9,A>T,210,222,432,2363276,2267438,4630714,9.329014920809188e-05
DAL195,3p,10,A>T,238,260,498,2363274,2267432,4630706,0.0001075429966834
DAL195,3p,11,A>T,174,199,373,2363274,2267431,4630705,8.054929001091626e-05
DAL195,3p,12,A>T,246,305,551,2363273,2267414,4630687,0.0001189888239045
DAL195,3p,13,A>T,198,281,479,2363269,2267412,4630681,0.0001034405090741
DAL195,3p,14,A>T,232,248,480,2363250,2267410,4630660,0.0001036569301136
DAL195,3p,15,A>T,228,366,594,2363254,2267411,4630665,0.0001282753125091
DAL195,3p,16,A>T,278,290,568,2363259,2267394,4630653,0.0001226608860564
DAL195,3p,17,A>T,186,314,500,2363234,2267398,4630632,0.0001079766217656
DAL195,3p,18,A>T,198,287,485,2363236,2267374,4630610,0.000104737820719
DAL195,3p,19,A>T,329,286,615,2363215,2267369,4630584,0.0001328126214749
DAL195,3p,20,A>T,212,308,520,2363222,2267380,4630602,0.0001122964141595
DAL195,3p,21,A>T,283,284,567,2363235,2267382,4630617,0.000122445885721
DAL195,3p,22,A>T,278,349,627,2363231,2267383,4630614,0.0001354032100278
DAL195,3p,23,A>T,236,354,590,2363219,2267370,4630589,0.0001274135968448
DAL195,3p,24,A>T,314,335,649,2363198,2267373,4630571,0.0001401555013409
DAL195,3p,25,A>T,345,462,807,2363180,2267377,4630557,0.0001742770902075
DAL195,5p,1,A>T,1,7,8,2363278,2267461,4630739,1.7275860289254048e-06
DAL195,5p,2,A>T,4,9,13,2363264,2267447,4630711,2.8073442717543806e-06
DAL195,5p,3,A>T,7,16,23,2363278,2267459,4630737,4.966811978309284e-06
DAL195,5p,4,A>T,38,29,67,2363278,2267461,4630739,1.4468532992250264e-05
DAL195,5p,5,A>T,281,102,383,2363277,2267461,4630738,8.270819899549488e-05
DAL195,5p,6,A>T,179,153,332,2363277,2267461,4630738,7.169483568277886e-05
DAL195,5p,7,A>T,389,312,701,2363277,2267461,4630738,0.0001513797584747
DAL195,5p,8,A>T,219,261,480,2363212,2267460,4630672,0.0001036566614953
DAL195,5p,9,A>T,237,282,519,2363181,2267461,4630642,0.0001120794913534
DAL195,5p,10,A>T,281,244,525,2363146,2267458,4630604,0.0001133761384044
DAL195,5p,11,A>T,211,195,406,2362948,2267450,4630398,8.768144768549053e-05
DAL195,5p,12,A>T,315,194,509,2362864,2267454,4630318,0.0001099276550768
DAL195,5p,13,A>T,295,324,619,2363073,2267445,4630518,0.000133678348729
DAL195,5p,14,A>T,275,255,530,2363094,2267434,4630528,0.0001144577896948
DAL195,5p,15,A>T,321,280,601,2363178,2267432,4630610,0.0001297885159838
DAL195,5p,16,A>T,301,465,766,2363170,2267429,4630599,0.0001654213634132
DAL195,5p,17,A>T,249,253,502,2363159,2267431,4630590,0.0001084095115309
DAL195,5p,18,A>T,234,293,527,2363182,2267420,4630602,0.0001138080966578
DAL195,5p,19,A>T,252,263,515,2363138,2267420,4630558,0.0001112176977375
DAL195,5p,20,A>T,233,256,489,2363110,2267401,4630511,0.0001056038955527
DAL195,5p,21,A>T,257,335,592,2363086,2267400,4630486,0.0001278483511234
DAL195,5p,22,A>T,332,329,661,2363094,2267388,4630482,0.0001427497180639
DAL195,5p,23,A>T,203,410,613,2363068,2267398,4630466,0.0001323840840209
DAL195,5p,24,A>T,286,387,673,2363067,2267402,4630469,0.0001453416489776
DAL195,5p,25,A>T,244,373,617,2363135,2267374,4630509,0.0001332466905906
DAL212,3p,1,A>T,6,2,8,4131322,4008153,8139475,9.828643739307511e-07
DAL212,3p,2,A>T,10,5,15,4131322,4008153,8139475,1.8428707011201585e-06
DAL212,3p,3,A>T,116,125,241,4131322,4008153,8139475,2.9608789264663878e-05
DAL212,3p,4,A>T,134,143,277,4131322,4008153,8139475,3.403167894735226e-05
DAL212,3p,5,A>T,395,529,924,4131322,4008151,8139473,0.0001135208630829
DAL212,3p,6,A>T,453,501,954,4131322,4008151,8139473,0.0001172066053907
DAL212,3p,7,A>T,445,422,867,4131322,4008153,8139475,0.0001065179265247
DAL212,3p,8,A>T,611,470,1081,4131319,4008093,8139412,0.0001328105764888
DAL212,3p,9,A>T,504,607,1111,4131316,4008115,8139431,0.0001364960277935
DAL212,3p,10,A>T,637,563,1200,4131317,4008102,8139419,0.00014743067042
DAL212,3p,11,A>T,594,442,1036,4131313,4008105,8139418,0.000127281827767
DAL212,3p,12,A>T,483,494,977,4131314,4008034,8139348,0.0001200341845563
DAL212,3p,13,A>T,531,419,950,4131307,4007923,8139230,0.0001167186576617
DAL212,3p,14,A>T,432,426,858,4131271,4007904,8139175,0.0001054160894685
DAL212,3p,15,A>T,606,500,1106,4131254,4007935,8139189,0.0001358857743689
DAL212,3p,16,A>T,514,502,1016,4131236,4007982,8139218,0.0001248277168642
DAL212,3p,17,A>T,575,657,1232,4131249,4007981,8139230,0.0001513656697255
DAL212,3p,18,A>T,533,465,998,4131222,4007954,8139176,0.0001226168349228
DAL212,3p,19,A>T,571,442,1013,4131233,4007956,8139189,0.000124459574535
DAL212,3p,20,A>T,558,468,1026,4131221,4007928,8139149,0.0001260574047729
DAL212,3p,21,A>T,529,506,1035,4131228,4007917,8139145,0.000127163233976
DAL212,3p,22,A>T,577,493,1070,4131183,4007898,8139081,0.0001314644736918
DAL212,3p,23,A>T,522,577,1099,4131172,4007904,8139076,0.0001350276124709
DAL212,3p,24,A>T,615,620,1235,4131124,4007904,8139028,0.0001517380208054
DAL212,3p,25,A>T,563,539,1102,4131071,4007924,8138995,0.0001353975521547
DAL212,5p,1,A>T,1,13,14,4131322,4008153,8139475,1.7200126543788143e-06
DAL212,5p,2,A>T,4,23,27,4131307,4008143,8139450,3.3171774505648417e-06
DAL212,5p,3,A>T,20,17,37,4131321,4008153,8139474,4.545748287911479e-06
DAL212,5p,4,A>T,209,93,302,4131322,4008153,8139475,3.710313011588585e-05
DAL212,5p,5,A>T,383,404,787,4131322,4008153,8139475,9.668928278543764e-05
DAL212,5p,6,A>T,335,331,666,4131322,4008153,8139475,8.182345912973502e-05
DAL212,5p,7,A>T,697,584,1281,4131322,4008153,8139475,0.0001573811578756
DAL212,5p,8,A>T,478,414,892,4131248,4008153,8139401,0.0001095903740336
DAL212,5p,9,A>T,400,538,938,4131243,4008153,8139396,0.0001152419663572
DAL212,5p,10,A>T,523,502,1025,4131179,4008148,8139327,0.0001259317877264
DAL212,5p,11,A>T,381,413,794,4131234,4008143,8139377,9.755046362885022e-05
DAL212,5p,12,A>T,514,559,1073,4131187,4008141,8139328,0.0001318290650038
DAL212,5p,13,A>T,579,558,1137,4131181,4008142,8139323,0.0001396922078163
DAL212,5p,14,A>T,640,423,1063,4131134,4008108,8139242,0.0001306018422845
DAL212,5p,15,A>T,502,521,1023,4131156,4008091,8139247,0.0001256873025231
DAL212,5p,16,A>T,404,511,915,4131154,4008081,8139235,0.0001124184275303
DAL212,5p,17,A>T,461,673,1134,4131159,4008081,8139240,0.0001393250475474
DAL212,5p,18,A>T,592,686,1278,4131113,4008066,8139179,0.0001570182938598
DAL212,5p,19,A>T,545,583,1128,4131040,4008052,8139092,0.0001385903980444
DAL212,5p,20,A>T,467,624,1091,4131020,4008040,8139060,0.0001340449634232
DAL212,5p,21,A>T,520,632,1152,4130973,4008040,8139013,0.0001415405037441
DAL212,5p,22,A>T,757,709,1466,4131015,4007967,8138982,0.0001801208062629
DAL212,5p,23,A>T,596,518,1114,4131005,4007962,8138967,0.0001368724065351
DAL212,5p,24,A>T,823,623,1446,4131060,4007918,8138978,0.0001776635838062
DAL212,5p,25,A>T,597,490,1087,4131016,4007614,8138630,0.0001335605624042
DAL218,3p,1,A>T,24,14,38,6952891,6658031,13610922,2.791875524670555e-06
DAL218,3p,2,A>T,21,26,47,6952891,6658031,13610922,3.453109201566213e-06
DAL218,3p,3,A>T,256,372,628,6952891,6658030,13610921,4.613941995549016e-05
DAL218,3p,4,A>T,209,370,579,6952891,6658031,13610922,4.2539366546953984e-05
DAL218,3p,5,A>T,874,1046,1920,6952891,6658031,13610922,0.0001410631844044
DAL218,3p,6,A>T,944,1191,2135,6952891,6658030,13610921,0.0001568593337658
DAL218,3p,7,A>T,850,885,1735,6952891,6658026,13610917,0.0001274712056505
DAL218,3p,8,A>T,909,1337,2246,6952887,6657945,13610832,0.0001650156287286
DAL218,3p,9,A>T,1233,1472,2705,6952882,6657945,13610827,0.0001987388422466
DAL218,3p,10,A>T,1314,1432,2746,6952881,6657960,13610841,0.0002017509425023
DAL218,3p,11,A>T,1105,1264,2369,6952866,6657905,13610771,0.0001740533287937
DAL218,3p,12,A>T,1082,1927,3009,6952858,6657882,13610740,0.0002210754154439
DAL218,3p,13,A>T,973,1475,2448,6952870,6657811,13610681,0.0001798587447608
DAL218,3p,14,A>T,1092,1981,3073,6952816,6657779,13610595,0.00022577998978
DAL218,3p,15,A>T,1429,1631,3060,6952788,6657738,13610526,0.0002248259912952
DAL218,3p,16,A>T,1348,1614,2962,6952760,6657689,13610449,0.0002176269129695
DAL218,3p,17,A>T,1117,1382,2499,6952737,6657651,13610388,0.0001836097545492
DAL218,3p,18,A>T,1136,1421,2557,6952711,6657672,13610383,0.0001878712744527
DAL218,3p,19,A>T,1153,1910,3063,6952716,6657697,13610413,0.000225048277374
DAL218,3p,20,A>T,1229,1667,2896,6952697,6657752,13610449,0.0002127776974881
DAL218,3p,21,A>T,1404,1468,2872,6952660,6657692,13610352,0.000211015850288
DAL218,3p,22,A>T,1404,1304,2708,6952654,6657637,13610291,0.000198967090417
DAL218,3p,23,A>T,1096,1637,2733,6952651,6657632,13610283,0.0002008040538172
DAL218,3p,24,A>T,1522,1330,2852,6952669,6657588,13610257,0.0002095478432185
DAL218,3p,25,A>T,1311,1467,2778,6952605,6657566,13610171,0.0002041120570784
DAL218,5p,1,A>T,5,53,58,6952891,6658031,13610922,4.261283695549795e-06
DAL218,5p,2,A>T,45,27,72,6952874,6658014,13610888,5.289882629259752e-06
DAL218,5p,3,A>T,34,47,81,6952891,6658031,13610922,5.95110309206092e-06
DAL218,5p,4,A>T,100,102,202,6952891,6658031,13610922,1.4841022525880318e-05
DAL218,5p,5,A>T,607,876,1483,6952891,6658031,13610922,0.0001089566158706
DAL218,5p,6,A>T,774,682,1456,6952891,6658031,13610922,0.00010697291484
DAL218,5p,7,A>T,1273,1753,3026,6952888,6658031,13610919,0.0002223215052561
DAL218,5p,8,A>T,948,1379,2327,6952719,6658029,13610748,0.000170967826309
DAL218,5p,9,A>T,1309,1178,2487,6952736,6658029,13610765,0.0001827230137321
DAL218,5p,10,A>T,1053,1060,2113,6952716,6658028,13610744,0.000155245003506
DAL218,5p,11,A>T,823,985,1808,6952715,6658016,13610731,0.0001328363627199
DAL218,5p,12,A>T,1562,1427,2989,6952625,6658005,13610630,0.0002196077624621
DAL218,5p,13,A>T,1401,1251,2652,6952475,6658005,13610480,0.0001948498509971
DAL218,5p,14,A>T,1388,1277,2665,6952554,6657955,13610509,0.0001958045801226
DAL218,5p,15,A>T,1359,1518,2877,6952449,6657923,13610372,0.0002113829070946
DAL218,5p,16,A>T,1134,1306,2440,6952253,6657920,13610173,0.0001792776623779
DAL218,5p,17,A>T,1150,1376,2526,6952350,6657874,13610224,0.0001855957697683
DAL218,5p,18,A>T,1354,1254,2608,6952457,6657843,13610300,0.0001916195822281
DAL218,5p,19,A>T,1397,1346,2743,6952296,6657770,13610066,0.0002015420057478
DAL218,5p,20,A>T,1111,1295,2406,6952289,6657772,13610061,0.0001767809857722
DAL218,5p,21,A>T,1354,1266,2620,6952371,6657729,13610100,0.0001925040962226
DAL218,5p,22,A>T,1320,1825,3145,6952322,6657786,13610108,0.0002310782544855
DAL218,5p,23,A>T,1099,1433,2532,6952288,6657745,13610033,0.0001860392256212
DAL218,5p,24,A>T,1611,2052,3663,6952375,6657772,13610147,0.0002691374310652
DAL218,5p,25,A>T,1573,1553,3126,6952272,6657720,13609992,0.0002296841908503
DAL224,3p,1,A>T,7,14,21,4609472,4586477,9195949,2.283614230570439e-06
DAL224,3p,2,A>T,21,8,29,4609471,4586476,9195947,3.1535631947422053e-06
DAL224,3p,3,A>T,89,466,555,4609472,4586477,9195949,6.035266180793304e-05
DAL224,3p,4,A>T,584,427,1011,4609472,4586477,9195949,0.0001099397136717
DAL224,3p,5,A>T,477,444,921,4609472,4586477,9195949,0.0001001527955407
DAL224,3p,6,A>T,409,479,888,4609472,4586477,9195949,9.656425889269284e-05
DAL224,3p,7,A>T,422,365,787,4609472,4586476,9195948,8.5581171185396e-05
DAL224,3p,8,A>T,464,434,898,4609469,4586423,9195892,9.76522995267887e-05
DAL224,3p,9,A>T,434,436,870,4609466,4586431,9195897,9.460741023958838e-05
DAL224,3p,10,A>T,1002,590,1592,4609461,4586371,9195832,0.0001731219100131
DAL224,3p,11,A>T,437,628,1065,4609461,4586382,9195843,0.0001158131995076
DAL224,3p,12,A>T,578,466,1044,4609458,4586384,9195842,0.0001135295712997
DAL224,3p,13,A>T,749,629,1378,4609454,4586364,9195818,0.0001498507256233
DAL224,3p,14,A>T,701,465,1166,4609412,4586293,9195705,0.0001267983259576
DAL224,3p,15,A>T,684,566,1250,4609400,4586272,9195672,0.00013593351307
DAL224,3p,16,A>T,712,737,1449,4609379,4586240,9195619,0.0001575750365472
DAL224,3p,17,A>T,632,753,1385,4609381,4586216,9195597,0.0001506155609037
DAL224,3p,18,A>T,892,609,1501,4609363,4586282,9195645,0.0001632294417629
DAL224,3p,19,A>T,699,653,1352,4609353,4586195,9195548,0.0001470276703465
DAL224,3p,20,A>T,593,726,1319,4609344,4586225,9195569,0.0001434386496365
DAL224,3p,21,A>T,631,859,1490,4609343,4586223,9195566,0.0001620346153787
DAL224,3p,22,A>T,650,644,1294,4609324,4586172,9195496,0.0001407210660523
DAL224,3p,23,A>T,723,929,1652,4609323,4586083,9195406,0.0001796549276888
DAL224,3p,24,A>T,886,992,1878,4609325,4586202,9195527,0.0002042297303895
DAL224,3p,25,A>T,750,747,1497,4609265,4586173,9195438,0.0001627981179363
DAL224,5p,1,A>T,6,7,13,4609472,4586477,9195949,1.4136659522578909e-06
DAL224,5p,2,A>T,9,17,26,4609461,4586469,9195930,2.8273377461550925e-06
DAL224,5p,3,A>T,17,46,63,4609468,4586477,9195945,6.850845671652016e-06
DAL224,5p,4,A>T,255,49,304,4609471,4586477,9195948,3.305803817072476e-05
DAL224,5p,5,A>T,923,218,1141,4609471,4586477,9195948,0.0001240763866868
DAL224,5p,6,A>T,338,383,721,4609472,4586477,9195949,7.840408858291842e-05
DAL224,5p,7,A>T,840,593,1433,4609471,4586477,9195948,0.0001558295022981
DAL224,5p,8,A>T,904,422,1326,4609397,4586477,9195874,0.0001441951031516
DAL224,5p,9,A>T,607,524,1131,4609357,4586473,9195830,0.000122990529403
DAL224,5p,10,A>T,424,350,774,4609338,4586470,9195808,8.41687864731408e-05
DAL224,5p,11,A>T,565,467,1032,4609388,4586469,9195857,0.0001122244506411
DAL224,5p,12,A>T,800,497,1297,4609357,4586464,9195821,0.0001410423278139
DAL224,5p,13,A>T,625,483,1108,4609320,4586461,9195781,0.0001204900377684
DAL224,5p,14,A>T,660,573,1233,4609270,4586428,9195698,0.0001340844381796
DAL224,5p,15,A>T,812,641,1453,4609299,4586416,9195715,0.0001580083767276
DAL224,5p,16,A>T,644,599,1243,4609292,4586373,9195665,0.0001351723882938
DAL224,5p,17,A>T,588,549,1137,4609285,4586385,9195670,0.0001236451503805
DAL224,5p,18,A>T,690,556,1246,4609226,4586351,9195577,0.0001354999256707
DAL224,5p,19,A>T,602,739,1341,4609203,4586337,9195540,0.0001458315661722
DAL224,5p,20,A>T,579,760,1339,4609148,4586313,9195461,0.0001456153204281
DAL224,5p,21,A>T,539,671,1210,4609195,4586347,9195542,0.0001315855008872
DAL224,5p,22,A>T,547,566,1113,4609138,4586312,9195450,0.0001210381221147
DAL224,5p,23,A>T,620,601,1221,4609100,4586313,9195413,0.000132783595473
DAL224,5p,24,A>T,780,589,1369,4609109,4586316,9195425,0.0001488783824564
DAL224,5p,25,A>T,832,735,1567,4609125,4586257,9195382,0.0001704116261836
DAL227,3p,1,A>T,9,6,15,3765386,3771243,7536629,1.9902797391247465e-06
DAL227,3p,2,A>T,13,15,28,3765386,3771243,7536629,3.7151888463661935e-06
DAL227,3p,3,A>T,255,221,476,3765386,3771243,7536629,6.31582103882253e-05
DAL227,3p,4,A>T,212,171,383,3765386,3771243,7536629,5.081847600565187e-05
DAL227,3p,5,A>T,362,288,650,3765386,3771243,7536629,8.624545536207235e-05
DAL227,3p,6,A>T,518,311,829,3765386,3771243,7536629,0.0001099961269156
DAL227,3p,7,A>T,275,179,454,3765386,3771243,7536629,6.0239133437509e-05
DAL227,3p,8,A>T,467,309,776,3765386,3771207,7536593,0.0001029642969973
DAL227,3p,9,A>T,483,470,953,3765384,3771218,7536602,0.0001264495590983
DAL227,3p,10,A>T,611,404,1015,3765382,3771209,7536591,0.0001346762747242
DAL227,3p,11,A>T,409,326,735,3765378,3771214,7536592,9.752418599812754e-05
DAL227,3p,12,A>T,542,374,916,3765377,3771173,7536550,0.0001215410234125
DAL227,3p,13,A>T,294,403,697,3765373,3771183,7536556,9.248256100001116e-05
DAL227,3p,14,A>T,417,280,697,3765341,3771166,7536507,9.248316229255808e-05
DAL227,3p,15,A>T,418,327,745,3765341,3771186,7536527,9.885189822845457e-05
DAL227,3p,16,A>T,329,430,759,3765340,3771079,7536419,0.0001007109610015
DAL227,3p,17,A>T,437,426,863,3765328,3771049,7536377,0.0001145112565361
DAL227,3p,18,A>T,511,445,956,3765321,3771036,7536357,0.000126851740171
DAL227,3p,19,A>T,538,340,878,3765313,3771111,7536424,0.0001165008762776
DAL227,3p,20,A>T,648,288,936,3765308,3771082,7536390,0.0001241973942431
DAL227,3p,21,A>T,403,432,835,3765307,3771104,7536411,0.0001107954436136
DAL227,3p,22,A>T,391,464,855,3765309,3771137,7536446,0.0001134486998248
DAL227,3p,23,A>T,646,367,1013,3765319,3771112,7536431,0.0001344137563257
DAL227,3p,24,A>T,585,457,1042,3765312,3771081,7536393,0.0001382624287241
DAL227,3p,25,A>T,401,365,766,3765249,3771100,7536349,0.0001016407281562
DAL227,5p,1,A>T,14,5,19,3765386,3771243,7536629,2.5210210028913457e-06
DAL227,5p,2,A>T,45,19,64,3765373,3771238,7536611,8.491880501726837e-06
DAL227,5p,3,A>T,20,18,38,3765386,3771243,7536629,5.042042005782692e-06
DAL227,5p,4,A>T,32,43,75,3765385,3771243,7536628,9.951400016028388e-06
DAL227,5p,5,A>T,141,269,410,3765386,3771242,7536628,5.440098675428852e-05
DAL227,5p,6,A>T,276,274,550,3765386,3771243,7536629,7.297692376790737e-05
DAL227,5p,7,A>T,695,316,1011,3765386,3771243,7536629,0.000134144854417
DAL227,5p,8,A>T,210,337,547,3765342,3771242,7536584,7.257930117942028e-05
DAL227,5p,9,A>T,309,775,1084,3765324,3771243,7536567,0.0001438320657137
DAL227,5p,10,A>T,457,246,703,3765318,3771238,7536556,9.32786806068979e-05
DAL227,5p,11,A>T,243,245,488,3765365,3771237,7536602,6.475066614901517e-05
DAL227,5p,12,A>T,399,676,1075,3765326,3771232,7536558,0.0001426380583815
DAL227,5p,13,A>T,684,354,1038,3765325,3771231,7536556,0.0001377286919914
DAL227,5p,14,A>T,352,548,900,3765297,3771226,7536523,0.0001194184639256
DAL227,5p,15,A>T,452,431,883,3765318,3771201,7536519,0.0001171628440132
DAL227,5p,16,A>T,605,450,1055,3765316,3771188,7536504,0.0001399853300681
DAL227,5p,17,A>T,499,425,924,3765326,3771175,7536501,0.0001226033141904
DAL227,5p,18,A>T,1020,637,1657,3765280,3771169,7536449,0.0002198648196252
DAL227,5p,19,A>T,890,563,1453,3765279,3771164,7536443,0.0001927965221789
DAL227,5p,20,A>T,533,498,1031,3765254,3771167,7536421,0.0001368023362813
DAL227,5p,21,A>T,813,630,1443,3765270,3771169,7536439,0.0001914697378961
DAL227,5p,22,A>T,685,688,1373,3765253,3771158,7536411,0.0001821822084809
DAL227,5p,23,A>T,682,562,1244,3765254,3771157,7536411,0.0001650653076112
DAL227,5p,24,A>T,1298,833,2131,3765270,3771180,7536450,0.0002827591239907
DAL227,5p,25,A>T,508,560,1068,3765247,3771148,7536395,0.0001417123173612
WA02,3p,1,A>T,10,18,28,6552698,6754258,13306956,2.10416266500017e-06
WA02,3p,2,A>T,56,29,85,6552698,6754258,13306956,6.387636661607658e-06
WA02,3p,3,A>T,157,108,265,6552698,6754258,13306956,1.9914396650894465e-05
WA02,3p,4,A>T,149,171,320,6552698,6754256,13306954,2.4047576928574337e-05
WA02,3p,5,A>T,390,381,771,6552698,6754256,13306954,5.79396306622838e-05
WA02,3p,6,A>T,391,311,702,6552698,6754257,13306955,5.275436792263895e-05
WA02,3p,7,A>T,437,441,878,6552698,6754257,13306955,6.598053423942592e-05
WA02,3p,8,A>T,445,537,982,6552692,6754207,13306899,7.379630671278109e-05
WA02,3p,9,A>T,610,556,1166,6552688,6754191,13306879,8.762385229474168e-05
WA02,3p,10,A>T,634,602,1236,6552680,6754207,13306887,9.28842335551508e-05
WA02,3p,11,A>T,525,768,1293,6552667,6754202,13306869,9.716786120010652e-05
WA02,3p,12,A>T,520,674,1194,6552670,6754189,13306859,8.972816199525372e-05
WA02,3p,13,A>T,494,652,1146,6552675,6754177,13306852,8.612104500748938e-05
WA02,3p,14,A>T,493,465,958,6552653,6754155,13306808,7.199322331846977e-05
WA02,3p,15,A>T,716,593,1309,6552632,6754146,13306778,9.83709204437017e-05
WA02,3p,16,A>T,774,651,1425,6552629,6754119,13306748,0.0001070885238076
WA02,3p,17,A>T,641,564,1205,6552608,6754116,13306724,9.055572205450418e-05
WA02,3p,18,A>T,580,478,1058,6552611,6754085,13306696,7.950884276607807e-05
WA02,3p,19,A>T,629,631,1260,6552605,6754056,13306661,9.468941908116544e-05
WA02,3p,20,A>T,629,662,1291,6552618,6754033,13306651,9.701915230210815e-05
WA02,3p,21,A>T,640,688,1328,6552597,6754089,13306686,9.97994541991898e-05
WA02,3p,22,A>T,600,612,1212,6552593,6754062,13306655,9.108224418533433e-05
WA02,3p,23,A>T,586,527,1113,6552585,6754052,13306637,8.364247104659126e-05
WA02,3p,24,A>T,595,658,1253,6552556,6754026,13306582,9.41639257925138e-05
WA02,3p,25,A>T,650,645,1295,6552517,6754038,13306555,9.732045597076028e-05
WA02,5p,1,A>T,9,21,30,6552698,6754258,13306956,2.254459998214468e-06
WA02,5p,2,A>T,33,74,107,6552562,6754179,13306741,8.041037245708774e-06
WA02,5p,3,A>T,50,73,123,6552698,6754258,13306956,9.243285992679318e-06
WA02,5p,4,A>T,116,97,213,6552698,6754258,13306956,1.600666598732272e-05
WA02,5p,5,A>T,377,365,742,6552698,6754258,13306956,5.57603106225045e-05
WA02,5p,6,A>T,460,357,817,6552697,6754258,13306955,6.139646523190317e-05
WA02,5p,7,A>T,641,775,1416,6552685,6754258,13306943,0.0001064106158717
WA02,5p,8,A>T,515,672,1187,6552655,6754257,13306912,8.92017622119993e-05
WA02,5p,9,A>T,639,715,1354,6552662,6754226,13306888,0.0001017518145489
WA02,5p,10,A>T,570,583,1153,6552618,6754222,13306840,8.664716792266233e-05
WA02,5p,11,A>T,531,428,959,6552625,6754225,13306850,7.206814535370881e-05
WA02,5p,12,A>T,714,595,1309,6552628,6754236,13306864,9.837028468916492e-05
WA02,5p,13,A>T,629,553,1182,6552614,6754205,13306819,8.882663843252095e-05
WA02,5p,14,A>T,521,579,1100,6552607,6754183,13306790,8.266456448174202e-05
WA02,5p,15,A>T,665,720,1385,6552586,6754168,13306754,0.0001040824832261
WA02,5p,16,A>T,673,551,1224,6552525,6754178,13306703,9.198371677792764e-05
WA02,5p,17,A>T,585,586,1171,6552567,6754148,13306715,8.800068236225094e-05
WA02,5p,18,A>T,681,744,1425,6552548,6754087,13306635,0.0001070894332038
WA02,5p,19,A>T,649,770,1419,6552516,6754124,13306640,0.0001066384902574
WA02,5p,20,A>T,829,740,1569,6552507,6754132,13306639,0.000117911066799
WA02,5p,21,A>T,856,713,1569,6552521,6754152,13306673,0.0001179107655234
WA02,5p,22,A>T,875,660,1535,6552516,6754117,13306633,0.0001153560032804
WA02,5p,23,A>T,699,620,1319,6552465,6754131,13306596,9.912377290179998e-05
WA02,5p,24,A>T,718,655,1373,6552457,6754135,13306592,0.0001031819417022
WA02,5p,25,A>T,832,711,1543,6552470,6754083,13306553,0.0001159579043498
WA03,3p,1,A>T,39,24,63,5399458,5543742,10943200,5.756999780685723e-06
WA03,3p,2,A>T,61,55,116,5399458,5543742,10943200,1.0600190072373712e-05
WA03,3p,3,A>T,445,936,1381,5399458,5543742,10943200,0.0001261970904305
WA03,3p,4,A>T,324,525,849,5399458,5543736,10943194,7.758246815326494e-05
WA03,3p,5,A>T,1241,1393,2634,5399458,5543740,10943198,0.0002406974633923
WA03,3p,6,A>T,1175,1649,2824,5399458,5543741,10943199,0.0002580598232747
WA03,3p,7,A>T,1342,1368,2710,5399458,5543739,10943197,0.0002476424394077
WA03,3p,8,A>T,1347,2426,3773,5399449,5543673,10943122,0.0003447827777118
WA03,3p,9,A>T,1454,1647,3101,5399436,5543670,10943106,0.0002833747566732
WA03,3p,10,A>T,1698,1678,3376,5399438,5543654,10943092,0.0003085051281667
WA03,3p,11,A>T,1595,1505,3100,5399404,5543644,10943048,0.0002832848763891
WA03,3p,12,A>T,1506,2023,3529,5399397,5543595,10942992,0.0003224894983017
WA03,3p,13,A>T,1491,1509,3000,5399378,5543551,10942929,0.0002741496358059
WA03,3p,14,A>T,1477,1687,3164,5399356,5543493,10942849,0.0002891385963563
WA03,3p,15,A>T,1745,2044,3789,5399349,5543505,10942854,0.0003462533631537
WA03,3p,16,A>T,1533,1825,3358,5399342,5543495,10942837,0.0003068674055914
WA03,3p,17,A>T,1572,1795,3367,5399346,5543438,10942784,0.0003076913516706
WA03,3p,18,A>T,1584,1853,3437,5399325,5543443,10942768,0.0003140887205138
WA03,3p,19,A>T,1391,1758,3149,5399297,5543425,10942722,0.0002877711779573
WA03,3p,20,A>T,1484,1797,3281,5399252,5543409,10942661,0.0002998356615452
WA03,3p,21,A>T,1485,2211,3696,5399248,5543303,10942551,0.0003377640186461
WA03,3p,22,A>T,1460,1967,3427,5399256,5543263,10942519,0.0003131820013289
WA03,3p,23,A>T,1483,1659,3142,5399255,5543267,10942522,0.0002871367313677
WA03,3p,24,A>T,1861,2076,3937,5399198,5543130,10942328,0.0003597954658277
WA03,3p,25,A>T,1581,1828,3409,5399050,5543142,10942192,0.0003115463519558
WA03,5p,1,A>T,19,38,57,5399457,5543742,10943199,5.208714563264362e-06
WA03,5p,2,A>T,69,137,206,5399258,5543638,10942896,1.8824998428204016e-05
WA03,5p,3,A>T,127,242,369,5399457,5543742,10943199,3.371957322534297e-05
WA03,5p,4,A>T,294,174,468,5399458,5543742,10943200,4.276628408509394e-05
WA03,5p,5,A>T,1140,954,2094,5399456,5543740,10943196,0.0001913517769397
WA03,5p,6,A>T,1429,1003,2432,5399452,5543742,10943194,0.0002222385895744
WA03,5p,7,A>T,1749,1944,3693,5399453,5543742,10943195,0.0003374699984785
WA03,5p,8,A>T,1730,1840,3570,5399403,5543732,10943135,0.000326231925312
WA03,5p,9,A>T,2090,1841,3931,5399319,5543732,10943051,0.0003592234012251
WA03,5p,10,A>T,1656,1697,3353,5399344,5543717,10943061,0.0003064042135925
WA03,5p,11,A>T,1517,1610,3127,5399321,5543705,10943026,0.0002857527707601
WA03,5p,12,A>T,2196,2001,4197,5399213,5543665,10942878,0.000383537127984
WA03,5p,13,A>T,2331,2038,4369,5399156,5543662,10942818,0.0003992573028263
WA03,5p,14,A>T,1491,1665,3156,5399124,5543629,10942753,0.0002884100554951
WA03,5p,15,A>T,2274,2806,5080,5399092,5543505,10942597,0.0004642408013381
WA03,5p,16,A>T,1677,1858,3535,5399083,5543501,10942584,0.0003230498390508
WA03,5p,17,A>T,2086,2069,4155,5399113,5543491,10942604,0.0003797085227611
WA03,5p,18,A>T,2581,1792,4373,5399074,5543600,10942674,0.0003996280982143
WA03,5p,19,A>T,2059,1836,3895,5399071,5543546,10942617,0.0003559477591146
WA03,5p,20,A>T,1718,1734,3452,5399050,5543533,10942583,0.0003154648221539
WA03,5p,21,A>T,2502,2231,4733,5399034,5543509,10942543,0.0004325319991888
WA03,5p,22,A>T,1935,1754,3689,5398989,5543454,10942443,0.0003371276414234
WA03,5p,23,A>T,1915,1959,3874,5398935,5543457,10942392,0.0003540359365667
WA03,5p,24,A>T,2258,1645,3903,5398952,5543428,10942380,0.0003566865709288
WA03,5p,25,A>T,1800,1907,3707,5398991,5543444,10942435,0.0003387728599712
WA07,3p,1,A>T,19,8,27,5691729,6013979,11705708,2.3065670184152893e-06
WA07,3p,2,A>T,44,19,63,5691729,6013979,11705708,5.381989709635676e-06
WA07,3p,3,A>T,187,171,358,5691729,6013979,11705708,3.058337009602495e-05
WA07,3p,4,A>T,210,249,459,5691729,6013979,11705708,3.921163931305992e-05
WA07,3p,5,A>T,383,499,882,5691729,6013979,11705708,7.534785593489945e-05
WA07,3p,6,A>T,437,494,931,5691729,6013979,11705708,7.953384793128275e-05
WA07,3p,7,A>T,397,444,841,5691729,6013979,11705708,7.184529120323179e-05
WA07,3p,8,A>T,515,621,1136,5691713,6013800,11705513,9.704828827237216e-05
WA07,3p,9,A>T,507,791,1298,5691720,6013901,11705621,0.0001108868978416
WA07,3p,10,A>T,483,649,1132,5691718,6013892,11705610,9.67057675764014e-05
WA07,3p,11,A>T,499,688,1187,5691711,6013883,11705594,0.0001014045079643
WA07,3p,12,A>T,442,778,1220,5691705,6013884,11705589,0.0001042237174054
WA07,3p,13,A>T,494,528,1022,5691711,6013848,11705559,8.730894440837896e-05
WA07,3p,14,A>T,510,689,1199,5691695,6013877,11705572,0.0001024298513562
WA07,3p,15,A>T,591,609,1200,5691211,6013856,11705067,0.0001025197036462
WA07,3p,16,A>T,467,716,1183,5691636,6013850,11705486,0.0001010637234541
WA07,3p,17,A>T,490,859,1349,5691662,6013813,11705475,0.0001152452164478
WA07,3p,18,A>T,743,602,1345,5691639,6013769,11705408,0.0001149041537039
WA07,3p,19,A>T,576,675,1251,5691628,6013742,11705370,0.0001068740244861
WA07,3p,20,A>T,753,701,1454,5691604,6013772,11705376,0.0001242164284171
WA07,3p,21,A>T,666,705,1371,5691611,6013735,11705346,0.000117125969621
WA07,3p,22,A>T,685,671,1356,5691577,6013736,11705313,0.0001158448304628
WA07,3p,23,A>T,616,581,1197,5691568,6013670,11705238,0.000102261910437
WA07,3p,24,A>T,677,1148,1825,5691554,6013661,11705215,0.0001559134112444
WA07,3p,25,A>T,643,717,1360,5691455,6013662,11705117,0.0001161885011486
WA07,5p,1,A>T,2,19,21,5691729,6013979,11705708,1.7939965698785585e-06
WA07,5p,2,A>T,31,37,68,5691636,6013923,11705559,5.809205694490968e-06
WA07,5p,3,A>T,27,51,78,5691729,6013979,11705708,6.663415830977503e-06
WA07,5p,4,A>T,195,63,258,5691728,6013979,11705707,2.2040531169966924e-05
WA07,5p,5,A>T,420,456,876,5691729,6013978,11705707,7.483529187942258e-05
WA07,5p,6,A>T,361,616,977,5691728,6013979,11705707,8.346356183355692e-05
WA07,5p,7,A>T,688,505,1193,5691728,6013979,11705707,0.0001019160995572
WA07,5p,8,A>T,494,416,910,5691579,6013975,11705554,7.774087411838859e-05
WA07,5p,9,A>T,693,765,1458,5691672,6013971,11705643,0.0001245553106309
WA07,5p,10,A>T,562,534,1096,5691582,6013961,11705543,9.363085505730064e-05
WA07,5p,11,A>T,388,588,976,5691326,6013942,11705268,8.338126047178073e-05
WA07,5p,12,A>T,621,1071,1692,5691520,6013938,11705458,0.0001445479536127
WA07,5p,13,A>T,614,922,1536,5691511,6013949,11705460,0.0001312208149017
WA07,5p,14,A>T,489,964,1453,5691556,6013950,11705506,0.0001241296190015
WA07,5p,15,A>T,575,1238,1813,5691563,6013633,11705196,0.0001548884785867
WA07,5p,16,A>T,521,802,1323,5691534,6013925,11705459,0.0001130241881159
WA07,5p,17,A>T,584,1221,1805,5691561,6013916,11705477,0.0001542013196044
WA07,5p,18,A>T,688,741,1429,5691474,6013905,11705379,0.0001220806263513
WA07,5p,19,A>T,570,699,1269,5691482,6013884,11705366,0.000108411817281
WA07,5p,20,A>T,749,1117,1866,5691421,6013876,11705297,0.0001594150067272
WA07,5p,21,A>T,900,945,1845,5691379,6013853,11705232,0.0001576218224465
WA07,5p,22,A>T,705,1144,1849,5691396,6013861,11705257,0.0001579632125975
WA07,5p,23,A>T,633,2603,3236,5691314,6013795,11705109,0.0002764604755068
WA07,5p,24,A>T,818,748,1566,5691332,6013785,11705117,0.0001337876417638
WA07,5p,25,A>T,856,2222,3078,5691334,6013719,11705053,0.0002629633543735
WA08,3p,1,A>T,21,19,40,6798117,7189085,13987202,2.8597570836540437e-06
WA08,3p,2,A>T,63,15,78,6798117,7189085,13987202,5.5765263131253845e-06
WA08,3p,3,A>T,111,225,336,6798117,7189085,13987202,2.402195950269396e-05
WA08,3p,4,A>T,111,80,191,6798117,7189081,13987198,1.3655343979544723e-05
WA08,3p,5,A>T,509,331,840,6798117,7189085,13987202,6.0054898756734906e-05
WA08,3p,6,A>T,392,418,810,6798117,7189085,13987202,5.791008094399437e-05
WA08,3p,7,A>T,445,440,885,6798117,7189084,13987201,6.327212999941875e-05
WA08,3p,8,A>T,527,471,998,6798110,7189053,13987163,7.135113818291815e-05
WA08,3p,9,A>T,646,599,1245,6798103,7189051,13987154,8.90102446859454e-05
WA08,3p,10,A>T,631,584,1215,6798074,7189042,13987116,8.686565550753993e-05
WA08,3p,11,A>T,629,874,1503,6798109,7189046,13987155,0.0001074557334926
WA08,3p,12,A>T,591,683,1274,6798091,7189018,13987109,9.108386872512396e-05
WA08,3p,13,A>T,605,527,1132,6798090,7189013,13987103,8.09316982937782e-05
WA08,3p,14,A>T,556,511,1067,6798067,7188981,13987048,7.628486010772252e-05
WA08,3p,15,A>T,590,726,1316,6798069,7188978,13987047,9.4087050683393e-05
WA08,3p,16,A>T,599,609,1208,6798049,7188961,13987010,8.636584945603099e-05
WA08,3p,17,A>T,650,593,1243,6798000,7188943,13986943,8.886859694788204e-05
WA08,3p,18,A>T,557,617,1174,6798023,7188956,13986979,8.393520859650966e-05
WA08,3p,19,A>T,574,822,1396,6798028,7188946,13986974,9.980714913747604e-05
WA08,3p,20,A>T,614,682,1296,6798009,7188917,13986926,9.265795786722544e-05
WA08,3p,21,A>T,576,689,1265,6798010,7188926,13986936,9.044153773206655e-05
WA08,3p,22,A>T,630,587,1217,6798012,7188920,13986932,8.700978885147937e-05
WA08,3p,23,A>T,688,609,1297,6798009,7188864,13986873,9.272980458176748e-05
WA08,3p,24,A>T,640,571,1211,6798015,7188867,13986882,8.658112651554506e-05
WA08,3p,25,A>T,621,681,1302,6797966,7188892,13986858,9.308738245573094e-05
WA08,5p,1,A>T,8,19,27,6798116,7189085,13987201,1.9303361694737923e-06
WA08,5p,2,A>T,28,52,80,6797941,7188997,13986938,5.719622121725284e-06
WA08,5p,3,A>T,69,60,129,6798117,7189084,13987201,9.222717254152563e-06
WA08,5p,4,A>T,215,73,288,6798115,7189085,13987200,2.059025394646534e-05
WA08,5p,5,A>T,382,391,773,6798116,7189084,13987200,5.5264813543811485e-05
WA08,5p,6,A>T,428,384,812,6798112,7189085,13987197,5.805308955039384e-05
WA08,5p,7,A>T,627,726,1353,6798110,7189085,13987195,9.673133176451748e-05
WA08,5p,8,A>T,564,655,1219,6798069,7189064,13987133,8.71515270498965e-05
WA08,5p,9,A>T,600,785,1385,6798054,7189067,13987121,9.901966244518796e-05
WA08,5p,10,A>T,598,528,1126,6798015,7189037,13987052,8.050302522647374e-05
WA08,5p,11,A>T,523,636,1159,6797997,7189047,13987044,8.286239751587255e-05
WA08,5p,12,A>T,734,648,1382,6798016,7189056,13987072,9.880552555960248e-05
WA08,5p,13,A>T,680,614,1294,6797995,7189043,13987038,9.251422638588672e-05
WA08,5p,14,A>T,628,677,1305,6797984,7189041,13987025,9.330075552163524e-05
WA08,5p,15,A>T,745,592,1337,6797997,7189013,13987010,9.558869265125283e-05
WA08,5p,16,A>T,697,558,1255,6797921,7188997,13986918,8.972670033527044e-05
WA08,5p,17,A>T,631,597,1228,6797959,7188875,13986834,8.779685238274795e-05
WA08,5p,18,A>T,628,666,1294,6797991,7188972,13986963,9.251472245976484e-05
WA08,5p,19,A>T,717,636,1353,6797966,7188988,13986954,9.673299847843926e-05
WA08,5p,20,A>T,764,639,1403,6797883,7188971,13986854,0.0001003084753726
WA08,5p,21,A>T,799,789,1588,6797885,7188979,13986864,0.0001135350997907
WA08,5p,22,A>T,737,735,1472,6797887,7188939,13986826,0.0001052418897611
WA08,5p,23,A>T,769,685,1454,6797851,7188919,13986770,0.0001039553806918
WA08,5p,24,A>T,728,874,1602,6797841,7188876,13986717,0.0001145372427282
WA08,5p,25,A>T,571,848,1419,6797835,7188817,13986652,0.0001014538718772
WA09,3p,1,A>T,34,17,51,4741672,4881751,9623423,5.29956960220911e-06
WA09,3p,2,A>T,96,37,133,4741672,4881751,9623423,1.3820446217525718e-05
WA09,3p,3,A>T,108,137,245,4741672,4881751,9623423,2.5458716716494743e-05
WA09,3p,4,A>T,203,196,399,4741672,4881748,9623420,4.146135157771354e-05
WA09,3p,5,A>T,1201,1277,2478,4741672,4881751,9623423,0.0002574967347896
WA09,3p,6,A>T,1081,1114,2195,4741672,4881751,9623423,0.0002280893191539
WA09,3p,7,A>T,1172,1232,2404,4741672,4881748,9623420,0.0002498072410847
WA09,3p,8,A>T,1388,1388,2776,4741663,4881718,9623381,0.000288464106326
WA09,3p,9,A>T,1615,1478,3093,4741664,4881723,9623387,0.0003214045117379
WA09,3p,10,A>T,1774,1561,3335,4741658,4881705,9623363,0.0003465524474136
WA09,3p,11,A>T,1519,1413,2932,4741648,4881712,9623360,0.0003046752901273
WA09,3p,12,A>T,1492,1535,3027,4741642,4881680,9623322,0.0003145483441165
WA09,3p,13,A>T,1583,1508,3091,4741628,4881645,9623273,0.0003212004896878
WA09,3p,14,A>T,1621,1453,3074,4741616,4881571,9623187,0.0003194367936526
WA09,3p,15,A>T,1576,2286,3862,4741598,4881557,9623155,0.0004013236823058
WA09,3p,16,A>T,1604,1835,3439,4741586,4881546,9623132,0.0003573680585489
WA09,3p,17,A>T,1516,2098,3614,4741582,4881528,9623110,0.0003755542646815
WA09,3p,18,A>T,1400,1923,3323,4741560,4881490,9623050,0.0003453167135159
WA09,3p,19,A>T,1633,1948,3581,4741552,4881442,9622994,0.0003721295056403
WA09,3p,20,A>T,1562,2309,3871,4741534,4881501,9623035,0.0004022639427166
WA09,3p,21,A>T,1566,1812,3378,4741546,4881493,9623039,0.0003510325584256
WA09,3p,22,A>T,1529,2378,3907,4741524,4881498,9623022,0.0004060055146917
WA09,3p,23,A>T,1517,1505,3022,4741501,4881486,9622987,0.0003140397051352
WA09,3p,24,A>T,1646,1564,3210,4741491,4881450,9622941,0.0003335778531739
WA09,3p,25,A>T,1604,2386,3990,4741451,4881469,9622920,0.0004146350587971
WA09,5p,1,A>T,18,40,58,4741672,4881751,9623423,6.026961508394674e-06
WA09,5p,2,A>T,67,63,130,4741495,4881667,9623162,1.350907321314969e-05
WA09,5p,3,A>T,118,92,210,4741672,4881750,9623422,2.182175945313424e-05
WA09,5p,4,A>T,200,155,355,4741672,4881751,9623423,3.6889160956553606e-05
WA09,5p,5,A>T,958,1177,2135,4741671,4881751,9623422,0.0002218545544401
WA09,5p,6,A>T,1148,1039,2187,4741669,4881751,9623420,0.0002272580849635
WA09,5p,7,A>T,1763,2391,4154,4741667,4881751,9623418,0.0004316553640297
WA09,5p,8,A>T,1583,1592,3175,4741639,4881744,9623383,0.0003299255573637
WA09,5p,9,A>T,1909,2095,4004,4741618,4881747,9623365,0.0004160706779801
WA09,5p,10,A>T,1635,1562,3197,4741622,4881737,9623359,0.0003322124842271
WA09,5p,11,A>T,1288,1374,2662,4741614,4881733,9623347,0.0002766189351792
WA09,5p,12,A>T,1913,1983,3896,4741580,4881734,9623314,0.0004048501379046
WA09,5p,13,A>T,1802,1799,3601,4741530,4881708,9623238,0.0003741983727306
WA09,5p,14,A>T,1603,1695,3298,4741498,4881705,9623203,0.0003427133356742
WA09,5p,15,A>T,1816,1722,3538,4741496,4881672,9623168,0.0003676543940623
WA09,5p,16,A>T,1592,1699,3291,4741451,4881636,9623087,0.0003419900495547
WA09,5p,17,A>T,1687,1541,3228,4741476,4881638,9623114,0.0003354423526521
WA09,5p,18,A>T,1937,1799,3736,4741455,4881610,9623065,0.0003882338942945
WA09,5p,19,A>T,1587,1809,3396,4741379,4881580,9622959,0.0003529060032366
WA09,5p,20,A>T,1645,1671,3316,4741390,4881557,9622947,0.0003445929817549
WA09,5p,21,A>T,1805,1706,3511,4741379,4881587,9622966,0.0003648563239234
WA09,5p,22,A>T,1768,1629,3397,4741354,4881580,9622934,0.0003530108384823
WA09,5p,23,A>T,1615,1836,3451,4741312,4881565,9622877,0.0003586245568762
WA09,5p,24,A>T,2040,1647,3687,4741363,4881548,9622911,0.0003831480931289
WA09,5p,25,A>T,1730,1903,3633,4741301,4881503,9622804,0.0003775406835679
WA11,3p,1,A>T,39,32,71,9756642,10108269,19864911,3.5741413591029933e-06
WA11,3p,2,A>T,91,96,187,9756642,10108269,19864911,9.413583579609292e-06
WA11,3p,3,A>T,392,448,840,9756642,10108269,19864911,4.228561607952837e-05
WA11,3p,4,A>T,395,957,1352,9756642,10108267,19864909,6.805971273263824e-05
WA11,3p,5,A>T,944,1679,2623,9756642,10108269,19864911,0.0001320418702102
WA11,3p,6,A>T,1229,1063,2292,9756642,10108269,19864911,0.0001153793238741
WA11,3p,7,A>T,1117,1777,2894,9756642,10108265,19864907,0.0001456840447327
WA11,3p,8,A>T,1142,1473,2615,9756629,10108160,19864789,0.0001316399585215
WA11,3p,9,A>T,1447,1338,2785,9756610,10108092,19864702,0.0001401984283479
WA11,3p,10,A>T,1445,1541,2986,9756615,10107969,19864584,0.0001503177715677
WA11,3p,11,A>T,1338,1987,3325,9756587,10107918,19864505,0.00016738398465
WA11,3p,12,A>T,1395,1873,3268,9756581,10108019,19864600,0.0001645137581426
WA11,3p,13,A>T,1353,1571,2924,9756565,10107963,19864528,0.0001471970539647
WA11,3p,14,A>T,1346,1703,3049,9756515,10107914,19864429,0.0001534904426399
WA11,3p,15,A>T,1368,1878,3246,9756471,10107972,19864443,0.0001634075518754
WA11,3p,16,A>T,1532,1782,3314,9756477,10108011,19864488,0.0001668303758949
WA11,3p,17,A>T,1271,1743,3014,9756469,10108044,19864513,0.0001517278576122
WA11,3p,18,A>T,1503,1843,3346,9756421,10108016,19864437,0.0001684417232665
WA11,3p,19,A>T,1404,1965,3369,9756438,10108000,19864438,0.0001695995627965
WA11,3p,20,A>T,1505,1788,3293,9756433,10107963,19864396,0.0001657739807442
WA11,3p,21,A>T,1454,1643,3097,9756421,10107904,19864325,0.0001559076384422
WA11,3p,22,A>T,1525,1788,3313,9756405,10107842,19864247,0.0001667820582375
WA11,3p,23,A>T,1651,1667,3318,9756375,10107816,19864191,0.0001670342376389
WA11,3p,24,A>T,1599,1611,3210,9756358,10107704,19864062,0.000161598367947
WA11,3p,25,A>T,1709,2377,4086,9756281,10107693,19863974,0.0002056990207498
WA11,5p,1,A>T,13,22,35,9756641,10108269,19864910,1.7619007586744667e-06
WA11,5p,2,A>T,89,136,225,9756471,10108196,19864667,1.132664343177764e-05
WA11,5p,3,A>T,163,681,844,9756642,10108269,19864911,4.248697615609756e-05
WA11,5p,4,A>T,505,173,678,9756638,10108269,19864907,3.413053985100459e-05
WA11,5p,5,A>T,1146,1377,2523,9756638,10108267,19864905,0.0001270079066574
WA11,5p,6,A>T,1238,1227,2465,9756642,10108269,19864911,0.0001240881471857
WA11,5p,7,A>T,1485,1522,3007,9756629,10108269,19864898,0.0001513725366221
WA11,5p,8,A>T,1597,1530,3127,9756500,10108261,19864761,0.0001574144284947
WA11,5p,9,A>T,1735,1959,3694,9756493,10108240,19864733,0.0001859576969899
WA11,5p,10,A>T,1365,1399,2764,9756446,10108197,19864643,0.0001391416900872
WA11,5p,11,A>T,1230,1742,2972,9756457,10108195,19864652,0.0001496124875482
WA11,5p,12,A>T,1733,2018,3751,9756411,10108221,19864632,0.0001888280638674
WA11,5p,13,A>T,1623,1533,3156,9756334,10108178,19864512,0.0001588762915494
WA11,5p,14,A>T,1568,1589,3157,9756261,10108167,19864428,0.0001589273046271
WA11,5p,15,A>T,1759,1778,3537,9756237,10108096,19864333,0.0001780578285714
WA11,5p,16,A>T,1694,1256,2950,9756275,10108079,19864354,0.0001485072205217
WA11,5p,17,A>T,1592,1479,3071,9756369,10108078,19864447,0.0001545978098459
WA11,5p,18,A>T,1621,4793,6414,9756327,10108075,19864402,0.00032288915619
WA11,5p,19,A>T,1430,1488,2918,9756284,10108088,19864372,0.0001468961616304
WA11,5p,20,A>T,1495,1718,3213,9756292,10108082,19864374,0.0001617468539406
WA11,5p,21,A>T,1913,1683,3596,9756251,10108036,19864287,0.0001810283953307
WA11,5p,22,A>T,1685,1639,3324,9756136,10108029,19864165,0.0001673365077263
WA11,5p,23,A>T,1621,1737,3358,9756095,10108016,19864111,0.0001690485922073
WA11,5p,24,A>T,1884,1877,3761,9756046,10108010,19864056,0.0001893369611926
WA11,5p,25,A>T,2123,1919,4042,9756056,10107943,19863999,0.0002034836993296
WA12,3p,1,A>T,32,11,43,6632243,6940679,13572922,3.168072431271616e-06
WA12,3p,2,A>T,70,34,104,6632243,6940679,13572922,7.66231471749414e-06
WA12,3p,3,A>T,162,161,323,6632243,6940679,13572922,2.3797381286063533e-05
WA12,3p,4,A>T,160,246,406,6632243,6940676,13572919,2.991250445095856e-05
WA12,3p,5,A>T,957,839,1796,6632243,6940678,13572921,0.0001323222908318
WA12,3p,6,A>T,954,1044,1998,6632243,6940679,13572922,0.0001472048538995
WA12,3p,7,A>T,1093,1004,2097,6632243,6940676,13572919,0.0001544988222503
WA12,3p,8,A>T,1256,1292,2548,6632240,6940664,13572904,0.0001877269595364
WA12,3p,9,A>T,1379,1235,2614,6632231,6940656,13572887,0.0001925898300044
WA12,3p,10,A>T,1181,1171,2352,6632228,6940644,13572872,0.0001732868327351
WA12,3p,11,A>T,1145,1083,2228,6632231,6940642,13572873,0.0001641509502078
WA12,3p,12,A>T,1288,1222,2510,6632223,6940615,13572838,0.0001849281631446
WA12,3p,13,A>T,1323,1013,2336,6632204,6940591,13572795,0.0001721089871319
WA12,3p,14,A>T,1150,1030,2180,6632209,6940533,13572742,0.0001606160346965
WA12,3p,15,A>T,1227,1363,2590,6632188,6940474,13572662,0.0001908247623052
WA12,3p,16,A>T,1423,1264,2687,6632187,6940478,13572665,0.0001979714374443
WA12,3p,17,A>T,1156,1107,2263,6632168,6940473,13572641,0.0001667324730684
WA12,3p,18,A>T,1276,1245,2521,6632160,6940482,13572642,0.0001857412875105
WA12,3p,19,A>T,1188,1310,2498,6632121,6940435,13572556,0.0001840478683602
WA12,3p,20,A>T,1164,1226,2390,6632105,6940432,13572537,0.0001760908811668
WA12,3p,21,A>T,1283,1288,2571,6632096,6940454,13572550,0.0001894264526562
WA12,3p,22,A>T,1292,1316,2608,6632039,6940438,13572477,0.0001921535766831
WA12,3p,23,A>T,1180,1409,2589,6631950,6940459,13572409,0.0001907546405358
WA12,3p,24,A>T,1214,1713,2927,6631933,6940411,13572344,0.0002156591374341
WA12,3p,25,A>T,1261,1600,2861,6631986,6940428,13572414,0.0002107952203638
WA12,5p,1,A>T,11,15,26,6632243,6940679,13572922,1.915578679373535e-06
WA12,5p,2,A>T,49,76,125,6631949,6940524,13572473,9.209817547620098e-06
WA12,5p,3,A>T,88,85,173,6632242,6940678,13572920,1.274596770628575e-05
WA12,5p,4,A>T,175,238,413,6632242,6940679,13572921,3.042823280265169e-05
WA12,5p,5,A>T,957,897,1854,6632242,6940677,13572919,0.0001365955252514
WA12,5p,6,A>T,928,813,1741,6632242,6940679,13572921,0.0001282701048654
WA12,5p,7,A>T,1489,1533,3022,6632238,6940679,13572917,0.0002226492654452
WA12,5p,8,A>T,1159,1193,2352,6632204,6940670,13572874,0.0001732868072008
WA12,5p,9,A>T,1605,1352,2957,6632209,6940675,13572884,0.0002178608466704
WA12,5p,10,A>T,1259,1402,2661,6632199,6940665,13572864,0.0001960529479997
WA12,5p,11,A>T,977,992,1969,6632166,6940667,13572833,0.0001450691981548
WA12,5p,12,A>T,1412,1232,2644,6632126,6940660,13572786,0.0001948015683736
WA12,5p,13,A>T,1669,1519,3188,6632065,6940658,13572723,0.0002348828602779
WA12,5p,14,A>T,1264,1235,2499,6632026,6940638,13572664,0.0001841200813635
WA12,5p,15,A>T,1602,1334,2936,6631987,6940631,13572618,0.0002163178835505
WA12,5p,16,A>T,1405,1407,2812,6631930,6940590,13572520,0.0002071833380978
WA12,5p,17,A>T,1316,1094,2410,6631958,6940621,13572579,0.0001775638955573
WA12,5p,18,A>T,1373,1590,2963,6632019,6940577,13572596,0.0002183075367453
WA12,5p,19,A>T,1183,1211,2394,6631996,6940532,13572528,0.0001763857109007
WA12,5p,20,A>T,1303,1233,2536,6631973,6940532,13572505,0.0001868483378713
WA12,5p,21,A>T,1512,1370,2882,6631936,6940534,13572470,0.0002123416003129
WA12,5p,22,A>T,1330,1263,2593,6631921,6940529,13572450,0.0001910487789603
WA12,5p,23,A>T,1162,1228,2390,6631926,6940534,13572460,0.000176091880175
WA12,5p,24,A>T,1654,1507,3161,6631934,6940518,13572452,0.0002328982264958
WA12,5p,25,A>T,1391,1467,2858,6631933,6940515,13572448,0.0002105736562777
WA13,3p,1,A>T,32,2,34,5896847,6081528,11978375,2.838448453984785e-06
WA13,3p,2,A>T,4,4,8,5896847,6081528,11978375,6.678702244670082e-07
WA13,3p,3,A>T,14,23,37,5896847,6081528,11978375,3.0888997881599133e-06
WA13,3p,4,A>T,23,42,65,5896847,6081522,11978369,5.426448291916871e-06
WA13,3p,5,A>T,53,74,127,5896847,6081527,11978374,1.0602440698545562e-05
WA13,3p,6,A>T,69,81,150,5896847,6081528,11978375,1.2522566708756404e-05
WA13,3p,7,A>T,77,59,136,5896847,6081528,11978375,1.135379381593914e-05
WA13,3p,8,A>T,79,104,183,5896845,6081521,11978366,1.5277542863525792e-05
WA13,3p,9,A>T,113,88,201,5896842,6081517,11978359,1.678026180380802e-05
WA13,3p,10,A>T,97,130,227,5896843,6081517,11978360,1.8950841350568855e-05
WA13,3p,11,A>T,266,137,403,5896841,6081492,11978333,3.36440805243935e-05
WA13,3p,12,A>T,144,155,299,5896836,6081505,11978341,2.4961720492011373e-05
WA13,3p,13,A>T,103,109,212,5896834,6081495,11978329,1.76986289156025e-05
WA13,3p,14,A>T,132,126,258,5896832,6081501,11978333,2.153889026127425e-05
WA13,3p,15,A>T,193,121,314,5896825,6081505,11978330,2.621400479031718e-05
WA13,3p,16,A>T,187,167,354,5896830,6081509,11978339,2.9553346252765097e-05
WA13,3p,17,A>T,160,126,286,5896823,6081499,11978322,2.387646616946848e-05
WA13,3p,18,A>T,145,185,330,5896827,6081499,11978326,2.754975945720629e-05
WA13,3p,19,A>T,126,239,365,5896822,6081480,11978302,3.047176469586424e-05
WA13,3p,20,A>T,155,193,348,5896818,6081448,11978266,2.905261913535732e-05
WA13,3p,21,A>T,160,125,285,5896824,6081466,11978290,2.379304558497081e-05
WA13,3p,22,A>T,144,147,291,5896824,6081460,11978284,2.4293963976810037e-05
WA13,3p,23,A>T,139,129,268,5896819,6081454,11978273,2.237384304064534e-05
WA13,3p,24,A>T,140,178,318,5896803,6081440,11978243,2.654813397924888e-05
WA13,3p,25,A>T,126,110,236,5896783,6081437,11978220,1.970242657089284e-05
WA13,5p,1,A>T,2,4,6,5896847,6081528,11978375,5.009026683502562e-07
WA13,5p,2,A>T,9,18,27,5896725,6081443,11978168,2.254100961015073e-06
WA13,5p,3,A>T,11,8,19,5896847,6081528,11978375,1.5861917831091443e-06
WA13,5p,4,A>T,36,21,57,5896841,6081528,11978369,4.758577732911718e-06
WA13,5p,5,A>T,126,69,195,5896841,6081528,11978369,1.6279344875750612e-05
WA13,5p,6,A>T,106,154,260,5896841,6081528,11978369,2.1705793167667484e-05
WA13,5p,7,A>T,163,136,299,5896845,6081528,11978373,2.496165380724077e-05
WA13,5p,8,A>T,198,90,288,5896843,6081526,11978369,2.404334012418552e-05
WA13,5p,9,A>T,163,134,297,5896837,6081518,11978355,2.4794723482481525e-05
WA13,5p,10,A>T,137,102,239,5896833,6081518,11978351,1.9952662933320287e-05
WA13,5p,11,A>T,119,66,185,5896827,6081513,11978340,1.544454406871069e-05
WA13,5p,12,A>T,163,191,354,5896822,6081502,11978324,2.9553383261297658e-05
WA13,5p,13,A>T,134,183,317,5896809,6081508,11978317,2.646448578711016e-05
WA13,5p,14,A>T,123,160,283,5896802,6081520,11978322,2.36260137271314e-05
WA13,5p,15,A>T,243,139,382,5896798,6081508,11978306,3.189098692252477e-05
WA13,5p,16,A>T,147,110,257,5896754,6081491,11978245,2.1455563815901244e-05
WA13,5p,17,A>T,125,132,257,5896805,6081514,11978319,2.145543126710852e-05
WA13,5p,18,A>T,159,129,288,5896796,6081504,11978300,2.4043478623844784e-05
WA13,5p,19,A>T,174,125,299,5896797,6081472,11978269,2.496187053404795e-05
WA13,5p,20,A>T,124,198,322,5896788,6081482,11978270,2.688201217705061e-05
WA13,5p,21,A>T,135,151,286,5896782,6081484,11978266,2.3876577795149985e-05
WA13,5p,22,A>T,178,124,302,5896771,6081483,11978254,2.5212355657176743e-05
WA13,5p,23,A>T,149,233,382,5896768,6081501,11978269,3.189108543145925e-05
WA13,5p,24,A>T,138,172,310,5896781,6081498,11978279,2.588017861330497e-05
WA13,5p,25,A>T,182,8794,8976,5896769,6081462,11978231,0.0007493594003989
WA14,3p,1,A>T,9,5,14,6684341,7140972,13825313,1.0126353016383788e-06
WA14,3p,2,A>T,68,12,80,6684341,7140972,13825313,5.786487437933593e-06
WA14,3p,3,A>T,227,185,412,6684341,7140972,13825313,2.9800410305358004e-05
WA14,3p,4,A>T,223,466,689,6684341,7140971,13825312,4.983612666390458e-05
WA14,3p,5,A>T,789,986,1775,6684341,7140970,13825311,0.0001283877086019
WA14,3p,6,A>T,809,697,1506,6684341,7140971,13825312,0.0001089306338981
WA14,3p,7,A>T,769,828,1597,6684341,7140969,13825310,0.0001155127805452
WA14,3p,8,A>T,1132,659,1791,6684326,7140932,13825258,0.0001295455028759
WA14,3p,9,A>T,944,924,1868,6684323,7140920,13825243,0.0001351151657876
WA14,3p,10,A>T,1270,885,2155,6684256,7140912,13825168,0.0001558751401791
WA14,3p,11,A>T,1000,1000,2000,6684256,7140894,13825150,0.000144663891531
WA14,3p,12,A>T,1049,1216,2265,6684291,7140849,13825140,0.0001638319756617
WA14,3p,13,A>T,1038,872,1910,6684289,7140794,13825083,0.0001381546859429
WA14,3p,14,A>T,974,953,1927,6684291,7140742,13825033,0.0001393848390813
WA14,3p,15,A>T,1161,1080,2241,6684271,7140702,13824973,0.0001620979657609
WA14,3p,16,A>T,945,1077,2022,6684263,7140648,13824911,0.0001462577227441
WA14,3p,17,A>T,1300,1065,2365,6684212,7140653,13824865,0.0001710685782465
WA14,3p,18,A>T,1246,1070,2316,6684177,7140647,13824824,0.0001675247366621
WA14,3p,19,A>T,1233,1557,2790,6684172,7140542,13824714,0.0002018124931915
WA14,3p,20,A>T,1492,1394,2886,6684176,7140544,13824720,0.0002087564883773
WA14,3p,21,A>T,1239,1550,2789,6684132,7140443,13824575,0.0002017421873728
WA14,3p,22,A>T,1615,1533,3148,6684105,7140560,13824665,0.0002277089535261
WA14,3p,23,A>T,1414,1288,2702,6683638,7140562,13824200,0.000195454348172
WA14,3p,24,A>T,1298,1327,2625,6683623,7140532,13824155,0.0001898850237139
WA14,3p,25,A>T,1318,1288,2606,6683613,7140513,13824126,0.0001885110132821
WA14,5p,1,A>T,8,18,26,6684341,7140972,13825313,1.8806084173284175e-06
WA14,5p,2,A>T,17,133,150,6684184,7140911,13825095,1.0849835028258396e-05
WA14,5p,3,A>T,69,149,218,6684338,7140972,13825310,1.576818168995849e-05
WA14,5p,4,A>T,241,334,575,6684341,7140972,13825313,4.15903784601477e-05
WA14,5p,5,A>T,792,1779,2571,6684341,7140972,13825313,0.0001859632400365
WA14,5p,6,A>T,791,1210,2001,6684340,7140972,13825312,0.0001447345275101
WA14,5p,7,A>T,1368,1748,3116,6684336,7140972,13825308,0.0002253837672187
WA14,5p,8,A>T,1278,2023,3301,6684277,7140970,13825247,0.0002387660777416
WA14,5p,9,A>T,1297,1311,2608,6684241,7140959,13825200,0.0001886410323177
WA14,5p,10,A>T,1097,1600,2697,6684210,7140628,13824838,0.0001950836602931
WA14,5p,11,A>T,1166,1412,2578,6684218,7140646,13824864,0.0001864756137926
WA14,5p,12,A>T,1433,1397,2830,6684139,7140917,13825056,0.0002047007983186
WA14,5p,13,A>T,1436,1332,2768,6684018,7140931,13824949,0.0002002177367887
WA14,5p,14,A>T,1124,1070,2194,6683951,7140942,13824893,0.0001586992391188
WA14,5p,15,A>T,1271,1050,2321,6684030,7140908,13824938,0.0001678850205331
WA14,5p,16,A>T,1292,1381,2673,6683910,7140868,13824778,0.0001933484935526
WA14,5p,17,A>T,1266,1375,2641,6683904,7140873,13824777,0.000191033822824
WA14,5p,18,A>T,1094,1703,2797,6683891,7140646,13824537,0.0002023214231333
WA14,5p,19,A>T,1315,1721,3036,6683958,7140595,13824553,0.0002196092705492
WA14,5p,20,A>T,1649,1554,3203,6683860,7140558,13824418,0.0002316914896525
WA14,5p,21,A>T,1465,1493,2958,6683480,7140494,13823974,0.0002139760968879
WA14,5p,22,A>T,1547,1020,2567,6683768,7140398,13824166,0.0001856893211496
WA14,5p,23,A>T,1606,1756,3362,6683762,7140257,13824019,0.0002431998972223
WA14,5p,24,A>T,1390,1221,2611,6683714,7140421,13824135,0.0001888725768375
WA14,5p,25,A>T,1475,1193,2668,6683731,7140511,13824242,0.0001929943066679
WA18,3p,1,A>T,42,11,53,14112928,14131239,28244167,1.8764936491134608e-06
WA18,3p,2,A>T,146,48,194,14112928,14131239,28244167,6.868674866566254e-06
WA18,3p,3,A>T,721,722,1443,14112928,14131239,28244167,5.109019501265518e-05
WA18,3p,4,A>T,1158,921,2079,14112928,14131238,28244166,7.360812140815204e-05
WA18,3p,5,A>T,1779,1566,3345,14112928,14131239,28244167,0.0001184315331374
WA18,3p,6,A>T,2144,1031,3175,14112928,14131239,28244167,0.000112412591244
WA18,3p,7,A>T,1971,1394,3365,14112928,14131237,28244165,0.0001191396523848
WA18,3p,8,A>T,2167,1599,3766,14112927,14131187,28244114,0.0001333375159157
WA18,3p,9,A>T,2403,1610,4013,14112909,14131177,28244086,0.0001420828416964
WA18,3p,10,A>T,2588,2121,4709,14112909,14131197,28244106,0.0001667250505291
WA18,3p,11,A>T,2606,1822,4428,14112900,14131167,28244067,0.0001567762886272
WA18,3p,12,A>T,2328,1846,4174,14112895,14131136,28244031,0.0001477834378527
WA18,3p,13,A>T,2391,1881,4272,14112898,14131061,28243959,0.0001512535831113
WA18,3p,14,A>T,2087,2058,4145,14112830,14131006,28243836,0.0001467576854645
WA18,3p,15,A>T,1966,2346,4312,14112809,14130957,28243766,0.0001526708584117
WA18,3p,16,A>T,3251,2522,5773,14112765,14130927,28243692,0.0002043996231087
WA18,3p,17,A>T,2729,2263,4992,14112743,14130850,28243593,0.0001767480504339
WA18,3p,18,A>T,2231,2052,4283,14112708,14130769,28243477,0.0001516456348487
WA18,3p,19,A>T,1987,2616,4603,14112724,14130771,28243495,0.0001629755807487
WA18,3p,20,A>T,3331,2669,6000,14112697,14130797,28243494,0.0002124383052606
WA18,3p,21,A>T,3075,3108,6183,14112659,14130783,28243442,0.0002189180766281
WA18,3p,22,A>T,2572,2490,5062,14112575,14130715,28243290,0.0001792284114209
WA18,3p,23,A>T,3413,2328,5741,14112548,14130648,28243196,0.0002032701964749
WA18,3p,24,A>T,3315,2634,5949,14112551,14130690,28243241,0.0002106344664905
WA18,3p,25,A>T,3594,2609,6203,14112486,14130651,28243137,0.0002196285773779
WA18,5p,1,A>T,13,22,35,14112926,14131239,28244165,1.239194006974538e-06
WA18,5p,2,A>T,136,105,241,14112820,14131183,28244003,8.532784818072708e-06
WA18,5p,3,A>T,218,156,374,14112928,14131239,28244167,1.324167216544216e-05
WA18,5p,4,A>T,855,297,1152,14112928,14131239,28244167,4.07871827128058e-05
WA18,5p,5,A>T,1390,1241,2631,14112925,14131239,28244164,9.315198707952551e-05
WA18,5p,6,A>T,1623,1837,3460,14112927,14131239,28244166,0.0001225031746379
WA18,5p,7,A>T,3932,2779,6711,14112921,14131239,28244160,0.0002376066415145
WA18,5p,8,A>T,2375,2110,4485,14112828,14131230,28244058,0.0001587944621838
WA18,5p,9,A>T,4548,3201,7749,14112833,14131230,28244063,0.0002743585439531
WA18,5p,10,A>T,3533,1976,5509,14112791,14131213,28244004,0.0001950502485412
WA18,5p,11,A>T,8218,3108,11326,14112776,14131211,28243987,0.0004010057078697
WA18,5p,12,A>T,4891,3360,8251,14112682,14131223,28243905,0.0002921338249792
WA18,5p,13,A>T,9737,2654,12391,14112608,14131206,28243814,0.0004387155360816
WA18,5p,14,A>T,7708,2742,10450,14112535,14131179,28243714,0.000369993832964
WA18,5p,15,A>T,2998,3290,6288,14112545,14131148,28243693,0.0002226337752644
WA18,5p,16,A>T,5883,2213,8096,14112522,14131083,28243605,0.0002866489600035
WA18,5p,17,A>T,4125,2786,6911,14112485,14130990,28243475,0.0002446936858867
WA18,5p,18,A>T,6328,2364,8692,14112481,14130987,28243468,0.0003077525748608
WA18,5p,19,A>T,4841,2265,7106,14112359,14130867,28243226,0.0002516001536085
WA18,5p,20,A>T,7774,3081,10855,14112397,14130866,28243263,0.0003843394440649
WA18,5p,21,A>T,6396,3018,9414,14112347,14130679,28243026,0.0003333212241492
WA18,5p,22,A>T,8367,3450,11817,14112376,14129592,28241968,0.0004184198494949
WA18,5p,23,A>T,4631,2308,6939,14112288,14129275,28241563,0.0002457016985922
WA18,5p,24,A>T,6755,2183,8938,14112253,14129481,28241734,0.0003164819837195
WA18,5p,25,A>T,6682,3256,9938,14112273,14130551,28242824,0.0003518769936037
WA22,3p,1,A>T,0,2,2,1513709,1653397,3167106,6.314913362546122e-07
WA22,3p,2,A>T,36,8,44,1513709,1653396,3167105,1.389281378419724e-05
WA22,3p,3,A>T,20,65,85,1513709,1653396,3167105,2.6838390264926488e-05
WA22,3p,4,A>T,21,48,69,1513709,1653394,3167103,2.178647173773635e-05
WA22,3p,5,A>T,73,67,140,1513709,1653397,3167106,4.420439353782286e-05
WA22,3p,6,A>T,98,151,249,1513709,1653397,3167106,7.862067136369923e-05
WA22,3p,7,A>T,83,92,175,1513709,1653397,3167106,5.525549192227857e-05
WA22,3p,8,A>T,170,168,338,1513709,1653395,3167104,0.0001067221032211
WA22,3p,9,A>T,133,63,196,1513709,1653397,3167106,6.1886150952952e-05
WA22,3p,10,A>T,167,108,275,1513706,1653396,3167102,8.683016840000732e-05
WA22,3p,11,A>T,137,123,260,1513685,1653390,3167075,8.20946772653e-05
WA22,3p,12,A>T,112,152,264,1513662,1653379,3167041,8.335856719253081e-05
WA22,3p,13,A>T,101,124,225,1513689,1653380,3167069,7.10436053019369e-05
WA22,3p,14,A>T,139,159,298,1513686,1653352,3167038,9.409422937141898e-05
WA22,3p,15,A>T,102,207,309,1513677,1653343,3167020,9.75680608268972e-05
WA22,3p,16,A>T,134,110,244,1513637,1653341,3166978,7.704505683335975e-05
WA22,3p,17,A>T,165,149,314,1513671,1653319,3166990,9.91477712275694e-05
WA22,3p,18,A>T,223,174,397,1513665,1653288,3166953,0.0001253570861329
WA22,3p,19,A>T,128,94,222,1513662,1653275,3166937,7.009927889313871e-05
WA22,3p,20,A>T,163,115,278,1513684,1653304,3166988,8.778056626674936e-05
WA22,3p,21,A>T,174,216,390,1513677,1653327,3167004,0.0001231447765774
WA22,3p,22,A>T,149,169,318,1513684,1653356,3167040,0.0001004092149136
WA22,3p,23,A>T,136,123,259,1513676,1653329,3167005,8.17807360582001e-05
WA22,3p,24,A>T,201,182,383,1513672,1653285,3166957,0.0001209362804736
WA22,3p,25,A>T,157,250,407,1513669,1653296,3166965,0.0001285142083982
WA22,5p,1,A>T,0,9,9,1513709,1653397,3167106,2.841711013145755e-06
WA22,5p,2,A>T,15,16,31,1513674,1653378,3167052,9.788282604769356e-06
WA22,5p,3,A>T,8,35,43,1513709,1653397,3167106,1.3577063729474164e-05
WA22,5p,4,A>T,26,16,42,1513709,1653397,3167106,1.3261318061346858e-05
WA22,5p,5,A>T,36,63,99,1513708,1653396,3167104,3.125884088429051e-05
WA22,5p,6,A>T,63,109,172,1513704,1653397,3167101,5.430834065601318e-05
WA22,5p,7,A>T,115,126,241,1513707,1653397,3167104,7.609475407185871e-05
WA22,5p,8,A>T,136,95,231,1513692,1653397,3167089,7.293764084305809e-05
WA22,5p,9,A>T,157,171,328,1513700,1653389,3167089,0.0001035651350498
WA22,5p,10,A>T,106,79,185,1513705,1653389,3167094,5.841316992801603e-05
WA22,5p,11,A>T,104,38,142,1513699,1653381,3167080,4.483625295224624e-05
WA22,5p,12,A>T,262,93,355,1513692,1653345,3167037,0.0001120921542754
WA22,5p,13,A>T,134,128,262,1513697,1653377,3167074,8.272620090342063e-05
WA22,5p,14,A>T,122,124,246,1513677,1653376,3167053,7.767473420874232e-05
WA22,5p,15,A>T,102,145,247,1513695,1653381,3167076,7.798991877681495e-05
WA22,5p,16,A>T,209,112,321,1513668,1653368,3167036,0.0001013565996723
WA22,5p,17,A>T,151,158,309,1513675,1653395,3167070,9.75665204747606e-05
WA22,5p,18,A>T,140,96,236,1513651,1653392,3167043,7.451745997765108e-05
WA22,5p,19,A>T,162,130,292,1513674,1653350,3167024,9.220012225988814e-05
WA22,5p,20,A>T,102,127,229,1513678,1653356,3167034,7.230740181507366e-05
WA22,5p,21,A>T,155,125,280,1513690,1653371,3167061,8.841004325461367e-05
WA22,5p,22,A>T,126,163,289,1513691,1653380,3167071,9.125150651816774e-05
WA22,5p,23,A>T,287,162,449,1513634,1653393,3167027,0.0001417733413703
WA22,5p,24,A>T,162,325,487,1513632,1653375,3167007,0.000153772947139
WA22,5p,25,A>T,150,121,271,1513644,1653364,3167008,8.556972385292364e-05
WA25,3p,1,A>T,2,0,2,3375244,3569089,6944333,2.880046218981722e-07
WA25,3p,2,A>T,286,3,289,3375244,3569089,6944333,4.161666786428589e-05
WA25,3p,3,A>T,323,94,417,3375244,3569089,6944333,6.0048963665768906e-05
WA25,3p,4,A>T,201,150,351,3375244,3569087,6944331,5.054482570027264e-05
WA25,3p,5,A>T,401,372,773,3375244,3569089,6944333,0.0001113137863636
WA25,3p,6,A>T,327,291,618,3375244,3569089,6944333,8.899342816653522e-05
WA25,3p,7,A>T,289,339,628,3375244,3569089,6944333,9.043345127602608e-05
WA25,3p,8,A>T,293,300,593,3375239,3569076,6944315,8.539359173654996e-05
WA25,3p,9,A>T,353,355,708,3375240,3569076,6944316,0.000101953885739
WA25,3p,10,A>T,347,445,792,3375240,3569075,6944315,0.0001140501258943
WA25,3p,11,A>T,388,310,698,3375233,3569054,6944287,0.0001005142788597
WA25,3p,12,A>T,338,356,694,3375226,3569069,6944295,9.99381506690024e-05
WA25,3p,13,A>T,541,371,912,3375230,3569053,6944283,0.0001313310531843
WA25,3p,14,A>T,272,473,745,3375223,3569037,6944260,0.0001072828494324
WA25,3p,15,A>T,344,529,873,3375218,3569039,6944257,0.0001257153933098
WA25,3p,16,A>T,452,465,917,3375196,3569030,6944226,0.0001320521538325
WA25,3p,17,A>T,434,490,924,3375198,3569022,6944220,0.0001330603005089
WA25,3p,18,A>T,604,352,956,3375213,3569006,6944219,0.0001376684692691
WA25,3p,19,A>T,436,456,892,3375204,3569005,6944209,0.0001284523550486
WA25,3p,20,A>T,452,480,932,3375190,3568979,6944169,0.0001342133234372
WA25,3p,21,A>T,358,410,768,3375199,3568998,6944197,0.0001105959407545
WA25,3p,22,A>T,369,559,928,3375179,3568994,6944173,0.0001336372236117
WA25,3p,23,A>T,434,540,974,3375175,3568972,6944147,0.0001402620077023
WA25,3p,24,A>T,664,599,1263,3375177,3568962,6944139,0.0001818799998099
WA25,3p,25,A>T,488,608,1096,3375156,3568970,6944126,0.0001578312375092
WA25,5p,1,A>T,1,8,9,3375244,3569089,6944333,1.296020798541775e-06
WA25,5p,2,A>T,9,17,26,3375147,3569045,6944192,3.744136106835756e-06
WA25,5p,3,A>T,31,37,68,3375243,3569089,6944332,9.792158554631317e-06
WA25,5p,4,A>T,293,67,360,3375243,3569089,6944332,5.184083940687167e-05
WA25,5p,5,A>T,344,265,609,3375244,3569088,6944332,8.769741999662458e-05
WA25,5p,6,A>T,297,309,606,3375244,3569089,6944333,8.726540043514618e-05
WA25,5p,7,A>T,536,443,979,3375242,3569089,6944331,0.0001409783030215
WA25,5p,8,A>T,393,323,716,3375221,3569088,6944309,0.0001031060109796
WA25,5p,9,A>T,375,414,789,3375227,3569087,6944314,0.000113618134203
WA25,5p,10,A>T,420,532,952,3375217,3569085,6944302,0.0001370908120067
WA25,5p,11,A>T,390,298,688,3375193,3569088,6944281,9.907433181347356e-05
WA25,5p,12,A>T,593,409,1002,3375142,3569084,6944226,0.0001442925388661
WA25,5p,13,A>T,475,432,907,3375133,3569081,6944214,0.0001306123342396
WA25,5p,14,A>T,370,379,749,3375151,3569071,6944222,0.000107859454954
WA25,5p,15,A>T,380,562,942,3375137,3569055,6944192,0.0001356529312553
WA25,5p,16,A>T,488,499,987,3375081,3569035,6944116,0.0001421347224038
WA25,5p,17,A>T,521,575,1096,3375076,3568871,6943947,0.0001578353060586
WA25,5p,18,A>T,558,614,1172,3375102,3568996,6944098,0.000168776419918
WA25,5p,19,A>T,550,414,964,3375134,3569021,6944155,0.000138821786092
WA25,5p,20,A>T,407,429,836,3375145,3569019,6944164,0.0001203888617837
WA25,5p,21,A>T,474,488,962,3375130,3569013,6944143,0.0001385340134844
WA25,5p,22,A>T,547,556,1103,3375139,3569001,6944140,0.0001588389635001
WA25,5p,23,A>T,436,444,880,3375144,3569002,6944146,0.0001267254461527
WA25,5p,24,A>T,517,504,1021,3375124,3568967,6944091,0.0001470314833143
WA25,5p,25,A>T,475,633,1108,3375125,3568950,6944075,0.0001595604886179
WA26,3p,1,A>T,2,8,10,2709623,2900126,5609749,1.782610951042551e-06
WA26,3p,2,A>T,42,6,48,2709623,2900126,5609749,8.556532565004245e-06
WA26,3p,3,A>T,47,57,104,2709623,2900126,5609749,1.853915389084253e-05
WA26,3p,4,A>T,57,67,124,2709623,2900126,5609749,2.2104375792927637e-05
WA26,3p,5,A>T,180,177,357,2709623,2900126,5609749,6.363921095221908e-05
WA26,3p,6,A>T,237,254,491,2709623,2900126,5609749,8.752619769618926e-05
WA26,3p,7,A>T,251,204,455,2709623,2900126,5609749,8.110879827243608e-05
WA26,3p,8,A>T,521,341,862,2709619,2900114,5609733,0.0001536615022497
WA26,3p,9,A>T,370,232,602,2709613,2900111,5609724,0.000107313657499
WA26,3p,10,A>T,256,392,648,2709609,2900074,5609683,0.000115514548683
WA26,3p,11,A>T,395,202,597,2709594,2900076,5609670,0.0001064233724978
WA26,3p,12,A>T,720,261,981,2709607,2900081,5609688,0.0001748760358864
WA26,3p,13,A>T,556,219,775,2709604,2900084,5609688,0.0001381538509806
WA26,3p,14,A>T,393,293,686,2709584,2900069,5609653,0.0001222892039846
WA26,3p,15,A>T,271,270,541,2709593,2900082,5609675,9.644052462932344e-05
WA26,3p,16,A>T,277,271,548,2709580,2900075,5609655,9.768871704231366e-05
WA26,3p,17,A>T,272,263,535,2709570,2900078,5609648,9.537140298286095e-05
WA26,3p,18,A>T,446,296,742,2709582,2900059,5609641,0.0001322722790995
WA26,3p,19,A>T,271,337,608,2709567,2900016,5609583,0.0001083859531091
WA26,3p,20,A>T,327,295,622,2709563,2899983,5609546,0.000110882413657
WA26,3p,21,A>T,271,412,683,2709562,2900021,5609583,0.0001217559308775
WA26,3p,22,A>T,350,317,667,2709522,2900007,5609529,0.000118904813577
WA26,3p,23,A>T,669,356,1025,2709541,2899974,5609515,0.0001827252445175
WA26,3p,24,A>T,324,332,656,2709558,2899951,5609509,0.0001169442815761
WA26,3p,25,A>T,313,403,716,2709500,2900002,5609502,0.0001276405641712
WA26,5p,1,A>T,4,5,9,2709622,2900126,5609748,1.6043501419315092e-06
WA26,5p,2,A>T,13,24,37,2709554,2900092,5609646,6.595781623296729e-06
WA26,5p,3,A>T,48,88,136,2709623,2900126,5609749,2.4243508934178696e-05
WA26,5p,4,A>T,108,54,162,2709623,2900126,5609749,2.8878297406889328e-05
WA26,5p,5,A>T,242,168,410,2709623,2900125,5609748,7.308706202132431e-05
WA26,5p,6,A>T,207,162,369,2709621,2900126,5609747,6.57783675449178e-05
WA26,5p,7,A>T,401,290,691,2709622,2900126,5609748,0.0001231784386749
WA26,5p,8,A>T,288,441,729,2709609,2900124,5609733,0.0001299527089791
WA26,5p,9,A>T,388,394,782,2709594,2900123,5609717,0.0001394009715641
WA26,5p,10,A>T,256,312,568,2709601,2900123,5609724,0.0001012527532548
WA26,5p,11,A>T,253,415,668,2709605,2900103,5609708,0.0001190792818449
WA26,5p,12,A>T,387,460,847,2709595,2900107,5609702,0.0001509884125752
WA26,5p,13,A>T,335,491,826,2709592,2900104,5609696,0.0001472450557035
WA26,5p,14,A>T,273,427,700,2709563,2900089,5609652,0.0001247849242698
WA26,5p,15,A>T,380,406,786,2709545,2900085,5609630,0.0001401161930466
WA26,5p,16,A>T,333,501,834,2709540,2900076,5609616,0.0001486732781709
WA26,5p,17,A>T,334,743,1077,2709554,2900055,5609609,0.0001919919908856
WA26,5p,18,A>T,368,523,891,2709554,2900082,5609636,0.0001588338352078
WA26,5p,19,A>T,312,620,932,2709570,2900086,5609656,0.0001661420949876
WA26,5p,20,A>T,283,494,777,2709563,2900082,5609645,0.0001385114387808
WA26,5p,21,A>T,488,427,915,2709545,2900061,5609606,0.0001631130599903
WA26,5p,22,A>T,306,568,874,2709542,2900059,5609601,0.0001558043076504
WA26,5p,23,A>T,414,333,747,2709528,2900065,5609593,0.0001331647411853
WA26,5p,24,A>T,467,692,1159,2709495,2900057,5609552,0.0002066118649047
WA26,5p,25,A>T,434,713,1147,2709506,2900041,5609547,0.0002044728388941
