Sample,End,Position,Substitution,Pos_Count,Neg_Count,Combined_Count,Pos_Total,Neg_Total,Combined_Total,Frequency
DAL192,3p,1,C>-,0,0,0,6350003,6167708,12517711,0.0
DAL192,3p,2,C>-,0,0,0,6350003,6167706,12517709,0.0
DAL192,3p,3,C>-,0,0,0,6350003,6167708,12517711,0.0
DAL192,3p,4,C>-,0,0,0,6350003,6167708,12517711,0.0
DAL192,3p,5,C>-,0,0,0,6350003,6167708,12517711,0.0
DAL192,3p,6,C>-,0,0,0,6350003,6167708,12517711,0.0
DAL192,3p,7,C>-,0,0,0,6350003,6167708,12517711,0.0
DAL192,3p,8,C>-,0,0,0,6350003,6167618,12517621,0.0
DAL192,3p,9,C>-,2,8,10,6350003,6167637,12517640,7.988726309432129e-07
DAL192,3p,10,C>-,4,7,11,6350003,6167645,12517648,8.787593324241104e-07
DAL192,3p,11,C>-,3,11,14,6349987,6167644,12517631,1.1184224874499017e-06
DAL192,3p,12,C>-,5,12,17,6349997,6167646,12517643,1.358083147122825e-06
DAL192,3p,13,C>-,8,12,20,6349992,6167621,12517613,1.5977487081602538e-06
DAL192,3p,14,C>-,0,15,15,6349967,6167610,12517577,1.1983149774113633e-06
DAL192,3p,15,C>-,1,9,10,6349968,6167615,12517583,7.988762686854164e-07
DAL192,3p,16,C>-,2,17,19,6349943,6167587,12517530,1.517871337236659e-06
DAL192,3p,17,C>-,4,19,23,6349922,6167606,12517528,1.8374234912835824e-06
DAL192,3p,18,C>-,27,41,68,6349922,6167564,12517486,5.432400723276223e-06
DAL192,3p,19,C>-,18,23,41,6349921,6167519,12517440,3.27543011989672e-06
DAL192,3p,20,C>-,10,17,27,6349910,6167516,12517426,2.1569929792275184e-06
DAL192,3p,21,C>-,14,38,52,6349882,6167507,12517389,4.154220980110149e-06
DAL192,3p,22,C>-,13,32,45,6349894,6167488,12517382,3.5950009354991324e-06
DAL192,3p,23,C>-,13,32,45,6349902,6167465,12517367,3.59500524351487e-06
DAL192,3p,24,C>-,36,57,93,6349899,6167465,12517364,7.429679283913131e-06
DAL192,3p,25,C>-,28,49,77,6349856,6167384,12517240,6.151515829368136e-06
DAL192,5p,1,C>-,0,0,0,6350003,6167708,12517711,0.0
DAL192,5p,2,C>-,0,0,0,6349992,6167694,12517686,0.0
DAL192,5p,3,C>-,0,0,0,6350003,6167707,12517710,0.0
DAL192,5p,4,C>-,0,0,0,6350003,6167708,12517711,0.0
DAL192,5p,5,C>-,2,0,2,6350003,6167707,12517710,1.597736327171663e-07
DAL192,5p,6,C>-,0,0,0,6350002,6167707,12517709,0.0
DAL192,5p,7,C>-,0,0,0,6350002,6167708,12517710,0.0
DAL192,5p,8,C>-,0,0,0,6349926,6167708,12517634,0.0
DAL192,5p,9,C>-,3,1,4,6349914,6167708,12517622,3.195495118801319e-07
DAL192,5p,10,C>-,3,1,4,6349896,6167708,12517604,3.195499713843001e-07
DAL192,5p,11,C>-,5,2,7,6349942,6167706,12517648,5.592104842698884e-07
DAL192,5p,12,C>-,7,10,17,6349906,6167700,12517606,1.3580871613949184e-06
DAL192,5p,13,C>-,7,3,10,6349906,6167705,12517611,7.988744817201941e-07
DAL192,5p,14,C>-,8,4,12,6349889,6167679,12517568,9.58652671189803e-07
DAL192,5p,15,C>-,13,6,19,6349890,6167649,12517539,1.517870245900572e-06
DAL192,5p,16,C>-,16,10,26,6349904,6167639,12517543,2.077084935917536e-06
DAL192,5p,17,C>-,8,4,12,6349778,6167623,12517401,9.58665460985072e-07
DAL192,5p,18,C>-,12,8,20,6349859,6167631,12517490,1.59776440804027e-06
DAL192,5p,19,C>-,21,18,39,6349822,6167638,12517460,3.115648062785901e-06
DAL192,5p,20,C>-,22,17,39,6349836,6167621,12517457,3.1156488094986066e-06
DAL192,5p,21,C>-,27,22,49,6349784,6167624,12517408,3.914548443255984e-06
DAL192,5p,22,C>-,30,29,59,6349783,6167584,12517367,4.713451319275052e-06
DAL192,5p,23,C>-,27,25,52,6349801,6167567,12517368,4.154227949517822e-06
DAL192,5p,24,C>-,51,53,104,6349759,6167564,12517323,8.30848576808316e-06
DAL192,5p,25,C>-,53,85,138,6349777,6167551,12517328,1.10247170961726e-05
DAL193,3p,1,C>-,0,0,0,6484405,6362696,12847101,0.0
DAL193,3p,2,C>-,0,0,0,6484402,6362696,12847098,0.0
DAL193,3p,3,C>-,0,0,0,6484405,6362696,12847101,0.0
DAL193,3p,4,C>-,0,0,0,6484405,6362696,12847101,0.0
DAL193,3p,5,C>-,0,0,0,6484405,6362696,12847101,0.0
DAL193,3p,6,C>-,0,0,0,6484405,6362696,12847101,0.0
DAL193,3p,7,C>-,0,0,0,6484405,6362696,12847101,0.0
DAL193,3p,8,C>-,0,0,0,6484400,6362644,12847044,0.0
DAL193,3p,9,C>-,1,9,10,6484400,6362631,12847031,7.783899641870562e-07
DAL193,3p,10,C>-,2,9,11,6484393,6362640,12847033,8.562288273097765e-07
DAL193,3p,11,C>-,1,14,15,6484398,6362639,12847037,1.1675844009789962e-06
DAL193,3p,12,C>-,2,12,14,6484368,6362594,12846962,1.0897518027997592e-06
DAL193,3p,13,C>-,2,10,12,6484385,6362543,12846928,9.34075445896482e-07
DAL193,3p,14,C>-,1,12,13,6484363,6362486,12846849,1.0119212890258149e-06
DAL193,3p,15,C>-,8,13,21,6484332,6362438,12846770,1.6346521343497236e-06
DAL193,3p,16,C>-,2,13,15,6484341,6362460,12846801,1.167605849892125e-06
DAL193,3p,17,C>-,57,38,95,6484294,6362445,12846739,7.394872737743018e-06
DAL193,3p,18,C>-,72,46,118,6484244,6362380,12846624,9.185292571807192e-06
DAL193,3p,19,C>-,61,61,122,6484265,6362400,12846665,9.496628113210703e-06
DAL193,3p,20,C>-,197,40,237,6484261,6362382,12846643,1.8448399321130043e-05
DAL193,3p,21,C>-,215,59,274,6484248,6362443,12846691,2.1328449481660296e-05
DAL193,3p,22,C>-,141,51,192,6484224,6362407,12846631,1.4945552651119192e-05
DAL193,3p,23,C>-,102,49,151,6484218,6362399,12846617,1.1754067238090776e-05
DAL193,3p,24,C>-,57,82,139,6484164,6362319,12846483,1.0820082041131412e-05
DAL193,3p,25,C>-,64,82,146,6484128,6362355,12846483,1.1364978259030118e-05
DAL193,5p,1,C>-,0,0,0,6484405,6362696,12847101,0.0
DAL193,5p,2,C>-,0,0,0,6484386,6362681,12847067,0.0
DAL193,5p,3,C>-,0,0,0,6484400,6362696,12847096,0.0
DAL193,5p,4,C>-,0,0,0,6484403,6362696,12847099,0.0
DAL193,5p,5,C>-,0,0,0,6484403,6362696,12847099,0.0
DAL193,5p,6,C>-,0,0,0,6484404,6362696,12847100,0.0
DAL193,5p,7,C>-,1,0,1,6484404,6362696,12847100,7.78385783562049e-08
DAL193,5p,8,C>-,1,0,1,6484314,6362693,12847007,7.7839141832802e-08
DAL193,5p,9,C>-,7,2,9,6484295,6362695,12846990,7.005532035130408e-07
DAL193,5p,10,C>-,4,4,8,6484284,6362694,12846978,6.227145403378133e-07
DAL193,5p,11,C>-,10,5,15,6484315,6362677,12846992,1.167588490753322e-06
DAL193,5p,12,C>-,5,3,8,6484218,6362670,12846888,6.227189028191108e-07
DAL193,5p,13,C>-,10,3,13,6484143,6362652,12846795,1.0119255425185814e-06
DAL193,5p,14,C>-,25,4,29,6484145,6362627,12846772,2.2573764055281742e-06
DAL193,5p,15,C>-,36,4,40,6484166,6362534,12846700,3.113640078775094e-06
DAL193,5p,16,C>-,47,8,55,6484111,6362519,12846630,4.281278436445978e-06
DAL193,5p,17,C>-,36,16,52,6484043,6362598,12846641,4.047750692184828e-06
DAL193,5p,18,C>-,42,52,94,6483967,6362571,12846538,7.317146456111366e-06
DAL193,5p,19,C>-,44,74,118,6483980,6362593,12846573,9.185329036778914e-06
DAL193,5p,20,C>-,44,24,68,6483952,6362554,12846506,5.293268068375946e-06
DAL193,5p,21,C>-,34,30,64,6484003,6362532,12846535,4.98188811224194e-06
DAL193,5p,22,C>-,44,36,80,6484010,6362499,12846509,6.227372743832585e-06
DAL193,5p,23,C>-,40,61,101,6483966,6362463,12846429,7.862107049359788e-06
DAL193,5p,24,C>-,74,71,145,6483905,6362426,12846331,1.1287269493523092e-05
DAL193,5p,25,C>-,117,121,238,6483942,6362403,12846345,1.852667042649096e-05
DAL195,3p,1,C>-,0,0,0,2363278,2267461,4630739,0.0
DAL195,3p,2,C>-,0,0,0,2363278,2267460,4630738,0.0
DAL195,3p,3,C>-,0,0,0,2363278,2267461,4630739,0.0
DAL195,3p,4,C>-,0,0,0,2363278,2267461,4630739,0.0
DAL195,3p,5,C>-,0,0,0,2363278,2267461,4630739,0.0
DAL195,3p,6,C>-,0,0,0,2363278,2267461,4630739,0.0
DAL195,3p,7,C>-,0,1,1,2363278,2267461,4630739,2.159482536156756e-07
DAL195,3p,8,C>-,0,0,0,2363278,2267413,4630691,0.0
DAL195,3p,9,C>-,0,5,5,2363276,2267438,4630714,1.0797470973158784e-06
DAL195,3p,10,C>-,5,9,14,2363274,2267432,4630706,3.0232970955184804e-06
DAL195,3p,11,C>-,1,5,6,2363274,2267431,4630705,1.2956990350281437e-06
DAL195,3p,12,C>-,2,7,9,2363273,2267414,4630687,1.943556107333534e-06
DAL195,3p,13,C>-,2,10,12,2363269,2267412,4630681,2.591411500813811e-06
DAL195,3p,14,C>-,5,9,14,2363250,2267410,4630660,3.0233271283143226e-06
DAL195,3p,15,C>-,2,7,9,2363254,2267411,4630665,1.9435653410471284e-06
DAL195,3p,16,C>-,3,16,19,2363259,2267394,4630653,4.103093019494227e-06
DAL195,3p,17,C>-,5,10,15,2363234,2267398,4630632,3.239298652970048e-06
DAL195,3p,18,C>-,5,13,18,2363236,2267374,4630610,3.887176851429941e-06
DAL195,3p,19,C>-,6,23,29,2363215,2267369,4630584,6.262708980120002e-06
DAL195,3p,20,C>-,5,15,20,2363222,2267380,4630602,4.319092852290048e-06
DAL195,3p,21,C>-,2,13,15,2363235,2267382,4630617,3.2393091460598014e-06
DAL195,3p,22,C>-,8,14,22,2363231,2267383,4630614,4.750989825539334e-06
DAL195,3p,23,C>-,9,20,29,2363219,2267370,4630589,6.26270221779562e-06
DAL195,3p,24,C>-,17,24,41,2363198,2267373,4630571,8.854199622465566e-06
DAL195,3p,25,C>-,18,24,42,2363180,2267377,4630557,9.070183133476169e-06
DAL195,5p,1,C>-,0,0,0,2363278,2267461,4630739,0.0
DAL195,5p,2,C>-,0,0,0,2363264,2267447,4630711,0.0
DAL195,5p,3,C>-,0,0,0,2363278,2267459,4630737,0.0
DAL195,5p,4,C>-,0,0,0,2363278,2267461,4630739,0.0
DAL195,5p,5,C>-,0,0,0,2363277,2267461,4630738,0.0
DAL195,5p,6,C>-,0,0,0,2363277,2267461,4630738,0.0
DAL195,5p,7,C>-,0,0,0,2363277,2267461,4630738,0.0
DAL195,5p,8,C>-,1,0,1,2363212,2267460,4630672,2.1595137811531458e-07
DAL195,5p,9,C>-,2,0,2,2363181,2267461,4630642,4.3190555434861946e-07
DAL195,5p,10,C>-,4,1,5,2363146,2267458,4630604,1.0797727467086367e-06
DAL195,5p,11,C>-,3,0,3,2362948,2267450,4630398,6.478924705824424e-07
DAL195,5p,12,C>-,1,1,2,2362864,2267454,4630318,4.3193577633328853e-07
DAL195,5p,13,C>-,2,1,3,2363073,2267445,4630518,6.478756804314333e-07
DAL195,5p,14,C>-,3,2,5,2363094,2267434,4630528,1.0797904688191069e-06
DAL195,5p,15,C>-,7,5,12,2363178,2267432,4630610,2.5914512342866275e-06
DAL195,5p,16,C>-,15,3,18,2363170,2267429,4630599,3.8871860854286885e-06
DAL195,5p,17,C>-,11,10,21,2363159,2267431,4630590,4.535059247309738e-06
DAL195,5p,18,C>-,17,3,20,2363182,2267420,4630602,4.319092852290048e-06
DAL195,5p,19,C>-,13,2,15,2363138,2267420,4630558,3.2393504195390705e-06
DAL195,5p,20,C>-,15,7,22,2363110,2267401,4630511,4.751095505442056e-06
DAL195,5p,21,C>-,14,6,20,2363086,2267400,4630486,4.319201051466304e-06
DAL195,5p,22,C>-,22,5,27,2363094,2267388,4630482,5.830926456468246e-06
DAL195,5p,23,C>-,21,10,31,2363068,2267398,4630466,6.694790545919136e-06
DAL195,5p,24,C>-,22,22,44,2363067,2267402,4630469,9.502277199134687e-06
DAL195,5p,25,C>-,51,20,71,2363135,2267374,4630509,1.5333087572014223e-05
DAL212,3p,1,C>-,0,0,0,4131322,4008153,8139475,0.0
DAL212,3p,2,C>-,0,0,0,4131322,4008153,8139475,0.0
DAL212,3p,3,C>-,0,0,0,4131322,4008153,8139475,0.0
DAL212,3p,4,C>-,0,0,0,4131322,4008153,8139475,0.0
DAL212,3p,5,C>-,0,0,0,4131322,4008151,8139473,0.0
DAL212,3p,6,C>-,0,0,0,4131322,4008151,8139473,0.0
DAL212,3p,7,C>-,0,0,0,4131322,4008153,8139475,0.0
DAL212,3p,8,C>-,0,1,1,4131319,4008093,8139412,1.228589976769821e-07
DAL212,3p,9,C>-,2,12,14,4131316,4008115,8139431,1.720021952394461e-06
DAL212,3p,10,C>-,15,19,34,4131317,4008102,8139419,4.177202328569152e-06
DAL212,3p,11,C>-,7,16,23,4131313,4008105,8139418,2.8257548635541264e-06
DAL212,3p,12,C>-,2,11,13,4131314,4008034,8139348,1.5971795283848289e-06
DAL212,3p,13,C>-,12,18,30,4131307,4007923,8139230,3.6858523472122057e-06
DAL212,3p,14,C>-,2,24,26,4131271,4007904,8139175,3.194426953591734e-06
DAL212,3p,15,C>-,5,40,45,4131254,4007935,8139189,5.528806371249028e-06
DAL212,3p,16,C>-,12,50,62,4131236,4007982,8139218,7.6174394149413375e-06
DAL212,3p,17,C>-,3,80,83,4131249,4007981,8139230,1.0197524827287102e-05
DAL212,3p,18,C>-,9,46,55,4131222,4007954,8139176,6.75744080236132e-06
DAL212,3p,19,C>-,23,65,88,4131233,4007956,8139189,1.0811888014886986e-05
DAL212,3p,20,C>-,26,56,82,4131221,4007928,8139149,1.0074763344423354e-05
DAL212,3p,21,C>-,21,101,122,4131228,4007917,8139145,1.4989289415534432e-05
DAL212,3p,22,C>-,78,115,193,4131183,4007898,8139081,2.3712750862167364e-05
DAL212,3p,23,C>-,55,71,126,4131172,4007904,8139076,1.548087276737556e-05
DAL212,3p,24,C>-,39,106,145,4131124,4007904,8139028,1.7815395155293728e-05
DAL212,3p,25,C>-,82,115,197,4131071,4007924,8138995,2.4204462590282957e-05
DAL212,5p,1,C>-,0,0,0,4131322,4008153,8139475,0.0
DAL212,5p,2,C>-,0,0,0,4131307,4008143,8139450,0.0
DAL212,5p,3,C>-,0,0,0,4131321,4008153,8139474,0.0
DAL212,5p,4,C>-,0,0,0,4131322,4008153,8139475,0.0
DAL212,5p,5,C>-,0,0,0,4131322,4008153,8139475,0.0
DAL212,5p,6,C>-,0,0,0,4131322,4008153,8139475,0.0
DAL212,5p,7,C>-,0,0,0,4131322,4008153,8139475,0.0
DAL212,5p,8,C>-,1,0,1,4131248,4008153,8139401,1.228591637148729e-07
DAL212,5p,9,C>-,6,2,8,4131243,4008153,8139396,9.828739134943183e-07
DAL212,5p,10,C>-,1,7,8,4131179,4008148,8139327,9.828822456696973e-07
DAL212,5p,11,C>-,3,6,9,4131234,4008143,8139377,1.105735733828277e-06
DAL212,5p,12,C>-,4,12,16,4131187,4008141,8139328,1.965764249825047e-06
DAL212,5p,13,C>-,8,9,17,4131181,4008142,8139323,2.088625798484714e-06
DAL212,5p,14,C>-,8,6,14,4131134,4008108,8139242,1.7200618927413634e-06
DAL212,5p,15,C>-,14,17,31,4131156,4008091,8139247,3.808706137066488e-06
DAL212,5p,16,C>-,20,16,36,4131154,4008081,8139235,4.423020099554811e-06
DAL212,5p,17,C>-,54,20,74,4131159,4008081,8139240,9.091757952830976e-06
DAL212,5p,18,C>-,46,24,70,4131113,4008066,8139179,8.600376033012666e-06
DAL212,5p,19,C>-,57,25,82,4131040,4008052,8139092,1.0074833900390857e-05
DAL212,5p,20,C>-,45,28,73,4131020,4008040,8139060,8.969094711182864e-06
DAL212,5p,21,C>-,34,39,73,4130973,4008040,8139013,8.969146504619171e-06
DAL212,5p,22,C>-,59,43,102,4131015,4007967,8138982,1.2532279835488023e-05
DAL212,5p,23,C>-,62,43,105,4131005,4007962,8138967,1.290090007736854e-05
DAL212,5p,24,C>-,91,78,169,4131060,4007918,8138978,2.0764277775416028e-05
DAL212,5p,25,C>-,103,136,239,4131016,4007614,8138630,2.9366121816571092e-05
DAL218,3p,1,C>-,0,0,0,6952891,6658031,13610922,0.0
DAL218,3p,2,C>-,0,0,0,6952891,6658031,13610922,0.0
DAL218,3p,3,C>-,0,0,0,6952891,6658030,13610921,0.0
DAL218,3p,4,C>-,0,0,0,6952891,6658031,13610922,0.0
DAL218,3p,5,C>-,0,0,0,6952891,6658031,13610922,0.0
DAL218,3p,6,C>-,0,0,0,6952891,6658030,13610921,0.0
DAL218,3p,7,C>-,0,0,0,6952891,6658026,13610917,0.0
DAL218,3p,8,C>-,0,0,0,6952887,6657945,13610832,0.0
DAL218,3p,9,C>-,0,10,10,6952882,6657945,13610827,7.347092134812969e-07
DAL218,3p,10,C>-,2,1,3,6952881,6657960,13610841,2.2041253732961842e-07
DAL218,3p,11,C>-,6,2,8,6952866,6657905,13610771,5.877697890883625e-07
DAL218,3p,12,C>-,3,4,7,6952858,6657882,13610740,5.142997368254775e-07
DAL218,3p,13,C>-,2,16,18,6952870,6657811,13610681,1.322490770300178e-06
DAL218,3p,14,C>-,4,8,12,6952816,6657779,13610595,8.816660843996901e-07
DAL218,3p,15,C>-,10,44,54,6952788,6657738,13610526,3.967517493445882e-06
DAL218,3p,16,C>-,4,34,38,6952760,6657689,13610449,2.791972549913673e-06
DAL218,3p,17,C>-,11,62,73,6952737,6657651,13610388,5.363550252939152e-06
DAL218,3p,18,C>-,34,80,114,6952711,6657672,13610383,8.375958266567517e-06
DAL218,3p,19,C>-,24,128,152,6952716,6657697,13610413,1.116791973909976e-05
DAL218,3p,20,C>-,54,100,154,6952697,6657752,13610449,1.131483612333436e-05
DAL218,3p,21,C>-,52,94,146,6952660,6657692,13610352,1.072712887954698e-05
DAL218,3p,22,C>-,113,57,170,6952654,6657637,13610291,1.2490548512151576e-05
DAL218,3p,23,C>-,60,102,162,6952651,6657632,13610283,1.190276499026508e-05
DAL218,3p,24,C>-,67,111,178,6952669,6657588,13610257,1.3078371701577714e-05
DAL218,3p,25,C>-,92,91,183,6952605,6657566,13610171,1.344582665419854e-05
DAL218,5p,1,C>-,0,0,0,6952891,6658031,13610922,0.0
DAL218,5p,2,C>-,0,0,0,6952874,6658014,13610888,0.0
DAL218,5p,3,C>-,0,0,0,6952891,6658031,13610922,0.0
DAL218,5p,4,C>-,0,0,0,6952891,6658031,13610922,0.0
DAL218,5p,5,C>-,0,0,0,6952891,6658031,13610922,0.0
DAL218,5p,6,C>-,1,0,1,6952891,6658031,13610922,7.347040854396197e-08
DAL218,5p,7,C>-,0,0,0,6952888,6658031,13610919,0.0
DAL218,5p,8,C>-,3,0,3,6952719,6658029,13610748,2.204140433721938e-07
DAL218,5p,9,C>-,19,3,22,6952736,6658029,13610765,1.6163676325320436e-06
DAL218,5p,10,C>-,22,11,33,6952716,6658028,13610744,2.4245551896354823e-06
DAL218,5p,11,C>-,25,12,37,6952715,6658016,13610731,2.718443263627795e-06
DAL218,5p,12,C>-,27,8,35,6952625,6658005,13610630,2.5715194667697238e-06
DAL218,5p,13,C>-,20,9,29,6952475,6658005,13610480,2.130711040315992e-06
DAL218,5p,14,C>-,59,3,62,6952554,6657955,13610509,4.555303552571032e-06
DAL218,5p,15,C>-,48,7,55,6952449,6657923,13610372,4.041035763019556e-06
DAL218,5p,16,C>-,150,4,154,6952253,6657920,13610173,1.1315065576315598e-05
DAL218,5p,17,C>-,70,8,78,6952350,6657874,13610224,5.730985764819154e-06
DAL218,5p,18,C>-,122,22,144,6952457,6657843,13610300,1.0580222331616497e-05
DAL218,5p,19,C>-,220,26,246,6952296,6657770,13610066,1.807485724169156e-05
DAL218,5p,20,C>-,128,53,181,6952289,6657772,13610061,1.329898521395312e-05
DAL218,5p,21,C>-,175,41,216,6952371,6657729,13610100,1.5870566711486324e-05
DAL218,5p,22,C>-,146,50,196,6952322,6657786,13610108,1.4401061328830011e-05
DAL218,5p,23,C>-,176,57,233,6952288,6657745,13610033,1.7119723368782425e-05
DAL218,5p,24,C>-,176,62,238,6952375,6657772,13610147,1.7486952932984486e-05
DAL218,5p,25,C>-,224,99,323,6952272,6657720,13609992,2.373256354595947e-05
DAL224,3p,1,C>-,0,0,0,4609472,4586477,9195949,0.0
DAL224,3p,2,C>-,0,0,0,4609471,4586476,9195947,0.0
DAL224,3p,3,C>-,0,0,0,4609472,4586477,9195949,0.0
DAL224,3p,4,C>-,0,0,0,4609472,4586477,9195949,0.0
DAL224,3p,5,C>-,0,0,0,4609472,4586477,9195949,0.0
DAL224,3p,6,C>-,0,0,0,4609472,4586477,9195949,0.0
DAL224,3p,7,C>-,0,0,0,4609472,4586476,9195948,0.0
DAL224,3p,8,C>-,0,0,0,4609469,4586423,9195892,0.0
DAL224,3p,9,C>-,0,6,6,4609466,4586431,9195897,6.524648982040578e-07
DAL224,3p,10,C>-,0,14,14,4609461,4586371,9195832,1.5224288568995171e-06
DAL224,3p,11,C>-,2,4,6,4609461,4586382,9195843,6.52468729620547e-07
DAL224,3p,12,C>-,4,7,11,4609458,4586384,9195842,1.1961928010507357e-06
DAL224,3p,13,C>-,7,15,22,4609454,4586364,9195818,2.3923918459456243e-06
DAL224,3p,14,C>-,5,7,12,4609412,4586293,9195705,1.304957042445359e-06
DAL224,3p,15,C>-,13,10,23,4609400,4586272,9195672,2.5011766404891343e-06
DAL224,3p,16,C>-,11,24,35,4609379,4586240,9195619,3.8061603030747576e-06
DAL224,3p,17,C>-,7,32,39,4609381,4586216,9195597,4.241160198734242e-06
DAL224,3p,18,C>-,18,24,42,4609363,4586282,9195645,4.567379449728649e-06
DAL224,3p,19,C>-,15,23,38,4609353,4586195,9195548,4.1324345215750056e-06
DAL224,3p,20,C>-,11,35,46,4609344,4586225,9195569,5.002409312572175e-06
DAL224,3p,21,C>-,35,34,69,4609343,4586223,9195566,7.503616416868739e-06
DAL224,3p,22,C>-,40,41,81,4609324,4586172,9195496,8.808660239752157e-06
DAL224,3p,23,C>-,33,35,68,4609323,4586083,9195406,7.394997023513698e-06
DAL224,3p,24,C>-,41,61,102,4609325,4586202,9195527,1.1092349573874342e-05
DAL224,3p,25,C>-,44,62,106,4609265,4586173,9195438,1.1527455244655012e-05
DAL224,5p,1,C>-,0,0,0,4609472,4586477,9195949,0.0
DAL224,5p,2,C>-,0,0,0,4609461,4586469,9195930,0.0
DAL224,5p,3,C>-,0,0,0,4609468,4586477,9195945,0.0
DAL224,5p,4,C>-,0,0,0,4609471,4586477,9195948,0.0
DAL224,5p,5,C>-,0,0,0,4609471,4586477,9195948,0.0
DAL224,5p,6,C>-,0,0,0,4609472,4586477,9195949,0.0
DAL224,5p,7,C>-,0,0,0,4609471,4586477,9195948,0.0
DAL224,5p,8,C>-,0,0,0,4609397,4586477,9195874,0.0
DAL224,5p,9,C>-,6,0,6,4609357,4586473,9195830,6.524696520053111e-07
DAL224,5p,10,C>-,4,3,7,4609338,4586470,9195808,7.612164151317644e-07
DAL224,5p,11,C>-,6,3,9,4609388,4586469,9195857,9.78701604429038e-07
DAL224,5p,12,C>-,6,2,8,4609357,4586464,9195821,8.699603874412084e-07
DAL224,5p,13,C>-,12,3,15,4609320,4586461,9195781,1.6311828217744638e-06
DAL224,5p,14,C>-,18,5,23,4609270,4586428,9195698,2.5011695686395963e-06
DAL224,5p,15,C>-,22,8,30,4609299,4586416,9195715,3.2623890583820832e-06
DAL224,5p,16,C>-,29,9,38,4609292,4586373,9195665,4.132381943013365e-06
DAL224,5p,17,C>-,30,13,43,4609285,4586385,9195670,4.676113866635058e-06
DAL224,5p,18,C>-,22,11,33,4609226,4586351,9195577,3.5886818195312814e-06
DAL224,5p,19,C>-,56,12,68,4609203,4586337,9195540,7.394889261533309e-06
DAL224,5p,20,C>-,42,19,61,4609148,4586313,9195461,6.6337076520687765e-06
DAL224,5p,21,C>-,84,12,96,4609195,4586347,9195542,1.043984139270964e-05
DAL224,5p,22,C>-,54,24,78,4609138,4586312,9195450,8.482455997259515e-06
DAL224,5p,23,C>-,79,24,103,4609100,4586313,9195413,1.1201236964560482e-05
DAL224,5p,24,C>-,69,71,140,4609109,4586316,9195425,1.5224962413374042e-05
DAL224,5p,25,C>-,122,115,237,4609125,4586257,9195382,2.5773806895678724e-05
DAL227,3p,1,C>-,0,0,0,3765386,3771243,7536629,0.0
DAL227,3p,2,C>-,0,0,0,3765386,3771243,7536629,0.0
DAL227,3p,3,C>-,0,0,0,3765386,3771243,7536629,0.0
DAL227,3p,4,C>-,0,0,0,3765386,3771243,7536629,0.0
DAL227,3p,5,C>-,0,0,0,3765386,3771243,7536629,0.0
DAL227,3p,6,C>-,0,0,0,3765386,3771243,7536629,0.0
DAL227,3p,7,C>-,0,0,0,3765386,3771243,7536629,0.0
DAL227,3p,8,C>-,1,0,1,3765386,3771207,7536593,1.326859497388276e-07
DAL227,3p,9,C>-,0,0,0,3765384,3771218,7536602,0.0
DAL227,3p,10,C>-,1,0,1,3765382,3771209,7536591,1.3268598494995946e-07
DAL227,3p,11,C>-,1,7,8,3765378,3771214,7536592,1.0614877387551296e-06
DAL227,3p,12,C>-,2,0,2,3765377,3771173,7536550,2.65373413564562e-07
DAL227,3p,13,C>-,0,8,8,3765373,3771183,7536556,1.0614928091823374e-06
DAL227,3p,14,C>-,2,2,4,3765341,3771166,7536507,5.307498553374925e-07
DAL227,3p,15,C>-,0,8,8,3765341,3771186,7536527,1.0614968937283712e-06
DAL227,3p,16,C>-,9,16,25,3765340,3771079,7536419,3.31722532943033e-06
DAL227,3p,17,C>-,7,13,20,3765328,3771049,7536377,2.653795052981028e-06
DAL227,3p,18,C>-,4,17,21,3765321,3771036,7536357,2.786492200409296e-06
DAL227,3p,19,C>-,6,10,16,3765313,3771111,7536424,2.123022802326409e-06
DAL227,3p,20,C>-,6,25,31,3765308,3771082,7536390,4.113375236684938e-06
DAL227,3p,21,C>-,6,25,31,3765307,3771104,7536411,4.11336377487905e-06
DAL227,3p,22,C>-,4,19,23,3765309,3771137,7536446,3.051836369556685e-06
DAL227,3p,23,C>-,6,30,36,3765319,3771112,7536431,4.776796868438124e-06
DAL227,3p,24,C>-,24,63,87,3765312,3771081,7536393,1.1543983972173426e-05
DAL227,3p,25,C>-,27,30,57,3765249,3771100,7536349,7.563344001186782e-06
DAL227,5p,1,C>-,0,0,0,3765386,3771243,7536629,0.0
DAL227,5p,2,C>-,0,0,0,3765373,3771238,7536611,0.0
DAL227,5p,3,C>-,0,0,0,3765386,3771243,7536629,0.0
DAL227,5p,4,C>-,0,0,0,3765385,3771243,7536628,0.0
DAL227,5p,5,C>-,0,0,0,3765386,3771242,7536628,0.0
DAL227,5p,6,C>-,0,0,0,3765386,3771243,7536629,0.0
DAL227,5p,7,C>-,0,0,0,3765386,3771243,7536629,0.0
DAL227,5p,8,C>-,2,0,2,3765342,3771242,7536584,2.653722163781363e-07
DAL227,5p,9,C>-,1,0,1,3765324,3771243,7536567,1.326864074849995e-07
DAL227,5p,10,C>-,2,0,2,3765318,3771238,7536556,2.653732022955844e-07
DAL227,5p,11,C>-,4,0,4,3765365,3771237,7536602,5.30743165155862e-07
DAL227,5p,12,C>-,2,3,5,3765326,3771232,7536558,6.634328296816663e-07
DAL227,5p,13,C>-,1,4,5,3765325,3771231,7536556,6.634330057389609e-07
DAL227,5p,14,C>-,6,6,12,3765297,3771226,7536523,1.5922461856747468e-06
DAL227,5p,15,C>-,7,1,8,3765318,3771201,7536519,1.061498020505223e-06
DAL227,5p,16,C>-,6,2,8,3765316,3771188,7536504,1.0615001332182667e-06
DAL227,5p,17,C>-,11,4,15,3765326,3771175,7536501,1.9903135420535338e-06
DAL227,5p,18,C>-,8,5,13,3765280,3771169,7536449,1.72495030484516e-06
DAL227,5p,19,C>-,4,8,12,3765279,3771164,7536443,1.5922630875069312e-06
DAL227,5p,20,C>-,4,13,17,3765254,3771167,7536421,2.25571262539606e-06
DAL227,5p,21,C>-,15,7,22,3765270,3771169,7536439,2.919150543114593e-06
DAL227,5p,22,C>-,12,10,22,3765253,3771158,7536411,2.9191613886238424e-06
DAL227,5p,23,C>-,20,12,32,3765254,3771157,7536411,4.246052928907407e-06
DAL227,5p,24,C>-,32,24,56,3765270,3771180,7536450,7.43055417338402e-06
DAL227,5p,25,C>-,26,53,79,3765247,3771148,7536395,1.0482465422791668e-05
WA02,3p,1,C>-,0,0,0,6552698,6754258,13306956,0.0
WA02,3p,2,C>-,0,0,0,6552698,6754258,13306956,0.0
WA02,3p,3,C>-,0,0,0,6552698,6754258,13306956,0.0
WA02,3p,4,C>-,0,0,0,6552698,6754256,13306954,0.0
WA02,3p,5,C>-,0,0,0,6552698,6754256,13306954,0.0
WA02,3p,6,C>-,0,0,0,6552698,6754257,13306955,0.0
WA02,3p,7,C>-,0,1,1,6552698,6754257,13306955,7.514867225447144e-08
WA02,3p,8,C>-,1,0,1,6552692,6754207,13306899,7.514898850588707e-08
WA02,3p,9,C>-,9,39,48,6552688,6754191,13306879,3.6071568697663815e-06
WA02,3p,10,C>-,10,35,45,6552680,6754207,13306887,3.3817075323477235e-06
WA02,3p,11,C>-,20,38,58,6552667,6754202,13306869,4.358651159788227e-06
WA02,3p,12,C>-,19,28,47,6552670,6754189,13306859,3.532013076865097e-06
WA02,3p,13,C>-,24,41,65,6552675,6754177,13306852,4.8847015056603925e-06
WA02,3p,14,C>-,34,60,94,6552653,6754155,13306808,7.06405322749077e-06
WA02,3p,15,C>-,36,49,85,6552632,6754146,13306778,6.387722106733876e-06
WA02,3p,16,C>-,37,51,88,6552629,6754119,13306748,6.613186031628464e-06
WA02,3p,17,C>-,40,49,89,6552608,6754116,13306724,6.688347935975827e-06
WA02,3p,18,C>-,49,46,95,6552611,6754085,13306696,7.139262819260318e-06
WA02,3p,19,C>-,51,61,112,6552605,6754056,13306661,8.41683725165915e-06
WA02,3p,20,C>-,63,59,122,6552618,6754033,13306651,9.168347467743762e-06
WA02,3p,21,C>-,67,72,139,6552597,6754089,13306686,1.0445876606692306e-05
WA02,3p,22,C>-,78,69,147,6552593,6754062,13306655,1.1047103873963816e-05
WA02,3p,23,C>-,60,89,149,6552585,6754052,13306637,1.1197419753766486e-05
WA02,3p,24,C>-,125,158,283,6552556,6754026,13306582,2.126767039048796e-05
WA02,3p,25,C>-,173,216,389,6552517,6754038,13306555,2.9233712256853855e-05
WA02,5p,1,C>-,0,0,0,6552698,6754258,13306956,0.0
WA02,5p,2,C>-,0,0,0,6552562,6754179,13306741,0.0
WA02,5p,3,C>-,0,0,0,6552698,6754258,13306956,0.0
WA02,5p,4,C>-,0,0,0,6552698,6754258,13306956,0.0
WA02,5p,5,C>-,0,0,0,6552698,6754258,13306956,0.0
WA02,5p,6,C>-,0,0,0,6552697,6754258,13306955,0.0
WA02,5p,7,C>-,1,0,1,6552685,6754258,13306943,7.514874002240786e-08
WA02,5p,8,C>-,1,0,1,6552655,6754257,13306912,7.514891509014264e-08
WA02,5p,9,C>-,27,4,31,6552662,6754226,13306888,2.3296205694374223e-06
WA02,5p,10,C>-,21,5,26,6552618,6754222,13306840,1.95388236425778e-06
WA02,5p,11,C>-,34,10,44,6552625,6754225,13306850,3.3065676700346064e-06
WA02,5p,12,C>-,44,9,53,6552628,6754236,13306864,3.982906866711796e-06
WA02,5p,13,C>-,22,10,32,6552614,6754205,13306819,2.4047820895437142e-06
WA02,5p,14,C>-,68,20,88,6552607,6754183,13306790,6.613165158539362e-06
WA02,5p,15,C>-,46,22,68,6552586,6754168,13306754,5.110186902079951e-06
WA02,5p,16,C>-,69,26,95,6552525,6754178,13306703,7.139259063646344e-06
WA02,5p,17,C>-,69,38,107,6552567,6754148,13306715,8.041052957097225e-06
WA02,5p,18,C>-,78,41,119,6552548,6754087,13306635,8.942907053511275e-06
WA02,5p,19,C>-,61,62,123,6552516,6754124,13306640,9.24350549800701e-06
WA02,5p,20,C>-,65,81,146,6552507,6754132,13306639,1.0971966700231366e-05
WA02,5p,21,C>-,110,48,158,6552521,6754152,13306673,1.1873741843659943e-05
WA02,5p,22,C>-,78,61,139,6552516,6754117,13306633,1.0445918212368225e-05
WA02,5p,23,C>-,105,69,174,6552465,6754131,13306596,1.3076221747470202e-05
WA02,5p,24,C>-,214,183,397,6552457,6754135,13306592,2.983483674858296e-05
WA02,5p,25,C>-,197,277,474,6552470,6754083,13306553,3.5621546767220634e-05
WA03,3p,1,C>-,0,0,0,5399458,5543742,10943200,0.0
WA03,3p,2,C>-,0,0,0,5399458,5543742,10943200,0.0
WA03,3p,3,C>-,0,0,0,5399458,5543742,10943200,0.0
WA03,3p,4,C>-,0,0,0,5399458,5543736,10943194,0.0
WA03,3p,5,C>-,0,0,0,5399458,5543740,10943198,0.0
WA03,3p,6,C>-,0,0,0,5399458,5543741,10943199,0.0
WA03,3p,7,C>-,0,2,2,5399458,5543739,10943197,1.8276194790242744e-07
WA03,3p,8,C>-,0,1,1,5399449,5543673,10943122,9.138160024168605e-08
WA03,3p,9,C>-,6,29,35,5399436,5543670,10943106,3.1983606848000923e-06
WA03,3p,10,C>-,14,43,57,5399438,5543654,10943092,5.208765493335887e-06
WA03,3p,11,C>-,20,47,67,5399404,5543644,10943048,6.122608618732185e-06
WA03,3p,12,C>-,11,14,25,5399397,5543595,10942992,2.284567145804365e-06
WA03,3p,13,C>-,23,42,65,5399378,5543551,10942929,5.939908775794854e-06
WA03,3p,14,C>-,23,42,65,5399356,5543493,10942849,5.939952200747721e-06
WA03,3p,15,C>-,37,57,94,5399349,5543505,10942854,8.590080796106756e-06
WA03,3p,16,C>-,32,70,102,5399342,5543495,10942837,9.321165982825111e-06
WA03,3p,17,C>-,43,79,122,5399346,5543438,10942784,1.1148899585334042e-05
WA03,3p,18,C>-,68,106,174,5399325,5543443,10942768,1.5900912822057454e-05
WA03,3p,19,C>-,41,152,193,5399297,5543425,10942722,1.763729353628832e-05
WA03,3p,20,C>-,64,166,230,5399252,5543409,10942661,2.1018653506674476e-05
WA03,3p,21,C>-,65,124,189,5399248,5543303,10942551,1.7272023680766942e-05
WA03,3p,22,C>-,64,242,306,5399256,5543263,10942519,2.7964310594297347e-05
WA03,3p,23,C>-,81,302,383,5399255,5543267,10942522,3.500107196494556e-05
WA03,3p,24,C>-,95,287,382,5399198,5543130,10942328,3.4910304278943204e-05
WA03,3p,25,C>-,183,368,551,5399050,5543142,10942192,5.035554119320882e-05
WA03,5p,1,C>-,0,0,0,5399457,5543742,10943199,0.0
WA03,5p,2,C>-,0,0,0,5399258,5543638,10942896,0.0
WA03,5p,3,C>-,0,0,0,5399457,5543742,10943199,0.0
WA03,5p,4,C>-,0,0,0,5399458,5543742,10943200,0.0
WA03,5p,5,C>-,0,0,0,5399456,5543740,10943196,0.0
WA03,5p,6,C>-,0,0,0,5399452,5543742,10943194,0.0
WA03,5p,7,C>-,0,0,0,5399453,5543742,10943195,0.0
WA03,5p,8,C>-,1,1,2,5399403,5543732,10943135,1.827629833681116e-07
WA03,5p,9,C>-,41,7,48,5399319,5543732,10943051,4.386345270619683e-06
WA03,5p,10,C>-,34,11,45,5399344,5543717,10943061,4.112194933392037e-06
WA03,5p,11,C>-,49,23,72,5399321,5543705,10943026,6.579532937233266e-06
WA03,5p,12,C>-,44,18,62,5399213,5543665,10942878,5.665785545630683e-06
WA03,5p,13,C>-,41,22,63,5399156,5543662,10942818,5.757200750300334e-06
WA03,5p,14,C>-,51,21,72,5399124,5543629,10942753,6.57969708354013e-06
WA03,5p,15,C>-,85,41,126,5399092,5543505,10942597,1.1514634048937375e-05
WA03,5p,16,C>-,75,28,103,5399083,5543501,10942584,9.412767587619158e-06
WA03,5p,17,C>-,119,25,144,5399113,5543491,10942604,1.315957335201018e-05
WA03,5p,18,C>-,90,33,123,5399074,5543600,10942674,1.1240396999855794e-05
WA03,5p,19,C>-,101,45,146,5399071,5543546,10942617,1.3342329353206824e-05
WA03,5p,20,C>-,121,55,176,5399050,5543533,10942583,1.6083953852577586e-05
WA03,5p,21,C>-,115,42,157,5399034,5543509,10942543,1.4347670372417088e-05
WA03,5p,22,C>-,149,65,214,5398989,5543454,10942443,1.955687591884189e-05
WA03,5p,23,C>-,119,83,202,5398935,5543457,10942392,1.846031470998297e-05
WA03,5p,24,C>-,202,123,325,5398952,5543428,10942380,2.9701033961533048e-05
WA03,5p,25,C>-,187,153,340,5398991,5543444,10942435,3.107169473704893e-05
WA07,3p,1,C>-,0,0,0,5691729,6013979,11705708,0.0
WA07,3p,2,C>-,0,0,0,5691729,6013979,11705708,0.0
WA07,3p,3,C>-,0,0,0,5691729,6013979,11705708,0.0
WA07,3p,4,C>-,0,0,0,5691729,6013979,11705708,0.0
WA07,3p,5,C>-,0,0,0,5691729,6013979,11705708,0.0
WA07,3p,6,C>-,0,0,0,5691729,6013979,11705708,0.0
WA07,3p,7,C>-,0,0,0,5691729,6013979,11705708,0.0
WA07,3p,8,C>-,0,0,0,5691713,6013800,11705513,0.0
WA07,3p,9,C>-,2,3,5,5691720,6013901,11705621,4.2714521510648603e-07
WA07,3p,10,C>-,3,15,18,5691718,6013892,11705610,1.537724219412743e-06
WA07,3p,11,C>-,13,4,17,5691711,6013883,11705594,1.4522970812074978e-06
WA07,3p,12,C>-,5,9,14,5691705,6013884,11705589,1.1960098718654824e-06
WA07,3p,13,C>-,4,16,20,5691711,6013848,11705559,1.7085899101444022e-06
WA07,3p,14,C>-,9,11,20,5691695,6013877,11705572,1.708588012614847e-06
WA07,3p,15,C>-,9,17,26,5691211,6013856,11705067,2.2212602456696743e-06
WA07,3p,16,C>-,20,17,37,5691636,6013850,11705486,3.1609110463247746e-06
WA07,3p,17,C>-,8,23,31,5691662,6013813,11705475,2.648333365369624e-06
WA07,3p,18,C>-,28,31,59,5691639,6013769,11705408,5.040405255416984e-06
WA07,3p,19,C>-,18,22,40,5691628,6013742,11705370,3.4172349955618663e-06
WA07,3p,20,C>-,17,27,44,5691604,6013772,11705376,3.758956568332363e-06
WA07,3p,21,C>-,20,50,70,5691611,6013735,11705346,5.980173503628172e-06
WA07,3p,22,C>-,13,50,63,5691577,6013736,11705313,5.382171326815438e-06
WA07,3p,23,C>-,28,36,64,5691568,6013670,11705238,5.4676376507679725e-06
WA07,3p,24,C>-,48,81,129,5691554,6013661,11705215,1.102072879481496e-05
WA07,3p,25,C>-,77,105,182,5691455,6013662,11705117,1.5548755300779993e-05
WA07,5p,1,C>-,0,0,0,5691729,6013979,11705708,0.0
WA07,5p,2,C>-,0,0,0,5691636,6013923,11705559,0.0
WA07,5p,3,C>-,0,0,0,5691729,6013979,11705708,0.0
WA07,5p,4,C>-,0,0,0,5691728,6013979,11705707,0.0
WA07,5p,5,C>-,0,0,0,5691729,6013978,11705707,0.0
WA07,5p,6,C>-,0,0,0,5691728,6013979,11705707,0.0
WA07,5p,7,C>-,0,0,0,5691728,6013979,11705707,0.0
WA07,5p,8,C>-,0,0,0,5691579,6013975,11705554,0.0
WA07,5p,9,C>-,13,2,15,5691672,6013971,11705643,1.2814332369439253e-06
WA07,5p,10,C>-,12,3,15,5691582,6013961,11705543,1.2814441841783846e-06
WA07,5p,11,C>-,8,2,10,5691326,6013942,11705268,8.543161933584092e-07
WA07,5p,12,C>-,13,4,17,5691520,6013938,11705458,1.4523139547380377e-06
WA07,5p,13,C>-,34,1,35,5691511,6013949,11705460,2.9900576312250864e-06
WA07,5p,14,C>-,28,0,28,5691556,6013950,11705506,2.3920367047780763e-06
WA07,5p,15,C>-,31,7,38,5691563,6013633,11705196,3.2464215037492757e-06
WA07,5p,16,C>-,47,4,51,5691534,6013925,11705459,4.356941491999587e-06
WA07,5p,17,C>-,67,16,83,5691561,6013916,11705477,7.090697798987602e-06
WA07,5p,18,C>-,47,11,58,5691474,6013905,11705379,4.954986933784886e-06
WA07,5p,19,C>-,78,12,90,5691482,6013884,11705366,7.688781367451474e-06
WA07,5p,20,C>-,70,6,76,5691421,6013876,11705297,6.492786983534036e-06
WA07,5p,21,C>-,82,22,104,5691379,6013853,11705232,8.884915736826063e-06
WA07,5p,22,C>-,66,19,85,5691396,6013861,11705257,7.261694467707971e-06
WA07,5p,23,C>-,80,11,91,5691314,6013795,11705109,7.774382963883548e-06
WA07,5p,24,C>-,115,56,171,5691332,6013785,11705117,1.4608995365018564e-05
WA07,5p,25,C>-,135,64,199,5691334,6013719,11705053,1.7001204522525443e-05
WA08,3p,1,C>-,0,0,0,6798117,7189085,13987202,0.0
WA08,3p,2,C>-,0,0,0,6798117,7189085,13987202,0.0
WA08,3p,3,C>-,0,0,0,6798117,7189085,13987202,0.0
WA08,3p,4,C>-,0,0,0,6798117,7189081,13987198,0.0
WA08,3p,5,C>-,0,0,0,6798117,7189085,13987202,0.0
WA08,3p,6,C>-,0,0,0,6798117,7189085,13987202,0.0
WA08,3p,7,C>-,0,0,0,6798117,7189084,13987201,0.0
WA08,3p,8,C>-,1,1,2,6798110,7189053,13987163,1.4298825287157948e-07
WA08,3p,9,C>-,6,25,31,6798103,7189051,13987154,2.2163193455938214e-06
WA08,3p,10,C>-,11,18,29,6798074,7189042,13987116,2.073336633513299e-06
WA08,3p,11,C>-,9,23,32,6798109,7189046,13987155,2.2878133544670094e-06
WA08,3p,12,C>-,11,17,28,6798091,7189018,13987109,2.0018432686840438e-06
WA08,3p,13,C>-,16,24,40,6798090,7189013,13987103,2.859777324868488e-06
WA08,3p,14,C>-,16,27,43,6798067,7188981,13987048,3.074272712869792e-06
WA08,3p,15,C>-,10,9,19,6798069,7188978,13987047,1.3583996679213274e-06
WA08,3p,16,C>-,35,29,64,6798049,7188961,13987010,4.57567414336588e-06
WA08,3p,17,C>-,49,33,82,6798000,7188943,13986943,5.862610579023594e-06
WA08,3p,18,C>-,42,50,92,6798023,7188956,13986979,6.577546159181336e-06
WA08,3p,19,C>-,50,41,91,6798028,7188946,13986974,6.506053417987336e-06
WA08,3p,20,C>-,34,51,85,6798009,7188917,13986926,6.077103718143643e-06
WA08,3p,21,C>-,53,42,95,6798010,7188926,13986936,6.792052240748081e-06
WA08,3p,22,C>-,55,51,106,6798012,7188920,13986932,7.5785025622488195e-06
WA08,3p,23,C>-,60,66,126,6798009,7188864,13986873,9.00844670570756e-06
WA08,3p,24,C>-,65,93,158,6798015,7188867,13986882,1.1296298917800265e-05
WA08,3p,25,C>-,76,107,183,6797966,7188892,13986858,1.3083710437326238e-05
WA08,5p,1,C>-,0,0,0,6798116,7189085,13987201,0.0
WA08,5p,2,C>-,0,0,0,6797941,7188997,13986938,0.0
WA08,5p,3,C>-,0,0,0,6798117,7189084,13987201,0.0
WA08,5p,4,C>-,1,0,1,6798115,7189085,13987200,7.149393731411576e-08
WA08,5p,5,C>-,0,0,0,6798116,7189084,13987200,0.0
WA08,5p,6,C>-,1,0,1,6798112,7189085,13987197,7.149395264826826e-08
WA08,5p,7,C>-,0,0,0,6798110,7189085,13987195,0.0
WA08,5p,8,C>-,3,4,7,6798069,7189064,13987133,5.004599584489545e-07
WA08,5p,9,C>-,25,2,27,6798054,7189067,13987121,1.930347210122798e-06
WA08,5p,10,C>-,19,2,21,6798015,7189037,13987052,1.501388569943116e-06
WA08,5p,11,C>-,35,9,44,6797997,7189047,13987044,3.1457683267458084e-06
WA08,5p,12,C>-,25,13,38,6798016,7189056,13987072,2.7167944799311822e-06
WA08,5p,13,C>-,41,12,53,6797995,7189043,13987038,3.789222564491496e-06
WA08,5p,14,C>-,21,8,29,6797984,7189041,13987025,2.073350122703005e-06
WA08,5p,15,C>-,36,16,52,6797997,7189013,13987010,3.7177352414847775e-06
WA08,5p,16,C>-,33,11,44,6797921,7188997,13986918,3.1457966651409557e-06
WA08,5p,17,C>-,62,28,90,6797959,7188875,13986834,6.434622731634621e-06
WA08,5p,18,C>-,64,24,88,6797991,7188972,13986963,6.29157308845387e-06
WA08,5p,19,C>-,54,42,96,6797966,7188988,13986954,6.863538694700791e-06
WA08,5p,20,C>-,35,25,60,6797883,7188971,13986854,4.289742353784489e-06
WA08,5p,21,C>-,55,27,82,6797885,7188979,13986864,5.862643691966977e-06
WA08,5p,22,C>-,63,65,128,6797887,7188939,13986826,9.151468674880204e-06
WA08,5p,23,C>-,73,50,123,6797851,7188919,13986770,8.794024638998138e-06
WA08,5p,24,C>-,139,90,229,6797841,7188876,13986717,1.637267701920329e-05
WA08,5p,25,C>-,160,169,329,6797835,7188817,13986652,2.3522426953927216e-05
WA09,3p,1,C>-,0,0,0,4741672,4881751,9623423,0.0
WA09,3p,2,C>-,0,0,0,4741672,4881751,9623423,0.0
WA09,3p,3,C>-,0,0,0,4741672,4881751,9623423,0.0
WA09,3p,4,C>-,0,0,0,4741672,4881748,9623420,0.0
WA09,3p,5,C>-,0,0,0,4741672,4881751,9623423,0.0
WA09,3p,6,C>-,0,0,0,4741672,4881751,9623423,0.0
WA09,3p,7,C>-,0,0,0,4741672,4881748,9623420,0.0
WA09,3p,8,C>-,0,0,0,4741663,4881718,9623381,0.0
WA09,3p,9,C>-,8,7,15,4741664,4881723,9623387,1.558702772734797e-06
WA09,3p,10,C>-,7,5,12,4741658,4881705,9623363,1.2469653280251405e-06
WA09,3p,11,C>-,10,11,21,4741648,4881712,9623360,2.182190004322814e-06
WA09,3p,12,C>-,5,11,16,4741642,4881680,9623322,1.662627520933e-06
WA09,3p,13,C>-,12,14,26,4741628,4881645,9623273,2.7017834784485485e-06
WA09,3p,14,C>-,23,15,38,4741616,4881571,9623187,3.948795757580103e-06
WA09,3p,15,C>-,18,30,48,4741598,4881557,9623155,4.987969122392812e-06
WA09,3p,16,C>-,20,41,61,4741586,4881546,9623132,6.338892576761911e-06
WA09,3p,17,C>-,17,39,56,4741582,4881528,9623110,5.81932452190612e-06
WA09,3p,18,C>-,24,41,65,4741560,4881490,9623050,6.754615220746021e-06
WA09,3p,19,C>-,27,50,77,4741552,4881442,9622994,8.00166767224421e-06
WA09,3p,20,C>-,29,24,53,4741534,4881501,9623035,5.507617918879023e-06
WA09,3p,21,C>-,20,44,64,4741546,4881493,9623039,6.650705665850465e-06
WA09,3p,22,C>-,50,43,93,4741524,4881498,9623022,9.664323743622326e-06
WA09,3p,23,C>-,45,83,128,4741501,4881486,9622987,1.3301483208903847e-05
WA09,3p,24,C>-,69,126,195,4741491,4881450,9622941,2.0264075192812678e-05
WA09,3p,25,C>-,102,111,213,4741451,4881469,9622920,2.2134653514733572e-05
WA09,5p,1,C>-,0,0,0,4741672,4881751,9623423,0.0
WA09,5p,2,C>-,0,0,0,4741495,4881667,9623162,0.0
WA09,5p,3,C>-,0,0,0,4741672,4881750,9623422,0.0
WA09,5p,4,C>-,1,0,1,4741672,4881751,9623423,1.039131294550806e-07
WA09,5p,5,C>-,0,0,0,4741671,4881751,9623422,0.0
WA09,5p,6,C>-,0,0,0,4741669,4881751,9623420,0.0
WA09,5p,7,C>-,1,0,1,4741667,4881751,9623418,1.0391318344480101e-07
WA09,5p,8,C>-,1,1,2,4741639,4881744,9623383,2.078271227488296e-07
WA09,5p,9,C>-,13,1,14,4741618,4881747,9623365,1.4547925803500129e-06
WA09,5p,10,C>-,11,2,13,4741622,4881737,9623359,1.3508796668606043e-06
WA09,5p,11,C>-,11,0,11,4741614,4881733,9623347,1.143053451153741e-06
WA09,5p,12,C>-,12,2,14,4741580,4881734,9623314,1.454800290211875e-06
WA09,5p,13,C>-,24,3,27,4741530,4881708,9623238,2.8057084320267253e-06
WA09,5p,14,C>-,27,3,30,4741498,4881705,9623203,3.11746515167559e-06
WA09,5p,15,C>-,58,9,67,4741496,4881672,9623168,6.962364161157739e-06
WA09,5p,16,C>-,30,11,41,4741451,4881636,9623087,4.260587065252553e-06
WA09,5p,17,C>-,45,12,57,4741476,4881638,9623114,5.923238569136768e-06
WA09,5p,18,C>-,43,23,66,4741455,4881610,9623065,6.858521687217118e-06
WA09,5p,19,C>-,47,19,66,4741379,4881580,9622959,6.858597236047665e-06
WA09,5p,20,C>-,50,38,88,4741390,4881557,9622947,9.14480771846712e-06
WA09,5p,21,C>-,70,36,106,4741379,4881587,9622966,1.101531482081512e-05
WA09,5p,22,C>-,96,39,135,4741354,4881580,9622934,1.402898533856722e-05
WA09,5p,23,C>-,150,194,344,4741312,4881565,9622877,3.574814475961815e-05
WA09,5p,24,C>-,189,82,271,4741363,4881548,9622911,2.816195639760152e-05
WA09,5p,25,C>-,131,120,251,4741301,4881503,9622804,2.6083873266045943e-05
WA11,3p,1,C>-,0,0,0,9756642,10108269,19864911,0.0
WA11,3p,2,C>-,0,0,0,9756642,10108269,19864911,0.0
WA11,3p,3,C>-,0,0,0,9756642,10108269,19864911,0.0
WA11,3p,4,C>-,0,0,0,9756642,10108267,19864909,0.0
WA11,3p,5,C>-,0,0,0,9756642,10108269,19864911,0.0
WA11,3p,6,C>-,0,0,0,9756642,10108269,19864911,0.0
WA11,3p,7,C>-,0,0,0,9756642,10108265,19864907,0.0
WA11,3p,8,C>-,1,2,3,9756629,10108160,19864789,1.510209849195982e-07
WA11,3p,9,C>-,5,110,115,9756610,10108092,19864702,5.789163109519589e-06
WA11,3p,10,C>-,18,39,57,9756615,10107969,19864584,2.869428325304975e-06
WA11,3p,11,C>-,21,58,79,9756587,10107918,19864505,3.976942793188151e-06
WA11,3p,12,C>-,21,74,95,9756581,10108019,19864600,4.782376690192604e-06
WA11,3p,13,C>-,29,65,94,9756565,10107963,19864528,4.732053034434042e-06
WA11,3p,14,C>-,31,110,141,9756515,10107914,19864429,7.098114926937996e-06
WA11,3p,15,C>-,41,43,84,9756471,10107972,19864443,4.228661231528113e-06
WA11,3p,16,C>-,41,75,116,9756477,10108011,19864488,5.839566567232944e-06
WA11,3p,17,C>-,62,96,158,9756469,10108044,19864513,7.953882383122104e-06
WA11,3p,18,C>-,44,93,137,9756421,10108016,19864437,6.8967471869451925e-06
WA11,3p,19,C>-,42,120,162,9756438,10108000,19864438,8.155277284965223e-06
WA11,3p,20,C>-,61,118,179,9756433,10107963,19864396,9.011097040151636e-06
WA11,3p,21,C>-,54,122,176,9756421,10107904,19864325,8.860104735499445e-06
WA11,3p,22,C>-,65,106,171,9756405,10107842,19864247,8.608431016791122e-06
WA11,3p,23,C>-,60,138,198,9756375,10107816,19864191,9.967685067063642e-06
WA11,3p,24,C>-,107,213,320,9756358,10107704,19864062,1.6109494624009934e-05
WA11,3p,25,C>-,136,270,406,9756281,10107693,19863974,2.043901185130428e-05
WA11,5p,1,C>-,0,0,0,9756641,10108269,19864910,0.0
WA11,5p,2,C>-,1,0,1,9756471,10108196,19864667,5.034063747456728e-08
WA11,5p,3,C>-,0,0,0,9756642,10108269,19864911,0.0
WA11,5p,4,C>-,0,0,0,9756638,10108269,19864907,0.0
WA11,5p,5,C>-,0,0,0,9756638,10108267,19864905,0.0
WA11,5p,6,C>-,0,0,0,9756642,10108269,19864911,0.0
WA11,5p,7,C>-,1,0,1,9756629,10108269,19864898,5.034005208584509e-08
WA11,5p,8,C>-,5,2,7,9756500,10108261,19864761,3.523827948395654e-07
WA11,5p,9,C>-,51,5,56,9756493,10108240,19864733,2.819066332278415e-06
WA11,5p,10,C>-,36,13,49,9756446,10108197,19864643,2.46669421645282e-06
WA11,5p,11,C>-,44,21,65,9756457,10108195,19864652,3.272143906674026e-06
WA11,5p,12,C>-,40,12,52,9756411,10108221,19864632,2.617717760892827e-06
WA11,5p,13,C>-,50,26,76,9756334,10108178,19864512,3.825918300937874e-06
WA11,5p,14,C>-,42,26,68,9756261,10108167,19864428,3.423204534255907e-06
WA11,5p,15,C>-,70,35,105,9756237,10108096,19864333,5.285855810008824e-06
WA11,5p,16,C>-,124,45,169,9756275,10108079,19864354,8.50770178582198e-06
WA11,5p,17,C>-,121,31,152,9756369,10108078,19864447,7.651861640044648e-06
WA11,5p,18,C>-,97,38,135,9756327,10108075,19864402,6.796076720557709e-06
WA11,5p,19,C>-,93,55,148,9756284,10108088,19864372,7.450524990168328e-06
WA11,5p,20,C>-,134,70,204,9756292,10108082,19864374,1.0269641520039848e-05
WA11,5p,21,C>-,96,83,179,9756251,10108036,19864287,9.011146486153767e-06
WA11,5p,22,C>-,136,60,196,9756136,10108029,19864165,9.86701429433354e-06
WA11,5p,23,C>-,150,90,240,9756095,10108016,19864111,1.2082091164311355e-05
WA11,5p,24,C>-,224,167,391,9756046,10108010,19864056,1.968379468926185e-05
WA11,5p,25,C>-,270,212,482,9756056,10107943,19863999,2.426500323524986e-05
WA12,3p,1,C>-,0,0,0,6632243,6940679,13572922,0.0
WA12,3p,2,C>-,0,0,0,6632243,6940679,13572922,0.0
WA12,3p,3,C>-,0,0,0,6632243,6940679,13572922,0.0
WA12,3p,4,C>-,0,0,0,6632243,6940676,13572919,0.0
WA12,3p,5,C>-,0,0,0,6632243,6940678,13572921,0.0
WA12,3p,6,C>-,0,0,0,6632243,6940679,13572922,0.0
WA12,3p,7,C>-,0,0,0,6632243,6940676,13572919,0.0
WA12,3p,8,C>-,0,0,0,6632240,6940664,13572904,0.0
WA12,3p,9,C>-,5,14,19,6632231,6940656,13572887,1.3998495677448726e-06
WA12,3p,10,C>-,4,11,15,6632228,6940644,13572872,1.1051456169335422e-06
WA12,3p,11,C>-,3,6,9,6632231,6940642,13572873,6.630873213062555e-07
WA12,3p,12,C>-,9,7,16,6632223,6940615,13572838,1.1788249443484112e-06
WA12,3p,13,C>-,12,19,31,6632204,6940591,13572795,2.283980565535691e-06
WA12,3p,14,C>-,8,10,18,6632209,6940533,13572742,1.3261874424489909e-06
WA12,3p,15,C>-,16,31,47,6632188,6940474,13572662,3.4628431769685267e-06
WA12,3p,16,C>-,20,27,47,6632187,6940478,13572665,3.462842411567662e-06
WA12,3p,17,C>-,18,42,60,6632168,6940473,13572641,4.4206577039796456e-06
WA12,3p,18,C>-,24,38,62,6632160,6940482,13572642,4.56801262421863e-06
WA12,3p,19,C>-,29,57,86,6632121,6940435,13572556,6.33631572417163e-06
WA12,3p,20,C>-,33,72,105,6632105,6940432,13572537,7.736210260469358e-06
WA12,3p,21,C>-,38,77,115,6632096,6940454,13572550,8.472984074473847e-06
WA12,3p,22,C>-,46,102,148,6632039,6940438,13572477,1.0904420762694974e-05
WA12,3p,23,C>-,56,92,148,6631950,6940459,13572409,1.0904475395635366e-05
WA12,3p,24,C>-,68,102,170,6631933,6940411,13572344,1.2525470913498805e-05
WA12,3p,25,C>-,109,135,244,6631986,6940428,13572414,1.7977642002373343e-05
WA12,5p,1,C>-,0,0,0,6632243,6940679,13572922,0.0
WA12,5p,2,C>-,0,0,0,6631949,6940524,13572473,0.0
WA12,5p,3,C>-,0,0,0,6632242,6940678,13572920,0.0
WA12,5p,4,C>-,0,0,0,6632242,6940679,13572921,0.0
WA12,5p,5,C>-,1,0,1,6632242,6940677,13572919,7.367611933733636e-08
WA12,5p,6,C>-,0,0,0,6632242,6940679,13572921,0.0
WA12,5p,7,C>-,1,0,1,6632238,6940679,13572917,7.367613019367907e-08
WA12,5p,8,C>-,5,0,5,6632204,6940670,13572874,3.683818180291072e-07
WA12,5p,9,C>-,223,5,228,6632209,6940675,13572884,1.6798198525825462e-05
WA12,5p,10,C>-,47,9,56,6632199,6940665,13572864,4.125879401723911e-06
WA12,5p,11,C>-,57,6,63,6632166,6940667,13572833,4.641624928266634e-06
WA12,5p,12,C>-,32,14,46,6632126,6940660,13572786,3.389134699390383e-06
WA12,5p,13,C>-,45,6,51,6632065,6940658,13572723,3.757536346980632e-06
WA12,5p,14,C>-,163,11,174,6632026,6940638,13572664,1.2819885617149294e-05
WA12,5p,15,C>-,55,14,69,6631987,6940631,13572618,5.083764974450765e-06
WA12,5p,16,C>-,61,12,73,6631930,6940590,13572520,5.378514822597425e-06
WA12,5p,17,C>-,114,18,132,6631958,6940621,13572579,9.72549137492587e-06
WA12,5p,18,C>-,111,15,126,6632019,6940577,13572596,9.283411957447195e-06
WA12,5p,19,C>-,106,31,137,6631996,6940532,13572528,1.0093919128404085e-05
WA12,5p,20,C>-,92,35,127,6631973,6940532,13572505,9.357152566899036e-06
WA12,5p,21,C>-,102,36,138,6631936,6940534,13572470,1.0167640819983392e-05
WA12,5p,22,C>-,93,29,122,6631921,6940529,13572450,8.988797158950669e-06
WA12,5p,23,C>-,104,65,169,6631926,6940534,13572460,1.2451685250868305e-05
WA12,5p,24,C>-,149,99,248,6631934,6940518,13572452,1.827230628629226e-05
WA12,5p,25,C>-,159,93,252,6631933,6940515,13572448,1.856702637578718e-05
WA13,3p,1,C>-,0,0,0,5896847,6081528,11978375,0.0
WA13,3p,2,C>-,0,0,0,5896847,6081528,11978375,0.0
WA13,3p,3,C>-,0,0,0,5896847,6081528,11978375,0.0
WA13,3p,4,C>-,0,0,0,5896847,6081522,11978369,0.0
WA13,3p,5,C>-,0,0,0,5896847,6081527,11978374,0.0
WA13,3p,6,C>-,0,0,0,5896847,6081528,11978375,0.0
WA13,3p,7,C>-,0,0,0,5896847,6081528,11978375,0.0
WA13,3p,8,C>-,0,0,0,5896845,6081521,11978366,0.0
WA13,3p,9,C>-,2,5,7,5896842,6081517,11978359,5.843872269982892e-07
WA13,3p,10,C>-,2,5,7,5896843,6081517,11978360,5.843871782113745e-07
WA13,3p,11,C>-,4,10,14,5896841,6081492,11978333,1.1687769909218589e-06
WA13,3p,12,C>-,4,10,14,5896836,6081505,11978341,1.1687762103282918e-06
WA13,3p,13,C>-,7,3,10,5896834,6081495,11978329,8.348409865850237e-07
WA13,3p,14,C>-,4,8,12,5896832,6081501,11978333,1.0018088493615932e-06
WA13,3p,15,C>-,8,6,14,5896825,6081505,11978330,1.1687772836447151e-06
WA13,3p,16,C>-,1,19,20,5896830,6081509,11978339,1.6696805792522653e-06
WA13,3p,17,C>-,11,26,37,5896823,6081499,11978322,3.0889134554906773e-06
WA13,3p,18,C>-,14,18,32,5896827,6081499,11978326,2.671491826153337e-06
WA13,3p,19,C>-,17,25,42,5896822,6081480,11978302,3.506340047195337e-06
WA13,3p,20,C>-,11,17,28,5896818,6081448,11978266,2.3375670568678304e-06
WA13,3p,21,C>-,13,31,44,5896824,6081466,11978290,3.673312300837599e-06
WA13,3p,22,C>-,19,76,95,5896824,6081460,11978284,7.931019167687124e-06
WA13,3p,23,C>-,14,40,54,5896819,6081454,11978273,4.508162403712121e-06
WA13,3p,24,C>-,38,71,109,5896803,6081440,11978243,9.099832087226816e-06
WA13,3p,25,C>-,108,90,198,5896783,6081437,11978220,1.6530001953545686e-05
WA13,5p,1,C>-,0,0,0,5896847,6081528,11978375,0.0
WA13,5p,2,C>-,0,0,0,5896725,6081443,11978168,0.0
WA13,5p,3,C>-,0,0,0,5896847,6081528,11978375,0.0
WA13,5p,4,C>-,0,0,0,5896841,6081528,11978369,0.0
WA13,5p,5,C>-,0,0,0,5896841,6081528,11978369,0.0
WA13,5p,6,C>-,0,0,0,5896841,6081528,11978369,0.0
WA13,5p,7,C>-,0,0,0,5896845,6081528,11978373,0.0
WA13,5p,8,C>-,0,0,0,5896843,6081526,11978369,0.0
WA13,5p,9,C>-,20,0,20,5896837,6081518,11978355,1.669678348988655e-06
WA13,5p,10,C>-,6,1,7,5896833,6081518,11978351,5.843876172938996e-07
WA13,5p,11,C>-,15,1,16,5896827,6081513,11978340,1.335744351888492e-06
WA13,5p,12,C>-,10,6,16,5896822,6081502,11978324,1.3357461361038488e-06
WA13,5p,13,C>-,21,8,29,5896809,6081508,11978317,2.4210412865179643e-06
WA13,5p,14,C>-,10,5,15,5896802,6081520,11978322,1.2522622116854096e-06
WA13,5p,15,C>-,7,4,11,5896798,6081508,11978306,9.183268485543782e-07
WA13,5p,16,C>-,20,8,28,5896754,6081491,11978245,2.3375711550398245e-06
WA13,5p,17,C>-,24,3,27,5896805,6081514,11978319,2.254072545571712e-06
WA13,5p,18,C>-,13,15,28,5896796,6081504,11978300,2.337560421762688e-06
WA13,5p,19,C>-,19,11,30,5896797,6081472,11978269,2.504535505088423e-06
WA13,5p,20,C>-,25,19,44,5896788,6081482,11978270,3.673318434131139e-06
WA13,5p,21,C>-,25,14,39,5896782,6081484,11978266,3.255896972065907e-06
WA13,5p,22,C>-,37,19,56,5896771,6081483,11978254,4.675138797357278e-06
WA13,5p,23,C>-,38,13,51,5896768,6081501,11978269,4.257710358650319e-06
WA13,5p,24,C>-,77,49,126,5896781,6081498,11978279,1.0519040339601372e-05
WA13,5p,25,C>-,76,66,142,5896769,6081462,11978231,1.1854838999181096e-05
WA14,3p,1,C>-,0,0,0,6684341,7140972,13825313,0.0
WA14,3p,2,C>-,0,0,0,6684341,7140972,13825313,0.0
WA14,3p,3,C>-,0,0,0,6684341,7140972,13825313,0.0
WA14,3p,4,C>-,0,0,0,6684341,7140971,13825312,0.0
WA14,3p,5,C>-,0,0,0,6684341,7140970,13825311,0.0
WA14,3p,6,C>-,0,0,0,6684341,7140971,13825312,0.0
WA14,3p,7,C>-,0,0,0,6684341,7140969,13825310,0.0
WA14,3p,8,C>-,0,2,2,6684326,7140932,13825258,1.446627614472005e-07
WA14,3p,9,C>-,11,17,28,6684323,7140920,13825243,2.0252808576312185e-06
WA14,3p,10,C>-,7,13,20,6684256,7140912,13825168,1.4466370318248574e-06
WA14,3p,11,C>-,11,13,24,6684256,7140894,13825150,1.7359666983721696e-06
WA14,3p,12,C>-,14,22,36,6684291,7140849,13825140,2.6039519310473527e-06
WA14,3p,13,C>-,20,31,51,6684289,7140794,13825083,3.688947111565261e-06
WA14,3p,14,C>-,15,11,26,6684291,7140742,13825033,1.8806465055092452e-06
WA14,3p,15,C>-,14,36,50,6684271,7140702,13824973,3.6166435912750063e-06
WA14,3p,16,C>-,24,37,61,6684263,7140648,13824911,4.412324969035967e-06
WA14,3p,17,C>-,33,46,79,6684212,7140653,13824865,5.7143415143656015e-06
WA14,3p,18,C>-,49,65,114,6684177,7140647,13824824,8.246036260570117e-06
WA14,3p,19,C>-,53,64,117,6684172,7140542,13824714,8.46310455319365e-06
WA14,3p,20,C>-,50,114,164,6684176,7140544,13824720,1.1862808071338876e-05
WA14,3p,21,C>-,42,65,107,6684132,7140443,13824575,7.739840103583655e-06
WA14,3p,22,C>-,86,80,166,6684105,7140560,13824665,1.2007524232956096e-05
WA14,3p,23,C>-,104,104,208,6683638,7140562,13824200,1.5046078615760768e-05
WA14,3p,24,C>-,178,201,379,6683623,7140532,13824155,2.741578056669648e-05
WA14,3p,25,C>-,176,229,405,6683613,7140513,13824126,2.929660797362524e-05
WA14,5p,1,C>-,0,0,0,6684341,7140972,13825313,0.0
WA14,5p,2,C>-,0,0,0,6684184,7140911,13825095,0.0
WA14,5p,3,C>-,1,0,1,6684338,7140972,13825310,7.233110866953437e-08
WA14,5p,4,C>-,0,0,0,6684341,7140972,13825313,0.0
WA14,5p,5,C>-,1,0,1,6684341,7140972,13825313,7.233109297416991e-08
WA14,5p,6,C>-,0,0,0,6684340,7140972,13825312,0.0
WA14,5p,7,C>-,2,0,2,6684336,7140972,13825308,1.4466223826622885e-07
WA14,5p,8,C>-,1,0,1,6684277,7140970,13825247,7.233143827376105e-08
WA14,5p,9,C>-,41,1,42,6684241,7140959,13825200,3.037930735179238e-06
WA14,5p,10,C>-,19,1,20,6684210,7140628,13824838,1.446671563167684e-06
WA14,5p,11,C>-,21,3,24,6684218,7140646,13824864,1.7360026109479268e-06
WA14,5p,12,C>-,32,8,40,6684139,7140917,13825056,2.89329750273706e-06
WA14,5p,13,C>-,55,10,65,6684018,7140931,13824949,4.701644830660858e-06
WA14,5p,14,C>-,76,3,79,6683951,7140942,13824893,5.714329940926125e-06
WA14,5p,15,C>-,95,18,113,6684030,7140908,13824938,8.173635209069292e-06
WA14,5p,16,C>-,129,16,145,6683910,7140868,13824778,1.048841435283807e-05
WA14,5p,17,C>-,125,26,151,6683904,7140873,13824777,1.0922418495430342e-05
WA14,5p,18,C>-,119,15,134,6683891,7140646,13824537,9.692910511216395e-06
WA14,5p,19,C>-,112,32,144,6683958,7140595,13824553,1.0416249986527594e-05
WA14,5p,20,C>-,212,33,245,6683860,7140558,13824418,1.772226505303876e-05
WA14,5p,21,C>-,213,64,277,6683480,7140494,13823974,2.003765342729956e-05
WA14,5p,22,C>-,215,52,267,6683768,7140398,13824166,1.9314004186581676e-05
WA14,5p,23,C>-,169,56,225,6683762,7140257,13824019,1.6276019296559127e-05
WA14,5p,24,C>-,179,136,315,6683714,7140421,13824135,2.2786235811499235e-05
WA14,5p,25,C>-,273,233,506,6683731,7140511,13824242,3.660236850599114e-05
WA18,3p,1,C>-,0,0,0,14112928,14131239,28244167,0.0
WA18,3p,2,C>-,0,0,0,14112928,14131239,28244167,0.0
WA18,3p,3,C>-,0,0,0,14112928,14131239,28244167,0.0
WA18,3p,4,C>-,0,0,0,14112928,14131238,28244166,0.0
WA18,3p,5,C>-,0,0,0,14112928,14131239,28244167,0.0
WA18,3p,6,C>-,0,0,0,14112928,14131239,28244167,0.0
WA18,3p,7,C>-,0,1,1,14112928,14131237,28244165,3.5405543056415375e-08
WA18,3p,8,C>-,0,0,0,14112927,14131187,28244114,0.0
WA18,3p,9,C>-,4,15,19,14112909,14131177,28244086,6.72707199659426e-07
WA18,3p,10,C>-,11,12,23,14112909,14131197,28244106,8.143291913718211e-07
WA18,3p,11,C>-,20,13,33,14112900,14131167,28244067,1.168386974864491e-06
WA18,3p,12,C>-,6,9,15,14112895,14131136,28244031,5.310856654986676e-07
WA18,3p,13,C>-,10,12,22,14112898,14131061,28243959,7.789276283824091e-07
WA18,3p,14,C>-,10,16,26,14112830,14131006,28243836,9.205548424796122e-07
WA18,3p,15,C>-,24,24,48,14112809,14130957,28243766,1.6994900750841795e-06
WA18,3p,16,C>-,15,35,50,14112765,14130927,28243692,1.770306799833393e-06
WA18,3p,17,C>-,21,46,67,14112743,14130850,28243593,2.372219426897987e-06
WA18,3p,18,C>-,26,104,130,14112708,14130769,28243477,4.602832717798874e-06
WA18,3p,19,C>-,31,73,104,14112724,14130771,28243495,3.682263827476026e-06
WA18,3p,20,C>-,48,104,152,14112697,14130797,28243494,5.381770399937061e-06
WA18,3p,21,C>-,39,145,184,14112659,14130783,28243442,6.514786689242763e-06
WA18,3p,22,C>-,46,101,147,14112575,14130715,28243290,5.204776072475976e-06
WA18,3p,23,C>-,40,199,239,14112548,14130648,28243196,8.462215111915805e-06
WA18,3p,24,C>-,84,151,235,14112551,14130690,28243241,8.320574823548048e-06
WA18,3p,25,C>-,120,218,338,14112486,14130651,28243137,1.1967509133280768e-05
WA18,5p,1,C>-,0,0,0,14112926,14131239,28244165,0.0
WA18,5p,2,C>-,0,0,0,14112820,14131183,28244003,0.0
WA18,5p,3,C>-,0,0,0,14112928,14131239,28244167,0.0
WA18,5p,4,C>-,0,0,0,14112928,14131239,28244167,0.0
WA18,5p,5,C>-,0,0,0,14112925,14131239,28244164,0.0
WA18,5p,6,C>-,0,0,0,14112927,14131239,28244166,0.0
WA18,5p,7,C>-,1,0,1,14112921,14131239,28244160,3.540554932417888e-08
WA18,5p,8,C>-,0,0,0,14112828,14131230,28244058,0.0
WA18,5p,9,C>-,16,3,19,14112833,14131230,28244063,6.727077474653699e-07
WA18,5p,10,C>-,14,7,21,14112791,14131213,28244004,7.435206424698141e-07
WA18,5p,11,C>-,11,14,25,14112776,14131211,28243987,8.851441547540721e-07
WA18,5p,12,C>-,17,9,26,14112682,14131223,28243905,9.205525935595662e-07
WA18,5p,13,C>-,18,9,27,14112608,14131206,28243814,9.559615425876972e-07
WA18,5p,14,C>-,39,8,47,14112535,14131179,28243714,1.6640870956277208e-06
WA18,5p,15,C>-,40,37,77,14112545,14131148,28243693,2.7262723752166544e-06
WA18,5p,16,C>-,62,16,78,14112522,14131083,28243605,2.7616871146583447e-06
WA18,5p,17,C>-,194,37,231,14112485,14130990,28243475,8.178880254642887e-06
WA18,5p,18,C>-,94,34,128,14112481,14130987,28243468,4.532021350919087e-06
WA18,5p,19,C>-,182,44,226,14112359,14130867,28243226,8.001918760980066e-06
WA18,5p,20,C>-,98,79,177,14112397,14130866,28243263,6.266981262044686e-06
WA18,5p,21,C>-,96,80,176,14112347,14130679,28243026,6.231626880207525e-06
WA18,5p,22,C>-,83,77,160,14112376,14129592,28241968,5.665327572072881e-06
WA18,5p,23,C>-,87,71,158,14112288,14129275,28241563,5.594591205876247e-06
WA18,5p,24,C>-,160,137,297,14112253,14129481,28241734,1.0516351439327344e-05
WA18,5p,25,C>-,178,118,296,14112273,14130551,28242824,1.0480538348431446e-05
WA22,3p,1,C>-,0,0,0,1513709,1653397,3167106,0.0
WA22,3p,2,C>-,0,0,0,1513709,1653396,3167105,0.0
WA22,3p,3,C>-,0,0,0,1513709,1653396,3167105,0.0
WA22,3p,4,C>-,0,0,0,1513709,1653394,3167103,0.0
WA22,3p,5,C>-,0,0,0,1513709,1653397,3167106,0.0
WA22,3p,6,C>-,0,0,0,1513709,1653397,3167106,0.0
WA22,3p,7,C>-,0,0,0,1513709,1653397,3167106,0.0
WA22,3p,8,C>-,0,0,0,1513709,1653395,3167104,0.0
WA22,3p,9,C>-,0,16,16,1513709,1653397,3167106,5.051930690036898e-06
WA22,3p,10,C>-,0,21,21,1513706,1653396,3167102,6.630667405091469e-06
WA22,3p,11,C>-,4,33,37,1513685,1653390,3167075,1.1682704072369616e-05
WA22,3p,12,C>-,10,34,44,1513662,1653379,3167041,1.389309453208847e-05
WA22,3p,13,C>-,13,15,28,1513689,1653380,3167069,8.840981993129925e-06
WA22,3p,14,C>-,42,15,57,1513686,1653352,3167038,1.799788951064054e-05
WA22,3p,15,C>-,12,49,61,1513677,1653343,3167020,1.926100877165285e-05
WA22,3p,16,C>-,1,19,20,1513637,1653341,3166978,6.31516859289834e-06
WA22,3p,17,C>-,27,26,53,1513671,1653319,3166990,1.6735133360067447e-05
WA22,3p,18,C>-,18,23,41,1513665,1653288,3166953,1.2946197812218877e-05
WA22,3p,19,C>-,40,56,96,1513662,1653275,3166937,3.031320168351944e-05
WA22,3p,20,C>-,13,23,36,1513684,1653304,3166988,1.1367267574111429e-05
WA22,3p,21,C>-,29,43,72,1513677,1653327,3167004,2.2734420291227923e-05
WA22,3p,22,C>-,4,56,60,1513684,1653356,3167040,1.894513488936041e-05
WA22,3p,23,C>-,37,25,62,1513676,1653329,3167005,1.957685573593979e-05
WA22,3p,24,C>-,19,108,127,1513672,1653285,3166957,4.010158647559787e-05
WA22,3p,25,C>-,72,98,170,1513669,1653296,3166965,5.36791533850232e-05
WA22,5p,1,C>-,0,0,0,1513709,1653397,3167106,0.0
WA22,5p,2,C>-,0,0,0,1513674,1653378,3167052,0.0
WA22,5p,3,C>-,0,0,0,1513709,1653397,3167106,0.0
WA22,5p,4,C>-,1,0,1,1513709,1653397,3167106,3.157456681273061e-07
WA22,5p,5,C>-,0,0,0,1513708,1653396,3167104,0.0
WA22,5p,6,C>-,0,0,0,1513704,1653397,3167101,0.0
WA22,5p,7,C>-,0,0,0,1513707,1653397,3167104,0.0
WA22,5p,8,C>-,0,0,0,1513692,1653397,3167089,0.0
WA22,5p,9,C>-,16,0,16,1513700,1653389,3167089,5.051957807311383e-06
WA22,5p,10,C>-,1,0,1,1513705,1653389,3167094,3.157468644757623e-07
WA22,5p,11,C>-,11,0,11,1513699,1653381,3167080,3.473230862497948e-06
WA22,5p,12,C>-,14,0,14,1513692,1653345,3167037,4.420535661566316e-06
WA22,5p,13,C>-,19,11,30,1513697,1653377,3167074,9.472465752300071e-06
WA22,5p,14,C>-,18,3,21,1513677,1653376,3167053,6.630769993429223e-06
WA22,5p,15,C>-,40,5,45,1513695,1653381,3167076,1.4208689655695031e-05
WA22,5p,16,C>-,30,13,43,1513668,1653368,3167036,1.3577363819040896e-05
WA22,5p,17,C>-,12,16,28,1513675,1653395,3167070,8.840979201596428e-06
WA22,5p,18,C>-,28,28,56,1513651,1653392,3167043,1.768210914723924e-05
WA22,5p,19,C>-,42,18,60,1513674,1653350,3167024,1.894523060134688e-05
WA22,5p,20,C>-,36,43,79,1513678,1653356,3167034,2.494447486196864e-05
WA22,5p,21,C>-,29,20,49,1513690,1653371,3167061,1.547175756955739e-05
WA22,5p,22,C>-,31,18,49,1513691,1653380,3167071,1.5471708717613213e-05
WA22,5p,23,C>-,26,8,34,1513634,1653393,3167027,1.073562050465626e-05
WA22,5p,24,C>-,40,18,58,1513632,1653375,3167007,1.831382121984574e-05
WA22,5p,25,C>-,91,39,130,1513644,1653364,3167008,4.104820701431761e-05
WA25,3p,1,C>-,0,0,0,3375244,3569089,6944333,0.0
WA25,3p,2,C>-,0,0,0,3375244,3569089,6944333,0.0
WA25,3p,3,C>-,0,0,0,3375244,3569089,6944333,0.0
WA25,3p,4,C>-,0,0,0,3375244,3569087,6944331,0.0
WA25,3p,5,C>-,0,0,0,3375244,3569089,6944333,0.0
WA25,3p,6,C>-,0,0,0,3375244,3569089,6944333,0.0
WA25,3p,7,C>-,0,0,0,3375244,3569089,6944333,0.0
WA25,3p,8,C>-,0,0,0,3375239,3569076,6944315,0.0
WA25,3p,9,C>-,1,8,9,3375240,3569076,6944316,1.2960239712593725e-06
WA25,3p,10,C>-,2,2,4,3375240,3569075,6944315,5.760107368401347e-07
WA25,3p,11,C>-,7,6,13,3375233,3569054,6944287,1.8720424429462665e-06
WA25,3p,12,C>-,4,10,14,3375226,3569069,6944295,2.0160433852536508e-06
WA25,3p,13,C>-,5,8,13,3375230,3569053,6944283,1.8720435212677823e-06
WA25,3p,14,C>-,6,16,22,3375223,3569037,6944260,3.168084144314873e-06
WA25,3p,15,C>-,6,16,22,3375218,3569039,6944257,3.168085512964166e-06
WA25,3p,16,C>-,22,21,43,3375196,3569030,6944226,6.192194781679052e-06
WA25,3p,17,C>-,11,22,33,3375198,3569022,6944220,4.752153589604016e-06
WA25,3p,18,C>-,7,28,35,3375213,3569006,6944219,5.040163623871885e-06
WA25,3p,19,C>-,28,36,64,3375204,3569005,6944209,9.216312469857978e-06
WA25,3p,20,C>-,27,30,57,3375190,3568979,6944169,8.208325575025608e-06
WA25,3p,21,C>-,11,22,33,3375199,3568998,6944197,4.7521693292975415e-06
WA25,3p,22,C>-,20,27,47,3375179,3568994,6944173,6.768264557925041e-06
WA25,3p,23,C>-,30,50,80,3375175,3568972,6944147,1.152049344577527e-05
WA25,3p,24,C>-,37,58,95,3375177,3568962,6944139,1.3680601727586386e-05
WA25,3p,25,C>-,63,77,140,3375156,3568970,6944126,2.016092449935384e-05
WA25,5p,1,C>-,0,0,0,3375244,3569089,6944333,0.0
WA25,5p,2,C>-,0,0,0,3375147,3569045,6944192,0.0
WA25,5p,3,C>-,0,0,0,3375243,3569089,6944332,0.0
WA25,5p,4,C>-,0,0,0,3375243,3569089,6944332,0.0
WA25,5p,5,C>-,3,0,3,3375244,3569088,6944332,4.3200699505726405e-07
WA25,5p,6,C>-,3,0,3,3375244,3569089,6944333,4.320069328472583e-07
WA25,5p,7,C>-,3,0,3,3375242,3569089,6944331,4.320070572672876e-07
WA25,5p,8,C>-,3,0,3,3375221,3569088,6944309,4.320084258923386e-07
WA25,5p,9,C>-,10,1,11,3375227,3569087,6944314,1.584029754414907e-06
WA25,5p,10,C>-,16,5,21,3375217,3569085,6944302,3.02406202956035e-06
WA25,5p,11,C>-,9,3,12,3375193,3569088,6944281,1.7280406711652365e-06
WA25,5p,12,C>-,17,2,19,3375142,3569084,6944226,2.7360860663233023e-06
WA25,5p,13,C>-,18,4,22,3375133,3569081,6944214,3.1681051304006474e-06
WA25,5p,14,C>-,56,4,60,3375151,3569071,6944222,8.640276765345348e-06
WA25,5p,15,C>-,15,3,18,3375137,3569055,6944192,2.5920942278093693e-06
WA25,5p,16,C>-,29,3,32,3375081,3569035,6944116,4.608217950276176e-06
WA25,5p,17,C>-,44,8,52,3375076,3568871,6943947,7.488536418840754e-06
WA25,5p,18,C>-,17,6,23,3375102,3568996,6944098,3.312165237299358e-06
WA25,5p,19,C>-,48,7,55,3375134,3569021,6944155,7.920330119359375e-06
WA25,5p,20,C>-,38,10,48,3375145,3569019,6944164,6.912279145481011e-06
WA25,5p,21,C>-,51,14,65,3375130,3569013,6944143,9.360406316517389e-06
WA25,5p,22,C>-,35,22,57,3375139,3569001,6944140,8.208359854496021e-06
WA25,5p,23,C>-,45,19,64,3375144,3569002,6944146,9.2163960838381e-06
WA25,5p,24,C>-,93,34,127,3375124,3568967,6944091,1.82889308334237e-05
WA25,5p,25,C>-,78,50,128,3375125,3568950,6944075,1.843298063456976e-05
WA26,3p,1,C>-,0,0,0,2709623,2900126,5609749,0.0
WA26,3p,2,C>-,0,0,0,2709623,2900126,5609749,0.0
WA26,3p,3,C>-,0,0,0,2709623,2900126,5609749,0.0
WA26,3p,4,C>-,0,0,0,2709623,2900126,5609749,0.0
WA26,3p,5,C>-,0,0,0,2709623,2900126,5609749,0.0
WA26,3p,6,C>-,0,0,0,2709623,2900126,5609749,0.0
WA26,3p,7,C>-,0,0,0,2709623,2900126,5609749,0.0
WA26,3p,8,C>-,0,3,3,2709619,2900114,5609733,5.34784810613981e-07
WA26,3p,9,C>-,14,42,56,2709613,2900111,5609724,9.982665813861788e-06
WA26,3p,10,C>-,12,24,36,2709609,2900074,5609683,6.417474926836329e-06
WA26,3p,11,C>-,24,17,41,2709594,2900076,5609670,7.308807826485337e-06
WA26,3p,12,C>-,23,35,58,2709607,2900081,5609688,1.0339255944359116e-05
WA26,3p,13,C>-,36,31,67,2709604,2900084,5609688,1.1943623246070012e-05
WA26,3p,14,C>-,37,33,70,2709584,2900069,5609653,1.2478490202513418e-05
WA26,3p,15,C>-,38,54,92,2709593,2900082,5609675,1.6400237090384023e-05
WA26,3p,16,C>-,41,44,85,2709580,2900075,5609655,1.5152446986490256e-05
WA26,3p,17,C>-,50,37,87,2709570,2900078,5609648,1.550899450375496e-05
WA26,3p,18,C>-,54,43,97,2709582,2900059,5609641,1.7291659127562708e-05
WA26,3p,19,C>-,28,49,77,2709567,2900016,5609583,1.372651050889166e-05
WA26,3p,20,C>-,83,71,154,2709563,2899983,5609546,2.7453202095142812e-05
WA26,3p,21,C>-,71,60,131,2709562,2900021,5609583,2.3352894502140357e-05
WA26,3p,22,C>-,52,65,117,2709522,2900007,5609529,2.0857366099720672e-05
WA26,3p,23,C>-,97,67,164,2709541,2899974,5609515,2.9236039122811865e-05
WA26,3p,24,C>-,83,107,190,2709558,2899951,5609509,3.387105716382664e-05
WA26,3p,25,C>-,181,159,340,2709500,2900002,5609502,6.061144108692715e-05
WA26,5p,1,C>-,0,0,0,2709622,2900126,5609748,0.0
WA26,5p,2,C>-,0,0,0,2709554,2900092,5609646,0.0
WA26,5p,3,C>-,0,0,0,2709623,2900126,5609749,0.0
WA26,5p,4,C>-,0,0,0,2709623,2900126,5609749,0.0
WA26,5p,5,C>-,0,0,0,2709623,2900125,5609748,0.0
WA26,5p,6,C>-,0,0,0,2709621,2900126,5609747,0.0
WA26,5p,7,C>-,3,0,3,2709622,2900126,5609748,5.347833806438364e-07
WA26,5p,8,C>-,1,0,1,2709609,2900124,5609733,1.782616035379937e-07
WA26,5p,9,C>-,28,0,28,2709594,2900123,5609717,4.9913391352897125e-06
WA26,5p,10,C>-,29,0,29,2709601,2900123,5609724,5.16959479646414e-06
WA26,5p,11,C>-,23,14,37,2709605,2900103,5609708,6.595708724946111e-06
WA26,5p,12,C>-,33,0,33,2709595,2900107,5609702,5.882665425008316e-06
WA26,5p,13,C>-,28,10,38,2709592,2900104,5609696,6.773985613480659e-06
WA26,5p,14,C>-,33,13,46,2709563,2900089,5609652,8.200152166301938e-06
WA26,5p,15,C>-,45,9,54,2709545,2900085,5609630,9.626303339079404e-06
WA26,5p,16,C>-,34,22,56,2709540,2900076,5609616,9.982858006679958e-06
WA26,5p,17,C>-,68,32,100,2709554,2900055,5609609,1.7826554399780805e-05
WA26,5p,18,C>-,56,36,92,2709554,2900082,5609636,1.6400351110125507e-05
WA26,5p,19,C>-,65,31,96,2709570,2900086,5609656,1.7113348839928864e-05
WA26,5p,20,C>-,68,35,103,2709563,2900082,5609645,1.8361233197466148e-05
WA26,5p,21,C>-,65,41,106,2709545,2900061,5609606,1.8896157769369187e-05
WA26,5p,22,C>-,58,37,95,2709542,2900059,5609601,1.6935250831565384e-05
WA26,5p,23,C>-,92,29,121,2709528,2900065,5609593,2.157019234728794e-05
WA26,5p,24,C>-,118,76,194,2709495,2900057,5609552,3.4583866946950485e-05
WA26,5p,25,C>-,142,153,295,2709506,2900041,5609547,5.258891671644787e-05
