Sample,End,Position,Substitution,Pos_Count,Neg_Count,Combined_Count,Pos_Total,Neg_Total,Combined_Total,Frequency
DAL192,3p,1,C>T,24,8,32,6350003,6167708,12517711,2.5563779192537675e-06
DAL192,3p,2,C>T,71,114,185,6350003,6167706,12517709,1.4779062206990114e-05
DAL192,3p,3,C>T,73,120,193,6350003,6167708,12517711,1.5418154325499286e-05
DAL192,3p,4,C>T,111,184,295,6350003,6167708,12517711,2.356660894312067e-05
DAL192,3p,5,C>T,395,425,820,6350003,6167708,12517711,6.550718418087779e-05
DAL192,3p,6,C>T,426,609,1035,6350003,6167708,12517711,8.268284832586406e-05
DAL192,3p,7,C>T,518,498,1016,6350003,6167708,12517711,8.116499893630712e-05
DAL192,3p,8,C>T,593,697,1290,6350003,6167618,12517621,0.0001030547258141
DAL192,3p,9,C>T,1847,536,2383,6350003,6167637,12517640,0.0001903713479537
DAL192,3p,10,C>T,607,630,1237,6350003,6167645,12517648,9.882048129169314e-05
DAL192,3p,11,C>T,792,610,1402,6349987,6167644,12517631,0.000112002023386
DAL192,3p,12,C>T,886,813,1699,6349997,6167646,12517643,0.0001357284274683
DAL192,3p,13,C>T,613,643,1256,6349992,6167621,12517613,0.0001003386188724
DAL192,3p,14,C>T,740,711,1451,6349967,6167610,12517577,0.0001159170021482
DAL192,3p,15,C>T,712,831,1543,6349968,6167615,12517583,0.0001232666082581
DAL192,3p,16,C>T,924,823,1747,6349943,6167587,12517530,0.0001395642750606
DAL192,3p,17,C>T,767,603,1370,6349922,6167606,12517528,0.0001094465296981
DAL192,3p,18,C>T,896,704,1600,6349922,6167564,12517486,0.0001278211934888
DAL192,3p,19,C>T,846,600,1446,6349921,6167519,12517440,0.0001155188281309
DAL192,3p,20,C>T,929,673,1602,6349910,6167516,12517426,0.0001279815834341
DAL192,3p,21,C>T,1015,1011,2026,6349882,6167507,12517389,0.0001618548404942
DAL192,3p,22,C>T,915,773,1688,6349894,6167488,12517382,0.000134852479536
DAL192,3p,23,C>T,801,632,1433,6349902,6167465,12517367,0.0001144809447545
DAL192,3p,24,C>T,910,880,1790,6349899,6167465,12517364,0.0001430013539591
DAL192,3p,25,C>T,761,749,1510,6349856,6167384,12517240,0.0001206336221083
DAL192,5p,1,C>T,5,6,11,6350003,6167708,12517711,8.787549097434826e-07
DAL192,5p,2,C>T,73,105,178,6349992,6167694,12517686,1.4219880575371518e-05
DAL192,5p,3,C>T,40,75,115,6350003,6167707,12517710,9.186983881237065e-06
DAL192,5p,4,C>T,142,125,267,6350003,6167708,12517711,2.1329778263773626e-05
DAL192,5p,5,C>T,512,427,939,6350003,6167707,12517710,7.501372056070959e-05
DAL192,5p,6,C>T,517,406,923,6350002,6167707,12517709,7.373553738946959e-05
DAL192,5p,7,C>T,887,642,1529,6350002,6167708,12517710,0.0001221469422122
DAL192,5p,8,C>T,655,594,1249,6349926,6167708,12517634,9.97792394313494e-05
DAL192,5p,9,C>T,839,514,1353,6349914,6167708,12517622,0.0001080876223934
DAL192,5p,10,C>T,762,556,1318,6349896,6167708,12517604,0.0001052917155711
DAL192,5p,11,C>T,527,447,974,6349942,6167706,12517648,7.781014452555304e-05
DAL192,5p,12,C>T,841,673,1514,6349906,6167700,12517606,0.0001209496448442
DAL192,5p,13,C>T,1015,794,1809,6349906,6167705,12517611,0.0001445163937431
DAL192,5p,14,C>T,847,713,1560,6349889,6167679,12517568,0.0001246248472546
DAL192,5p,15,C>T,1494,603,2097,6349890,6167649,12517539,0.0001675249424028
DAL192,5p,16,C>T,721,618,1339,6349904,6167639,12517543,0.0001069698741997
DAL192,5p,17,C>T,760,719,1479,6349778,6167623,12517401,0.0001181555180664
DAL192,5p,18,C>T,1068,799,1867,6349859,6167631,12517490,0.0001491513074905
DAL192,5p,19,C>T,890,621,1511,6349822,6167638,12517460,0.0001207113903299
DAL192,5p,20,C>T,750,551,1301,6349836,6167621,12517457,0.0001039348487476
DAL192,5p,21,C>T,1206,903,2109,6349784,6167624,12517408,0.0001684853605474
DAL192,5p,22,C>T,910,695,1605,6349783,6167584,12517367,0.0001282218536853
DAL192,5p,23,C>T,616,674,1290,6349801,6167567,12517368,0.0001030568087476
DAL192,5p,24,C>T,796,748,1544,6349759,6167564,12517323,0.0001233490579415
DAL192,5p,25,C>T,954,797,1751,6349777,6167551,12517328,0.0001398860843144
DAL193,3p,1,C>T,51,17,68,6484405,6362696,12847101,5.293022916220554e-06
DAL193,3p,2,C>T,222,331,553,6484402,6362696,12847098,4.3044740532064126e-05
DAL193,3p,3,C>T,331,300,631,6484405,6362696,12847101,4.911613911963485e-05
DAL193,3p,4,C>T,828,634,1462,6484405,6362696,12847101,0.0001137999926987
DAL193,3p,5,C>T,3171,3159,6330,6484405,6362696,12847101,0.0004927181626422
DAL193,3p,6,C>T,3598,2993,6591,6484405,6362696,12847101,0.0005130340300119
DAL193,3p,7,C>T,3574,3097,6671,6484405,6362696,12847101,0.0005192611157956
DAL193,3p,8,C>T,3889,3757,7646,6484400,6362644,12847044,0.0005951563643745
DAL193,3p,9,C>T,4381,5409,9790,6484400,6362631,12847031,0.0007620437749391
DAL193,3p,10,C>T,3915,3667,7582,6484393,6362640,12847033,0.0005901751789693
DAL193,3p,11,C>T,3903,3410,7313,6484398,6362639,12847037,0.0005692363149572
DAL193,3p,12,C>T,4163,4235,8398,6484368,6362594,12846962,0.0006536954028508
DAL193,3p,13,C>T,3863,3036,6899,6484385,6362543,12846928,0.0005370155417699
DAL193,3p,14,C>T,4072,3233,7305,6484363,6362486,12846849,0.0005686219243333
DAL193,3p,15,C>T,4571,4256,8827,6484332,6362438,12846770,0.0006870987804716
DAL193,3p,16,C>T,4063,3621,7684,6484341,6362460,12846801,0.0005981255567047
DAL193,3p,17,C>T,4303,3566,7869,6484294,6362445,12846739,0.0006125289849821
DAL193,3p,18,C>T,4837,4109,8946,6484244,6362380,12846624,0.0006963697232829
DAL193,3p,19,C>T,4436,3249,7685,6484265,6362400,12846665,0.0005982097299182
DAL193,3p,20,C>T,4107,3654,7761,6484261,6362382,12846643,0.0006041266967564
DAL193,3p,21,C>T,4901,4819,9720,6484248,6362443,12846691,0.0007566150692034
DAL193,3p,22,C>T,4114,4026,8140,6484224,6362407,12846631,0.0006336291592714
DAL193,3p,23,C>T,4159,4098,8257,6484218,6362399,12846617,0.0006427373058603
DAL193,3p,24,C>T,4613,4699,9312,6484164,6362319,12846483,0.0007248676544389
DAL193,3p,25,C>T,4031,4060,8091,6484128,6362355,12846483,0.000629822185574
DAL193,5p,1,C>T,50,80,130,6484405,6362696,12847101,1.0119014398656942e-05
DAL193,5p,2,C>T,219,365,584,6484386,6362681,12847067,4.545784652637057e-05
DAL193,5p,3,C>T,185,216,401,6484400,6362696,12847096,3.121327963922742e-05
DAL193,5p,4,C>T,440,419,859,6484403,6362696,12847099,6.686334401252765e-05
DAL193,5p,5,C>T,2513,2402,4915,6484403,6362696,12847099,0.0003825766423999
DAL193,5p,6,C>T,3017,2622,5639,6484404,6362696,12847100,0.0004389317433506
DAL193,5p,7,C>T,6192,5150,11342,6484404,6362696,12847100,0.000882845155716
DAL193,5p,8,C>T,4229,3572,7801,6484314,6362693,12847007,0.0006072231454376
DAL193,5p,9,C>T,5159,4286,9445,6484295,6362695,12846990,0.0007351916674645
DAL193,5p,10,C>T,4458,3576,8034,6484284,6362694,12846978,0.0006253610771342
DAL193,5p,11,C>T,3858,3389,7247,6484315,6362677,12846992,0.0005641009194992
DAL193,5p,12,C>T,5494,4634,10128,6484218,6362670,12846888,0.0007883621309689
DAL193,5p,13,C>T,4880,4052,8932,6484143,6362652,12846795,0.0006952706881366
DAL193,5p,14,C>T,4955,4703,9658,6484145,6362627,12846772,0.0007517841836065
DAL193,5p,15,C>T,6328,7741,14069,6484166,6362534,12846700,0.0010951450567071
DAL193,5p,16,C>T,4846,5063,9909,6484111,6362519,12846630,0.0007713306913953
DAL193,5p,17,C>T,5000,4064,9064,6484043,6362598,12846641,0.0007055540821916
DAL193,5p,18,C>T,4831,4841,9672,6483967,6362571,12846538,0.0007528876651437
DAL193,5p,19,C>T,4674,4457,9131,6483980,6362593,12846573,0.0007107732155493
DAL193,5p,20,C>T,4336,3868,8204,6483952,6362554,12846506,0.000638617224014
DAL193,5p,21,C>T,5163,4150,9313,6484003,6362532,12846535,0.0007249425623329
DAL193,5p,22,C>T,5375,3963,9338,6484010,6362499,12846509,0.0007268900835238
DAL193,5p,23,C>T,4474,4357,8831,6483966,6362463,12846429,0.0006874283896326
DAL193,5p,24,C>T,5109,4667,9776,6483905,6362426,12846331,0.0007609954935771
DAL193,5p,25,C>T,5243,4683,9926,6483942,6362403,12846345,0.0007726711371989
DAL195,3p,1,C>T,19,4,23,2363278,2267461,4630739,4.966809833160539e-06
DAL195,3p,2,C>T,26,45,71,2363278,2267460,4630738,1.5332329317702707e-05
DAL195,3p,3,C>T,55,62,117,2363278,2267461,4630739,2.5265945673034045e-05
DAL195,3p,4,C>T,140,97,237,2363278,2267461,4630739,5.117973610691511e-05
DAL195,3p,5,C>T,464,679,1143,2363278,2267461,4630739,0.0002468288538827
DAL195,3p,6,C>T,601,646,1247,2363278,2267461,4630739,0.0002692874722587
DAL195,3p,7,C>T,530,634,1164,2363278,2267461,4630739,0.0002513637672086
DAL195,3p,8,C>T,757,735,1492,2363278,2267413,4630691,0.0003221981341445
DAL195,3p,9,C>T,880,1002,1882,2363276,2267438,4630714,0.0004064168074296
DAL195,3p,10,C>T,784,676,1460,2363274,2267432,4630706,0.000315286697104
DAL195,3p,11,C>T,873,680,1553,2363274,2267431,4630705,0.0003353701002331
DAL195,3p,12,C>T,803,752,1555,2363273,2267414,4630687,0.0003358033052115
DAL195,3p,13,C>T,738,750,1488,2363269,2267412,4630681,0.0003213350261009
DAL195,3p,14,C>T,882,767,1649,2363250,2267410,4630660,0.0003561047453278
DAL195,3p,15,C>T,963,861,1824,2363254,2267411,4630665,0.0003938959091188
DAL195,3p,16,C>T,1015,668,1683,2363259,2267394,4630653,0.0003634476606215
DAL195,3p,17,C>T,959,711,1670,2363234,2267398,4630632,0.0003606419166973
DAL195,3p,18,C>T,893,959,1852,2363236,2267374,4630610,0.0003999473071582
DAL195,3p,19,C>T,738,664,1402,2363215,2267369,4630584,0.0003027695858664
DAL195,3p,20,C>T,881,811,1692,2363222,2267380,4630602,0.0003653952553037
DAL195,3p,21,C>T,1003,1107,2110,2363235,2267382,4630617,0.000455662819879
DAL195,3p,22,C>T,747,713,1460,2363231,2267383,4630614,0.0003152929611494
DAL195,3p,23,C>T,910,771,1681,2363219,2267370,4630589,0.0003630207733832
DAL195,3p,24,C>T,875,678,1553,2363198,2267373,4630571,0.0003353798052119
DAL195,3p,25,C>T,817,808,1625,2363180,2267377,4630557,0.000350929704569
DAL195,5p,1,C>T,3,31,34,2363278,2267461,4630739,7.34224062293297e-06
DAL195,5p,2,C>T,37,56,93,2363264,2267447,4630711,2.008330902101211e-05
DAL195,5p,3,C>T,14,60,74,2363278,2267459,4630737,1.5980177669342915e-05
DAL195,5p,4,C>T,67,96,163,2363278,2267461,4630739,3.519956533935512e-05
DAL195,5p,5,C>T,407,742,1149,2363277,2267461,4630738,0.0002481245969864
DAL195,5p,6,C>T,551,983,1534,2363277,2267461,4630738,0.0003312646925824
DAL195,5p,7,C>T,1004,1628,2632,2363277,2267461,4630738,0.0005683759262562
DAL195,5p,8,C>T,711,820,1531,2363212,2267460,4630672,0.0003306215598945
DAL195,5p,9,C>T,994,1438,2432,2363181,2267461,4630642,0.0005251971540879
DAL195,5p,10,C>T,686,824,1510,2363146,2267458,4630604,0.000326091369506
DAL195,5p,11,C>T,595,585,1180,2362948,2267450,4630398,0.0002548377050957
DAL195,5p,12,C>T,872,876,1748,2362864,2267454,4630318,0.0003775118685152
DAL195,5p,13,C>T,666,858,1524,2363073,2267445,4630518,0.0003291208456591
DAL195,5p,14,C>T,879,1160,2039,2363094,2267434,4630528,0.0004403385531844
DAL195,5p,15,C>T,767,1071,1838,2363178,2267432,4630610,0.0003969239473849
DAL195,5p,16,C>T,717,779,1496,2363170,2267429,4630599,0.0003230683546556
DAL195,5p,17,C>T,886,857,1743,2363159,2267431,4630590,0.0003764099175267
DAL195,5p,18,C>T,801,859,1660,2363182,2267420,4630602,0.00035848470674
DAL195,5p,19,C>T,747,1017,1764,2363138,2267420,4630558,0.0003809476093377
DAL195,5p,20,C>T,694,896,1590,2363110,2267401,4630511,0.0003433746297114
DAL195,5p,21,C>T,840,1184,2024,2363086,2267400,4630486,0.0004371031464083
DAL195,5p,22,C>T,896,836,1732,2363094,2267388,4630482,0.0003740431341704
DAL195,5p,23,C>T,711,818,1529,2363068,2267398,4630466,0.0003302043466035
DAL195,5p,24,C>T,968,1229,2197,2363067,2267402,4630469,0.0004744659774204
DAL195,5p,25,C>T,876,880,1756,2363135,2267374,4630509,0.0003792239686824
DAL212,3p,1,C>T,32,10,42,4131322,4008153,8139475,5.160037963136443e-06
DAL212,3p,2,C>T,47,84,131,4131322,4008153,8139475,1.609440412311605e-05
DAL212,3p,3,C>T,55,96,151,4131322,4008153,8139475,1.8551565057942927e-05
DAL212,3p,4,C>T,181,197,378,4131322,4008153,8139475,4.644034166822799e-05
DAL212,3p,5,C>T,1152,1150,2302,4131322,4008151,8139473,0.0002828192930918
DAL212,3p,6,C>T,1178,1239,2417,4131322,4008151,8139473,0.0002969479719387
DAL212,3p,7,C>T,1262,1071,2333,4131322,4008153,8139475,0.0002866278230475
DAL212,3p,8,C>T,1252,1176,2428,4131319,4008093,8139412,0.0002983016463597
DAL212,3p,9,C>T,1801,1384,3185,4131316,4008115,8139431,0.0003913049941697
DAL212,3p,10,C>T,1563,1297,2860,4131317,4008102,8139419,0.0003513764311678
DAL212,3p,11,C>T,1521,1238,2759,4131313,4008105,8139418,0.0003389677247193
DAL212,3p,12,C>T,1682,1360,3042,4131314,4008034,8139348,0.000373740009642
DAL212,3p,13,C>T,1572,1151,2723,4131307,4007923,8139230,0.0003345525313819
DAL212,3p,14,C>T,1551,1319,2870,4131271,4007904,8139175,0.0003526155906464
DAL212,3p,15,C>T,1674,1363,3037,4131254,4007935,8139189,0.0003731329988774
DAL212,3p,16,C>T,1601,1149,2750,4131236,4007982,8139218,0.0003378702966304
DAL212,3p,17,C>T,1477,1267,2744,4131249,4007981,8139230,0.000337132628025
DAL212,3p,18,C>T,1793,1317,3110,4131222,4007954,8139176,0.0003821025617335
DAL212,3p,19,C>T,1598,1358,2956,4131233,4007956,8139189,0.0003631811474091
DAL212,3p,20,C>T,1544,1198,2742,4131221,4007928,8139149,0.0003368902572001
DAL212,3p,21,C>T,1882,1482,3364,4131228,4007917,8139145,0.0004133112261791
DAL212,3p,22,C>T,1680,1355,3035,4131183,4007898,8139081,0.0003728922221071
DAL212,3p,23,C>T,1368,1347,2715,4131172,4007904,8139076,0.000333575948916
DAL212,3p,24,C>T,1772,1456,3228,4131124,4007904,8139028,0.000396607555595
DAL212,3p,25,C>T,1484,1355,2839,4131071,4007924,8138995,0.0003488145649432
DAL212,5p,1,C>T,11,12,23,4131322,4008153,8139475,2.8257350750509094e-06
DAL212,5p,2,C>T,68,137,205,4131307,4008143,8139450,2.51859769394738e-05
DAL212,5p,3,C>T,66,44,110,4131321,4008153,8139474,1.3514386801898992e-05
DAL212,5p,4,C>T,127,188,315,4131322,4008153,8139475,3.870028472352332e-05
DAL212,5p,5,C>T,925,987,1912,4131322,4008153,8139475,0.0002349045853694
DAL212,5p,6,C>T,910,1021,1931,4131322,4008153,8139475,0.0002372388882575
DAL212,5p,7,C>T,1985,1844,3829,4131322,4008153,8139475,0.0004704234609726
DAL212,5p,8,C>T,1519,1244,2763,4131248,4008153,8139401,0.0003394598693441
DAL212,5p,9,C>T,1619,1535,3154,4131243,4008153,8139396,0.0003874980403951
DAL212,5p,10,C>T,1504,1679,3183,4131179,4008148,8139327,0.0003910642734958
DAL212,5p,11,C>T,1058,987,2045,4131234,4008143,8139377,0.0002512477306309
DAL212,5p,12,C>T,1608,1340,2948,4131187,4008141,8139328,0.0003621920630302
DAL212,5p,13,C>T,2039,1361,3400,4131181,4008142,8139323,0.0004177251596969
DAL212,5p,14,C>T,1616,1210,2826,4131134,4008108,8139242,0.0003472067792062
DAL212,5p,15,C>T,1788,1585,3373,4131156,4008091,8139247,0.0004144118000104
DAL212,5p,16,C>T,1876,1548,3424,4131154,4008081,8139235,0.0004206783561354
DAL212,5p,17,C>T,1753,1353,3106,4131159,4008081,8139240,0.0003816081108309
DAL212,5p,18,C>T,1769,1527,3296,4131113,4008066,8139179,0.0004049548486401
DAL212,5p,19,C>T,1714,1505,3219,4131040,4008052,8139092,0.0003954986625043
DAL212,5p,20,C>T,1651,1732,3383,4131020,4008040,8139060,0.0004156499644922
DAL212,5p,21,C>T,1844,1424,3268,4130973,4008040,8139013,0.0004015228873574
DAL212,5p,22,C>T,1768,1358,3126,4131015,4007967,8138982,0.0003840775173111
DAL212,5p,23,C>T,1573,1354,2927,4131005,4007962,8138967,0.000359627947871
DAL212,5p,24,C>T,1790,1258,3048,4131060,4007918,8138978,0.0003744941932512
DAL212,5p,25,C>T,1572,1310,2882,4131016,4007614,8138630,0.0003541136530349
DAL218,3p,1,C>T,55,17,72,6952891,6658031,13610922,5.289869415165263e-06
DAL218,3p,2,C>T,116,92,208,6952891,6658031,13610922,1.528184497714409e-05
DAL218,3p,3,C>T,212,476,688,6952891,6658030,13610921,5.054764479200195e-05
DAL218,3p,4,C>T,399,359,758,6952891,6658031,13610922,5.569056967632317e-05
DAL218,3p,5,C>T,3124,2693,5817,6952891,6658031,13610922,0.0004273773665002
DAL218,3p,6,C>T,3299,3062,6361,6952891,6658030,13610921,0.0004673453030841
DAL218,3p,7,C>T,2924,3477,6401,6952891,6658026,13610917,0.0004702842578497
DAL218,3p,8,C>T,3325,2549,5874,6952887,6657945,13610832,0.0004315680334604
DAL218,3p,9,C>T,4444,3499,7943,6952882,6657945,13610827,0.0005835795282681
DAL218,3p,10,C>T,3932,3801,7733,6952881,6657960,13610841,0.0005681500503899
DAL218,3p,11,C>T,3169,3507,6676,6952866,6657905,13610771,0.0004904938889942
DAL218,3p,12,C>T,4196,3871,8067,6952858,6657882,13610740,0.0005926937109958
DAL218,3p,13,C>T,3698,3452,7150,6952870,6657811,13610681,0.000525322722647
DAL218,3p,14,C>T,3315,3299,6614,6952816,6657779,13610595,0.0004859449568516
DAL218,3p,15,C>T,4023,3520,7543,6952788,6657738,13610526,0.0005542034157974
DAL218,3p,16,C>T,3766,3206,6972,6952760,6657689,13610449,0.0005122534899473
DAL218,3p,17,C>T,3900,3390,7290,6952737,6657651,13610388,0.0005356202923825
DAL218,3p,18,C>T,4236,4414,8650,6952711,6657672,13610383,0.0006355442018053
DAL218,3p,19,C>T,3741,3179,6920,6952716,6657697,13610413,0.0005084342407537
DAL218,3p,20,C>T,3701,3207,6908,6952697,6657752,13610449,0.0005075512203895
DAL218,3p,21,C>T,4224,3599,7823,6952660,6657692,13610352,0.0005747830768814
DAL218,3p,22,C>T,3992,3353,7345,6952654,6657637,13610291,0.0005396651695397
DAL218,3p,23,C>T,4165,4239,8404,6952651,6657632,13610283,0.0006174743023344
DAL218,3p,24,C>T,4982,4284,9266,6952669,6657588,13610257,0.0006808100684652
DAL218,3p,25,C>T,4458,3908,8366,6952605,6657566,13610171,0.0006146873540383
DAL218,5p,1,C>T,44,80,124,6952891,6658031,13610922,9.110330659451284e-06
DAL218,5p,2,C>T,326,245,571,6952874,6658014,13610888,4.195170807371275e-05
DAL218,5p,3,C>T,240,238,478,6952891,6658031,13610922,3.5118855284013824e-05
DAL218,5p,4,C>T,491,260,751,6952891,6658031,13610922,5.517627681651544e-05
DAL218,5p,5,C>T,2704,2420,5124,6952891,6658031,13610922,0.0003764623733792
DAL218,5p,6,C>T,2993,2683,5676,6952891,6658031,13610922,0.0004170180388955
DAL218,5p,7,C>T,6666,4304,10970,6952888,6658031,13610919,0.0008059705593722
DAL218,5p,8,C>T,3461,3628,7089,6952719,6658029,13610748,0.0005208383844884
DAL218,5p,9,C>T,5702,3344,9046,6952736,6658029,13610765,0.0006646209819947
DAL218,5p,10,C>T,4198,2870,7068,6952716,6658028,13610744,0.0005192956387982
DAL218,5p,11,C>T,3716,2301,6017,6952715,6658016,13610731,0.0004420776518175
DAL218,5p,12,C>T,5201,4147,9348,6952625,6658005,13610630,0.0006868161135818
DAL218,5p,13,C>T,4938,3682,8620,6952475,6658005,13610480,0.0006333354885353
DAL218,5p,14,C>T,4445,3398,7843,6952554,6657955,13610509,0.0005762458994002
DAL218,5p,15,C>T,5112,3442,8554,6952449,6657923,13610372,0.0006284912712158
DAL218,5p,16,C>T,5454,4436,9890,6952253,6657920,13610173,0.0007266623282452
DAL218,5p,17,C>T,4044,3466,7510,6952350,6657874,13610224,0.000551791065305
DAL218,5p,18,C>T,5210,3615,8825,6952457,6657843,13610300,0.0006484059866424
DAL218,5p,19,C>T,4844,3526,8370,6952296,6657770,13610066,0.0006149859963941
DAL218,5p,20,C>T,4282,3277,7559,6952289,6657772,13610061,0.0005553979515595
DAL218,5p,21,C>T,4247,3563,7810,6952371,6657729,13610100,0.0005738385463736
DAL218,5p,22,C>T,4521,3472,7993,6952322,6657786,13610108,0.000587284097966
DAL218,5p,23,C>T,3875,3438,7313,6952288,6657745,13610033,0.0005373241931154
DAL218,5p,24,C>T,4891,3819,8710,6952375,6657772,13610147,0.0006399636976735
DAL218,5p,25,C>T,4480,3577,8057,6952272,6657720,13609992,0.0005919915309281
DAL224,3p,1,C>T,32,12,44,4609472,4586477,9195949,4.784715530719015e-06
DAL224,3p,2,C>T,64,160,224,4609471,4586476,9195947,2.4358557090422556e-05
DAL224,3p,3,C>T,143,167,310,4609472,4586477,9195949,3.371049578461125e-05
DAL224,3p,4,C>T,184,193,377,4609472,4586477,9195949,4.099631261547884e-05
DAL224,3p,5,C>T,774,1030,1804,4609472,4586477,9195949,0.0001961733367594
DAL224,3p,6,C>T,1367,1036,2403,4609472,4586477,9195949,0.0002613107140981
DAL224,3p,7,C>T,1263,673,1936,4609472,4586476,9195948,0.0002105275062451
DAL224,3p,8,C>T,1105,943,2048,4609469,4586423,9195892,0.000222708139678
DAL224,3p,9,C>T,1116,869,1985,4609466,4586431,9195897,0.0002158571371558
DAL224,3p,10,C>T,1244,1041,2285,4609461,4586371,9195832,0.0002484821384296
DAL224,3p,11,C>T,1112,1237,2349,4609461,4586382,9195843,0.0002554415076464
DAL224,3p,12,C>T,1525,1243,2768,4609458,4586384,9195842,0.0003010056066644
DAL224,3p,13,C>T,1840,1196,3036,4609454,4586364,9195818,0.0003301500747404
DAL224,3p,14,C>T,2597,984,3581,4609412,4586293,9195705,0.0003894209307497
DAL224,3p,15,C>T,1674,1104,2778,4609400,4586272,9195672,0.0003020986394469
DAL224,3p,16,C>T,1292,1427,2719,4609379,4586240,9195619,0.0002956842818302
DAL224,3p,17,C>T,1581,2076,3657,4609381,4586216,9195597,0.0003976903294043
DAL224,3p,18,C>T,2282,1488,3770,4609363,4586282,9195645,0.000409976679178
DAL224,3p,19,C>T,2114,1048,3162,4609353,4586195,9195548,0.0003438620515057
DAL224,3p,20,C>T,2147,1158,3305,4609344,4586225,9195569,0.0003594122343054
DAL224,3p,21,C>T,2354,1186,3540,4609343,4586223,9195566,0.0003849681466045
DAL224,3p,22,C>T,1555,1040,2595,4609324,4586172,9195496,0.0002822033743476
DAL224,3p,23,C>T,1919,1428,3347,4609323,4586083,9195406,0.0003639861034955
DAL224,3p,24,C>T,2083,1565,3648,4609325,4586202,9195527,0.0003967146200538
DAL224,3p,25,C>T,2714,1377,4091,4609265,4586173,9195438,0.000444894522697
DAL224,5p,1,C>T,11,16,27,4609472,4586477,9195949,2.9360754393048502e-06
DAL224,5p,2,C>T,76,118,194,4609461,4586469,9195930,2.109628933669569e-05
DAL224,5p,3,C>T,47,69,116,4609468,4586477,9195945,1.2614255522406888e-05
DAL224,5p,4,C>T,104,102,206,4609471,4586477,9195948,2.240117060253059e-05
DAL224,5p,5,C>T,821,710,1531,4609471,4586477,9195948,0.0001664863698663
DAL224,5p,6,C>T,754,827,1581,4609472,4586477,9195949,0.0001719235285015
DAL224,5p,7,C>T,1370,1324,2694,4609471,4586477,9195948,0.0002929551145787
DAL224,5p,8,C>T,1990,931,2921,4609397,4586477,9195874,0.0003176424557361
DAL224,5p,9,C>T,1280,1077,2357,4609357,4586473,9195830,0.000256311828296
DAL224,5p,10,C>T,1419,993,2412,4609338,4586470,9195808,0.0002622934276139
DAL224,5p,11,C>T,819,741,1560,4609388,4586469,9195857,0.0001696416114343
DAL224,5p,12,C>T,1453,1324,2777,4609357,4586464,9195821,0.0003019849994905
DAL224,5p,13,C>T,1492,1231,2723,4609320,4586461,9195781,0.0002961140549127
DAL224,5p,14,C>T,1765,1330,3095,4609270,4586428,9195698,0.0003365704267365
DAL224,5p,15,C>T,1834,1263,3097,4609299,4586416,9195715,0.0003367872971269
DAL224,5p,16,C>T,1341,1504,2845,4609292,4586373,9195665,0.0003093849112598
DAL224,5p,17,C>T,1674,1338,3012,4609285,4586385,9195670,0.0003275454643326
DAL224,5p,18,C>T,1873,1510,3383,4609226,4586351,9195577,0.0003678942604689
DAL224,5p,19,C>T,1291,1810,3101,4609203,4586337,9195540,0.0003372287000002
DAL224,5p,20,C>T,1227,1197,2424,4609148,4586313,9195461,0.0002636083171904
DAL224,5p,21,C>T,1846,1286,3132,4609195,4586347,9195542,0.0003405998254371
DAL224,5p,22,C>T,1622,1291,2913,4609138,4586312,9195450,0.0003167871066668
DAL224,5p,23,C>T,1249,1023,2272,4609100,4586313,9195413,0.0002470797124609
DAL224,5p,24,C>T,2597,1311,3908,4609109,4586316,9195425,0.0004249939507961
DAL224,5p,25,C>T,1642,1129,2771,4609125,4586257,9195382,0.0003013469152233
DAL227,3p,1,C>T,32,141,173,3765386,3771243,7536629,2.295455965790541e-05
DAL227,3p,2,C>T,110,78,188,3765386,3771243,7536629,2.494483939703016e-05
DAL227,3p,3,C>T,99,62,161,3765386,3771243,7536629,2.136233586660561e-05
DAL227,3p,4,C>T,144,130,274,3765386,3771243,7536629,3.635577656801204e-05
DAL227,3p,5,C>T,637,406,1043,3765386,3771243,7536629,0.0001383907845271
DAL227,3p,6,C>T,759,512,1271,3765386,3771243,7536629,0.0001686430365618
DAL227,3p,7,C>T,581,454,1035,3765386,3771243,7536629,0.0001373293019996
DAL227,3p,8,C>T,1044,509,1553,3765386,3771207,7536593,0.0002060612799443
DAL227,3p,9,C>T,876,569,1445,3765384,3771218,7536602,0.0001917309684125
DAL227,3p,10,C>T,902,646,1548,3765382,3771209,7536591,0.0002053979047025
DAL227,3p,11,C>T,1184,714,1898,3765378,3771214,7536592,0.0002518379660196
DAL227,3p,12,C>T,1074,759,1833,3765377,3771173,7536550,0.0002432147335319
DAL227,3p,13,C>T,1312,647,1959,3765373,3771183,7536556,0.0002599330516485
DAL227,3p,14,C>T,1344,600,1944,3765341,3771166,7536507,0.000257944429694
DAL227,3p,15,C>T,993,858,1851,3765341,3771186,7536527,0.0002456038437864
DAL227,3p,16,C>T,893,672,1565,3765340,3771079,7536419,0.0002076583056223
DAL227,3p,17,C>T,705,681,1386,3765328,3771049,7536377,0.0001839079971715
DAL227,3p,18,C>T,1003,673,1676,3765321,3771036,7536357,0.0002223886156136
DAL227,3p,19,C>T,889,721,1610,3765313,3771111,7536424,0.000213629169484
DAL227,3p,20,C>T,869,661,1530,3765308,3771082,7536390,0.0002030149713589
DAL227,3p,21,C>T,1000,773,1773,3765307,3771104,7536411,0.0002352578700922
DAL227,3p,22,C>T,879,699,1578,3765309,3771137,7536446,0.0002093825126591
DAL227,3p,23,C>T,876,713,1589,3765319,3771112,7536431,0.0002108425062207
DAL227,3p,24,C>T,1303,923,2226,3765312,3771081,7536393,0.0002953667623225
DAL227,3p,25,C>T,888,670,1558,3765249,3771100,7536349,0.0002067314026991
DAL227,5p,1,C>T,3,7,10,3765386,3771243,7536629,1.3268531594164975e-06
DAL227,5p,2,C>T,51,58,109,3765373,3771238,7536611,1.446273397950352e-05
DAL227,5p,3,C>T,35,56,91,3765386,3771243,7536629,1.207436375069013e-05
DAL227,5p,4,C>T,92,82,174,3765385,3771243,7536628,2.308724803718586e-05
DAL227,5p,5,C>T,374,376,750,3765386,3771242,7536628,9.951400016028388e-05
DAL227,5p,6,C>T,405,417,822,3765386,3771243,7536629,0.000109067329704
DAL227,5p,7,C>T,1020,687,1707,3765386,3771243,7536629,0.0002264938343123
DAL227,5p,8,C>T,743,575,1318,3765342,3771242,7536584,0.0001748802905931
DAL227,5p,9,C>T,792,935,1727,3765324,3771243,7536567,0.0002291494257265
DAL227,5p,10,C>T,812,702,1514,3765318,3771238,7536556,0.0002008875141377
DAL227,5p,11,C>T,705,398,1103,3765365,3771237,7536602,0.0001463524277917
DAL227,5p,12,C>T,925,786,1711,3765326,3771232,7536558,0.000227026714317
DAL227,5p,13,C>T,898,737,1635,3765325,3771231,7536556,0.0002169425928766
DAL227,5p,14,C>T,740,598,1338,3765297,3771226,7536523,0.0001775354497027
DAL227,5p,15,C>T,912,632,1544,3765318,3771201,7536519,0.0002048691179575
DAL227,5p,16,C>T,693,560,1253,3765316,3771188,7536504,0.0001662574583653
DAL227,5p,17,C>T,962,633,1595,3765326,3771175,7536501,0.000211636673305
DAL227,5p,18,C>T,765,672,1437,3765280,3771169,7536449,0.0001906733529278
DAL227,5p,19,C>T,1078,1042,2120,3765279,3771164,7536443,0.0002812998121262
DAL227,5p,20,C>T,906,665,1571,3765254,3771167,7536421,0.0002084543843821
DAL227,5p,21,C>T,1020,667,1687,3765270,3771169,7536439,0.0002238457711924
DAL227,5p,22,C>T,951,724,1675,3765253,3771158,7536411,0.0002222543329974
DAL227,5p,23,C>T,717,704,1421,3765254,3771157,7536411,0.0001885512878742
DAL227,5p,24,C>T,1605,706,2311,3765270,3771180,7536450,0.0003066430481194
DAL227,5p,25,C>T,952,622,1574,3765247,3771148,7536395,0.0002088531718414
WA02,3p,1,C>T,70,31,101,6552698,6754258,13306956,7.5900153273220415e-06
WA02,3p,2,C>T,124,114,238,6552698,6754258,13306956,1.7885382652501444e-05
WA02,3p,3,C>T,191,247,438,6552698,6754258,13306956,3.291511597393123e-05
WA02,3p,4,C>T,303,283,586,6552698,6754256,13306954,4.403712525045176e-05
WA02,3p,5,C>T,1693,1485,3178,6552698,6754256,13306954,0.0002388224983719
WA02,3p,6,C>T,1681,1479,3160,6552698,6754257,13306955,0.0002374698043241
WA02,3p,7,C>T,1817,1451,3268,6552698,6754257,13306955,0.0002455858609276
WA02,3p,8,C>T,1929,1880,3809,6552692,6754207,13306899,0.0002862424972189
WA02,3p,9,C>T,2275,1850,4125,6552688,6754191,13306879,0.0003099900434955
WA02,3p,10,C>T,2497,1974,4471,6552680,6754207,13306887,0.0003359914306028
WA02,3p,11,C>T,2460,2155,4615,6552667,6754202,13306869,0.0003468133638348
WA02,3p,12,C>T,2312,2101,4413,6552670,6754189,13306859,0.0003316334831533
WA02,3p,13,C>T,2450,2130,4580,6552675,6754177,13306852,0.0003441835830142
WA02,3p,14,C>T,2311,2120,4431,6552653,6754155,13306808,0.0003329874452235
WA02,3p,15,C>T,2439,2285,4724,6552632,6754146,13306778,0.0003550070497907
WA02,3p,16,C>T,2484,2320,4804,6552629,6754119,13306748,0.0003610198374538
WA02,3p,17,C>T,2483,1984,4467,6552608,6754116,13306724,0.0003356949464045
WA02,3p,18,C>T,2459,2473,4932,6552611,6754085,13306696,0.000370640465522
WA02,3p,19,C>T,2671,2565,5236,6552605,6754056,13306661,0.000393487141515
WA02,3p,20,C>T,2529,2415,4944,6552618,6754033,13306651,0.0003715435236108
WA02,3p,21,C>T,2644,2275,4919,6552597,6754089,13306686,0.0003696637915706
WA02,3p,22,C>T,2705,2087,4792,6552593,6754062,13306655,0.0003601205562179
WA02,3p,23,C>T,2594,2082,4676,6552585,6754052,13306637,0.000351403589051
WA02,3p,24,C>T,2450,2164,4614,6552556,6754026,13306582,0.0003467456932215
WA02,3p,25,C>T,2646,2212,4858,6552517,6754038,13306555,0.00036508322402
WA02,5p,1,C>T,23,42,65,6552698,6754258,13306956,4.88466332946468e-06
WA02,5p,2,C>T,194,150,344,6552562,6754179,13306741,2.58515589955497e-05
WA02,5p,3,C>T,235,136,371,6552698,6754258,13306956,2.788015531125225e-05
WA02,5p,4,C>T,328,216,544,6552698,6754258,13306956,4.088087463428901e-05
WA02,5p,5,C>T,1678,1292,2970,6552698,6754258,13306956,0.0002231915398232
WA02,5p,6,C>T,1600,1328,2928,6552697,6754258,13306955,0.000220035312361
WA02,5p,7,C>T,2678,2279,4957,6552685,6754258,13306943,0.000372512304291
WA02,5p,8,C>T,2300,2273,4573,6552655,6754257,13306912,0.0003436559887072
WA02,5p,9,C>T,2893,2523,5416,6552662,6754226,13306888,0.0004070072581959
WA02,5p,10,C>T,2394,2050,4444,6552618,6754222,13306840,0.0003339635856446
WA02,5p,11,C>T,2069,1703,3772,6552625,6754225,13306850,0.0002834630284402
WA02,5p,12,C>T,2951,2453,5404,6552628,6754236,13306864,0.0004061062020322
WA02,5p,13,C>T,2549,2267,4816,6552614,6754205,13306819,0.0003619197044763
WA02,5p,14,C>T,2526,2133,4659,6552607,6754183,13306790,0.0003501220053822
WA02,5p,15,C>T,2602,2113,4715,6552586,6754168,13306754,0.0003543313418133
WA02,5p,16,C>T,2622,2083,4705,6552525,6754178,13306703,0.000353581198889
WA02,5p,17,C>T,2893,2081,4974,6552567,6754148,13306715,0.0003737962374635
WA02,5p,18,C>T,2968,1939,4907,6552548,6754087,13306635,0.0003687634026183
WA02,5p,19,C>T,2655,1884,4539,6552516,6754124,13306640,0.0003411078980118
WA02,5p,20,C>T,2468,2195,4663,6552507,6754132,13306639,0.0003504265802957
WA02,5p,21,C>T,2882,2103,4985,6552521,6754152,13306673,0.0003746240701939
WA02,5p,22,C>T,2582,2012,4594,6552516,6754117,13306633,0.0003452413544433
WA02,5p,23,C>T,2586,2246,4832,6552465,6754131,13306596,0.0003631281809412
WA02,5p,24,C>T,2706,2253,4959,6552457,6754135,13306592,0.0003726724318292
WA02,5p,25,C>T,2765,2231,4996,6552470,6754083,13306553,0.0003754541089642
WA03,3p,1,C>T,161,71,232,5399458,5543742,10943200,2.1200380144747424e-05
WA03,3p,2,C>T,233,266,499,5399458,5543742,10943200,4.559909350098692e-05
WA03,3p,3,C>T,396,529,925,5399458,5543742,10943200,8.452737773229038e-05
WA03,3p,4,C>T,738,558,1296,5399458,5543736,10943194,0.0001184297747074
WA03,3p,5,C>T,4217,4018,8235,5399458,5543740,10943198,0.000752522251722
WA03,3p,6,C>T,4285,4234,8519,5399458,5543741,10943199,0.0007784743748148
WA03,3p,7,C>T,4607,4462,9069,5399458,5543739,10943197,0.0008287340527635
WA03,3p,8,C>T,4822,4305,9127,5399449,5543673,10943122,0.0008340398654058
WA03,3p,9,C>T,5593,5983,11576,5399436,5543670,10943106,0.0010578349510641
WA03,3p,10,C>T,5723,5632,11355,5399438,5543654,10943092,0.0010376409153829
WA03,3p,11,C>T,5695,5394,11089,5399404,5543644,10943048,0.0010133374175092
WA03,3p,12,C>T,5776,6014,11790,5399397,5543595,10942992,0.0010774018659613
WA03,3p,13,C>T,5375,5601,10976,5399378,5543551,10942929,0.0010030221342019
WA03,3p,14,C>T,5327,5251,10578,5399356,5543493,10942849,0.0009666586827616
WA03,3p,15,C>T,5592,6593,12185,5399349,5543505,10942854,0.0011135120691549
WA03,3p,16,C>T,5503,5556,11059,5399342,5543495,10942837,0.0010106154372947
WA03,3p,17,C>T,5881,5554,11435,5399346,5543438,10942784,0.0010449808750679
WA03,3p,18,C>T,5979,6439,12418,5399325,5543443,10942768,0.0011348134219787
WA03,3p,19,C>T,5502,5473,10975,5399297,5543425,10942722,0.0010029497231127
WA03,3p,20,C>T,5578,5711,11289,5399252,5543409,10942661,0.0010316503453776
WA03,3p,21,C>T,6386,6938,13324,5399248,5543303,10942551,0.0012176319763097
WA03,3p,22,C>T,5798,5804,11602,5399256,5543263,10942519,0.0010602677500491
WA03,3p,23,C>T,5767,6085,11852,5399255,5543267,10942522,0.0010831141120849
WA03,3p,24,C>T,5832,6229,12061,5399198,5543130,10942328,0.0011022334552574
WA03,3p,25,C>T,5430,5775,11205,5399050,5543142,10942192,0.0010240178567511
WA03,5p,1,C>T,61,94,155,5399457,5543742,10943199,1.4164048373789051e-05
WA03,5p,2,C>T,304,376,680,5399258,5543638,10942896,6.214077151057636e-05
WA03,5p,3,C>T,450,413,863,5399457,5543742,10943199,7.886176610696745e-05
WA03,5p,4,C>T,622,579,1201,5399458,5543742,10943200,0.0001097485196286
WA03,5p,5,C>T,3850,3580,7430,5399456,5543740,10943196,0.0006789606985016
WA03,5p,6,C>T,4406,4137,8543,5399452,5543742,10943194,0.0007806678744797
WA03,5p,7,C>T,7354,6775,14129,5399453,5543742,10943195,0.0012911220169246
WA03,5p,8,C>T,5700,5568,11268,5399403,5543732,10943135,0.0010296866482959
WA03,5p,9,C>T,7601,6494,14095,5399319,5543732,10943051,0.0012880320122788
WA03,5p,10,C>T,5586,5219,10805,5399344,5543717,10943061,0.0009873836945622
WA03,5p,11,C>T,4918,4533,9451,5399321,5543705,10943026,0.0008636550804137
WA03,5p,12,C>T,6962,5952,12914,5399213,5543665,10942878,0.0011801282989721
WA03,5p,13,C>T,6219,6069,12288,5399156,5543662,10942818,0.0011229282987252
WA03,5p,14,C>T,6230,6295,12525,5399124,5543629,10942753,0.0011445931384908
WA03,5p,15,C>T,7453,6378,13831,5399092,5543505,10942597,0.0012639595518321
WA03,5p,16,C>T,6247,6104,12351,5399083,5543501,10942584,0.0011287096356765
WA03,5p,17,C>T,6160,5827,11987,5399113,5543491,10942604,0.0010954430956287
WA03,5p,18,C>T,7802,6598,14400,5399074,5543600,10942674,0.0013159489170562
WA03,5p,19,C>T,6870,6495,13365,5399071,5543546,10942617,0.0012213714507233
WA03,5p,20,C>T,6830,5893,12723,5399050,5543533,10942583,0.0011627053685587
WA03,5p,21,C>T,8266,6629,14895,5399034,5543509,10942543,0.0013612009566697
WA03,5p,22,C>T,6709,6405,13114,5398989,5543454,10942443,0.0011984526672882
WA03,5p,23,C>T,6920,5922,12842,5398935,5543457,10942392,0.0011736007995326
WA03,5p,24,C>T,8683,5937,14620,5398952,5543428,10942380,0.0013360895892849
WA03,5p,25,C>T,6923,5931,12854,5398991,5543444,10942435,0.0011746928357353
WA07,3p,1,C>T,24,20,44,5691729,6013979,11705708,3.7588499559360273e-06
WA07,3p,2,C>T,47,97,144,5691729,6013979,11705708,1.2301690764881545e-05
WA07,3p,3,C>T,92,206,298,5691729,6013979,11705708,2.545766561065764e-05
WA07,3p,4,C>T,219,264,483,5691729,6013979,11705708,4.126192110720684e-05
WA07,3p,5,C>T,1049,883,1932,5691729,6013979,11705708,0.0001650476844288
WA07,3p,6,C>T,994,1023,2017,5691729,6013979,11705708,0.0001723090991164
WA07,3p,7,C>T,1035,1039,2074,5691729,6013979,11705708,0.0001771785183775
WA07,3p,8,C>T,1410,1247,2657,5691713,6013800,11705513,0.0002269870615666
WA07,3p,9,C>T,1487,1431,2918,5691720,6013901,11705621,0.0002492819475361
WA07,3p,10,C>T,1250,1544,2794,5691718,6013892,11705610,0.0002386889705021
WA07,3p,11,C>T,1247,1747,2994,5691711,6013883,11705594,0.0002557751447726
WA07,3p,12,C>T,1355,1307,2662,5691705,6013884,11705589,0.0002274127342075
WA07,3p,13,C>T,1454,1275,2729,5691711,6013848,11705559,0.0002331370932392
WA07,3p,14,C>T,1262,1071,2333,5691695,6013877,11705572,0.0001993067916715
WA07,3p,15,C>T,1465,1084,2549,5691211,6013856,11705067,0.000217768937162
WA07,3p,16,C>T,1515,1278,2793,5691636,6013850,11705486,0.0002386060689833
WA07,3p,17,C>T,1468,1259,2727,5691662,6013813,11705475,0.0002329679060439
WA07,3p,18,C>T,1622,1230,2852,5691639,6013769,11705408,0.000243648064211
WA07,3p,19,C>T,1637,1171,2808,5691628,6013742,11705370,0.0002398898966884
WA07,3p,20,C>T,2310,1245,3555,5691604,6013772,11705376,0.000303706604555
WA07,3p,21,C>T,1585,1386,2971,5691611,6013735,11705346,0.0002538156497039
WA07,3p,22,C>T,1509,1364,2873,5691577,6013736,11705313,0.0002454440987609
WA07,3p,23,C>T,1479,1343,2822,5691568,6013670,11705238,0.0002410886476635
WA07,3p,24,C>T,1314,1488,2802,5691554,6013661,11705215,0.0002393804812641
WA07,3p,25,C>T,1976,1462,3438,5691455,6013662,11705117,0.0002937176962861
WA07,5p,1,C>T,10,26,36,5691729,6013979,11705708,3.0754226912203858e-06
WA07,5p,2,C>T,95,111,206,5691636,6013923,11705559,1.7598476074487344e-05
WA07,5p,3,C>T,134,101,235,5691729,6013979,11705708,2.0075675901021963e-05
WA07,5p,4,C>T,184,203,387,5691728,6013979,11705707,3.3060796754950386e-05
WA07,5p,5,C>T,808,638,1446,5691729,6013978,11705707,0.0001235294886502
WA07,5p,6,C>T,1206,746,1952,5691728,6013979,11705707,0.0001667562668363
WA07,5p,7,C>T,1928,1287,3215,5691728,6013979,11705707,0.0002746523554707
WA07,5p,8,C>T,1614,1424,3038,5691579,6013975,11705554,0.0002595349182106
WA07,5p,9,C>T,1666,1651,3317,5691672,6013971,11705643,0.0002833676031295
WA07,5p,10,C>T,1565,1091,2656,5691582,6013961,11705543,0.0002269010502118
WA07,5p,11,C>T,1212,984,2196,5691326,6013942,11705268,0.0001876078360615
WA07,5p,12,C>T,1603,1361,2964,5691520,6013938,11705458,0.0002532152095202
WA07,5p,13,C>T,1980,1321,3301,5691511,6013949,11705460,0.0002820051497335
WA07,5p,14,C>T,1499,1482,2981,5691556,6013950,11705506,0.0002546664791765
WA07,5p,15,C>T,1367,1268,2635,5691563,6013633,11705196,0.0002251137016415
WA07,5p,16,C>T,1631,1619,3250,5691534,6013925,11705459,0.0002776482323333
WA07,5p,17,C>T,1564,1300,2864,5691561,6013916,11705477,0.000244671789112
WA07,5p,18,C>T,1670,1585,3255,5691474,6013905,11705379,0.0002780772839563
WA07,5p,19,C>T,1427,1265,2692,5691482,6013884,11705366,0.0002299799937908
WA07,5p,20,C>T,1868,1557,3425,5691421,6013876,11705297,0.0002926025712974
WA07,5p,21,C>T,1738,1156,2894,5691379,6013853,11705232,0.0002472398667536
WA07,5p,22,C>T,1934,1553,3487,5691396,6013861,11705257,0.0002979003365752
WA07,5p,23,C>T,1975,1312,3287,5691314,6013795,11705109,0.0002808175472778
WA07,5p,24,C>T,1785,2664,4449,5691332,6013785,11705117,0.0003800901776547
WA07,5p,25,C>T,1499,1262,2761,5691334,6013719,11705053,0.0002358810336014
WA08,3p,1,C>T,80,32,112,6798117,7189085,13987202,8.00731983423132e-06
WA08,3p,2,C>T,102,173,275,6798117,7189085,13987202,1.9660829950121545e-05
WA08,3p,3,C>T,185,219,404,6798117,7189085,13987202,2.888354654490584e-05
WA08,3p,4,C>T,277,424,701,6798117,7189081,13987198,5.011725722335524e-05
WA08,3p,5,C>T,1932,1578,3510,6798117,7189085,13987202,0.0002509436840906
WA08,3p,6,C>T,1875,1533,3408,6798117,7189085,13987202,0.0002436513035273
WA08,3p,7,C>T,2013,1808,3821,6798117,7189084,13987201,0.0002731783149466
WA08,3p,8,C>T,2325,2204,4529,6798110,7189053,13987163,0.0003237968986276
WA08,3p,9,C>T,2603,2083,4686,6798103,7189051,13987154,0.0003350216920468
WA08,3p,10,C>T,2773,2439,5212,6798074,7189042,13987116,0.000372628639099
WA08,3p,11,C>T,2902,2495,5397,6798109,7189046,13987155,0.0003858540210643
WA08,3p,12,C>T,2626,2222,4848,6798091,7189018,13987109,0.0003466048630921
WA08,3p,13,C>T,2395,2482,4877,6798090,7189013,13987103,0.0003486783503345
WA08,3p,14,C>T,2514,2267,4781,6798067,7188981,13987048,0.0003418162288425
WA08,3p,15,C>T,2645,2628,5273,6798069,7188978,13987047,0.0003769916552078
WA08,3p,16,C>T,2665,2355,5020,6798049,7188961,13987010,0.0003589044406202
WA08,3p,17,C>T,2629,2565,5194,6798000,7188943,13986943,0.0003713463335054
WA08,3p,18,C>T,2662,2796,5458,6798023,7188956,13986979,0.0003902200754001
WA08,3p,19,C>T,2687,2624,5311,6798028,7188946,13986974,0.0003797104362959
WA08,3p,20,C>T,2969,2486,5455,6798009,7188917,13986926,0.0003900070680291
WA08,3p,21,C>T,2801,2610,5411,6798010,7188926,13986936,0.0003868609965756
WA08,3p,22,C>T,2963,2635,5598,6798012,7188920,13986932,0.0004002307296553
WA08,3p,23,C>T,2846,2590,5436,6798009,7188864,13986873,0.0003886501293033
WA08,3p,24,C>T,2748,2732,5480,6798015,7188867,13986882,0.0003917956839844
WA08,3p,25,C>T,2986,2374,5360,6797966,7188892,13986858,0.0003832168740113
WA08,5p,1,C>T,31,38,69,6798116,7189085,13987201,4.933081321988581e-06
WA08,5p,2,C>T,173,182,355,6797941,7188997,13986938,2.5380823165155947e-05
WA08,5p,3,C>T,256,172,428,6798117,7189084,13987201,3.059940298276975e-05
WA08,5p,4,C>T,305,208,513,6798115,7189085,13987200,3.667638984214139e-05
WA08,5p,5,C>T,1797,1612,3409,6798116,7189084,13987200,0.0002437228323038
WA08,5p,6,C>T,1792,1444,3236,6798112,7189085,13987197,0.0002313544307697
WA08,5p,7,C>T,3077,2546,5623,6798110,7189085,13987195,0.0004020105532238
WA08,5p,8,C>T,2869,2708,5577,6798069,7189064,13987133,0.0003987235983242
WA08,5p,9,C>T,3264,3149,6413,6798054,7189067,13987121,0.0004584932095747
WA08,5p,10,C>T,2789,2668,5457,6798015,7189037,13987052,0.0003901465441037
WA08,5p,11,C>T,2417,2244,4661,6797997,7189047,13987044,0.0003332369584309
WA08,5p,12,C>T,3073,2789,5862,6798016,7189056,13987072,0.0004191012958251
WA08,5p,13,C>T,2956,2891,5847,6797995,7189043,13987038,0.0004180298931053
WA08,5p,14,C>T,3103,2531,5634,6797984,7189041,13987025,0.0004028018824589
WA08,5p,15,C>T,3145,2560,5705,6797997,7189013,13987010,0.0004078784529359
WA08,5p,16,C>T,3161,2341,5502,6797921,7188997,13986918,0.0003933675739001
WA08,5p,17,C>T,3057,2458,5515,6797959,7188875,13986834,0.0003942993818329
WA08,5p,18,C>T,3446,2498,5944,6797991,7188972,13986963,0.0004249671640655
WA08,5p,19,C>T,2844,2458,5302,6797966,7188988,13986954,0.0003790675224927
WA08,5p,20,C>T,3183,2370,5553,6797883,7188971,13986854,0.0003970156548427
WA08,5p,21,C>T,3359,2727,6086,6797885,7188979,13986864,0.0004351225549915
WA08,5p,22,C>T,2981,2748,5729,6797887,7188939,13986826,0.0004095997190499
WA08,5p,23,C>T,2910,2674,5584,6797851,7188919,13986770,0.0003992344193834
WA08,5p,24,C>T,3509,2832,6341,6797841,7188876,13986717,0.0004533587116976
WA08,5p,25,C>T,2934,2754,5688,6797835,7188817,13986652,0.0004066734483706
WA09,3p,1,C>T,116,56,172,4741672,4881751,9623423,1.7873058266273862e-05
WA09,3p,2,C>T,130,199,329,4741672,4881751,9623423,3.418741959072151e-05
WA09,3p,3,C>T,354,292,646,4741672,4881751,9623423,6.712788162798205e-05
WA09,3p,4,C>T,524,512,1036,4741672,4881748,9623420,0.0001076540356754
WA09,3p,5,C>T,4311,3657,7968,4741672,4881751,9623423,0.000827979815498
WA09,3p,6,C>T,4202,3369,7571,4741672,4881751,9623423,0.0007867263031044
WA09,3p,7,C>T,4361,3656,8017,4741672,4881748,9623420,0.0008330718185426
WA09,3p,8,C>T,4688,3836,8524,4741663,4881718,9623381,0.0008857593812403
WA09,3p,9,C>T,5137,4467,9604,4741664,4881723,9623387,0.0009979854286229
WA09,3p,10,C>T,5651,4551,10202,4741658,4881705,9623363,0.001060128356376
WA09,3p,11,C>T,5250,4663,9913,4741648,4881712,9623360,0.00103009759585
WA09,3p,12,C>T,5619,5237,10856,4741642,4881680,9623322,0.001128092772953
WA09,3p,13,C>T,5223,4854,10077,4741628,4881645,9623273,0.0010471489273971
WA09,3p,14,C>T,5257,4639,9896,4741616,4881571,9623187,0.0010283495478161
WA09,3p,15,C>T,5477,5244,10721,4741598,4881557,9623155,0.0011140836866911
WA09,3p,16,C>T,5618,4443,10061,4741586,4881546,9623132,0.0010455016100787
WA09,3p,17,C>T,5382,5130,10512,4741582,4881528,9623110,0.0010923703459692
WA09,3p,18,C>T,5685,5023,10708,4741560,4881490,9623050,0.0011127449197499
WA09,3p,19,C>T,5719,5371,11090,4741552,4881442,9622994,0.0011524479803271
WA09,3p,20,C>T,5338,5036,10374,4741534,4881501,9623035,0.0010780382696311
WA09,3p,21,C>T,5584,5791,11375,4741546,4881493,9623039,0.0011820590148288
WA09,3p,22,C>T,5878,5724,11602,4741524,4881498,9623022,0.0012056503663817
WA09,3p,23,C>T,5557,4493,10050,4741501,4881486,9622987,0.001044374267574
WA09,3p,24,C>T,5681,5280,10961,4741491,4881450,9622941,0.0011390488625047
WA09,3p,25,C>T,5535,5065,10600,4741451,4881469,9622920,0.0011015367476815
WA09,5p,1,C>T,41,55,96,4741672,4881751,9623423,9.975660427687735e-06
WA09,5p,2,C>T,212,591,803,4741495,4881667,9623162,8.34445060781477e-05
WA09,5p,3,C>T,373,236,609,4741672,4881750,9623422,6.328310241408929e-05
WA09,5p,4,C>T,544,362,906,4741672,4881751,9623423,9.414529528630302e-05
WA09,5p,5,C>T,3904,2694,6598,4741671,4881751,9623422,0.0006856188993894
WA09,5p,6,C>T,3981,3160,7141,4741669,4881751,9623420,0.000742043888763
WA09,5p,7,C>T,7076,5563,12639,4741667,4881751,9623418,0.0013133587255588
WA09,5p,8,C>T,5503,4723,10226,4741639,4881744,9623383,0.0010626200786147
WA09,5p,9,C>T,6559,5137,11696,4741618,4881747,9623365,0.0012153752871266
WA09,5p,10,C>T,5709,4406,10115,4741622,4881737,9623359,0.001051088294638
WA09,5p,11,C>T,4720,3721,8441,4741614,4881733,9623347,0.0008771376528353
WA09,5p,12,C>T,6542,5011,11553,4741580,4881734,9623314,0.0012005219823441
WA09,5p,13,C>T,6066,4736,10802,4741530,4881708,9623238,0.0011224912030649
WA09,5p,14,C>T,6101,4938,11039,4741498,4881705,9623203,0.0011471232603115
WA09,5p,15,C>T,6557,5035,11592,4741496,4881672,9623168,0.0012045929157632
WA09,5p,16,C>T,6124,5059,11183,4741451,4881636,9623087,0.001162101101237
WA09,5p,17,C>T,5586,4776,10362,4741476,4881638,9623114,0.0010767824219893
WA09,5p,18,C>T,6459,5167,11626,4741455,4881610,9623065,0.0012081389869028
WA09,5p,19,C>T,5706,5542,11248,4741379,4881580,9622959,0.0011688712380464
WA09,5p,20,C>T,5630,4482,10112,4741390,4881557,9622947,0.0010508215414674
WA09,5p,21,C>T,6724,4999,11723,4741379,4881587,9622966,0.0012182314683435
WA09,5p,22,C>T,5698,4875,10573,4741354,4881580,9622934,0.0010987293480346
WA09,5p,23,C>T,5871,4743,10614,4741312,4881565,9622877,0.0011029965362749
WA09,5p,24,C>T,6811,4801,11612,4741363,4881548,9622911,0.0012067034601068
WA09,5p,25,C>T,5913,4543,10456,4741301,4881503,9622804,0.0010865855731863
WA11,3p,1,C>T,67,38,105,9756642,10108269,19864911,5.285702009941046e-06
WA11,3p,2,C>T,98,503,601,9756642,10108269,19864911,3.0254351504519704e-05
WA11,3p,3,C>T,810,586,1396,9756642,10108269,19864911,7.027466672264477e-05
WA11,3p,4,C>T,464,771,1235,9756642,10108267,19864909,6.216992990000608e-05
WA11,3p,5,C>T,3330,3259,6589,9756642,10108269,19864911,0.0003316903861285
WA11,3p,6,C>T,3223,3082,6305,9756642,10108269,19864911,0.0003173938206921
WA11,3p,7,C>T,3394,3491,6885,9756642,10108265,19864907,0.0003465911015843
WA11,3p,8,C>T,3666,3447,7113,9756629,10108160,19864789,0.0003580707552443
WA11,3p,9,C>T,4007,3948,7955,9756610,10108092,19864702,0.0004004590655324
WA11,3p,10,C>T,4329,4771,9100,9756615,10107969,19864584,0.0004581017150925
WA11,3p,11,C>T,4270,3754,8024,9756587,10107918,19864505,0.0004039365692726
WA11,3p,12,C>T,4297,4213,8510,9756581,10108019,19864600,0.0004284002698267
WA11,3p,13,C>T,3922,4119,8041,9756565,10107963,19864528,0.000404791898403
WA11,3p,14,C>T,4295,4345,8640,9756515,10107914,19864429,0.0004349483189272
WA11,3p,15,C>T,4515,4412,8927,9756471,10107972,19864443,0.0004493959382601
WA11,3p,16,C>T,4316,3937,8253,9756477,10108011,19864488,0.0004154650248221
WA11,3p,17,C>T,4252,3775,8027,9756469,10108044,19864513,0.0004040874296792
WA11,3p,18,C>T,4454,4602,9056,9756421,10108016,19864437,0.0004558900914231
WA11,3p,19,C>T,4234,3978,8212,9756438,10108000,19864438,0.0004134020806428
WA11,3p,20,C>T,4541,4071,8612,9756433,10107963,19864396,0.0004335394844122
WA11,3p,21,C>T,4681,4413,9094,9756421,10107904,19864325,0.0004578056390035
WA11,3p,22,C>T,4440,4249,8689,9756405,10107842,19864247,0.000437419047397
WA11,3p,23,C>T,4370,4109,8479,9756375,10107816,19864191,0.0004268484933516
WA11,3p,24,C>T,4379,4870,9249,9756358,10107704,19864062,0.0004656147368045
WA11,3p,25,C>T,4331,3926,8257,9756281,10107693,19863974,0.000415677144966
WA11,5p,1,C>T,31,46,77,9756641,10108269,19864910,3.876181669083826e-06
WA11,5p,2,C>T,334,349,683,9756471,10108196,19864667,3.4382655395129454e-05
WA11,5p,3,C>T,386,273,659,9756642,10108269,19864911,3.317407261477285e-05
WA11,5p,4,C>T,512,400,912,9756638,10108269,19864907,4.591010670223626e-05
WA11,5p,5,C>T,2868,2970,5838,9756638,10108267,19864905,0.0002938851205178
WA11,5p,6,C>T,3035,3113,6148,9756642,10108269,19864911,0.0003094904376868
WA11,5p,7,C>T,4893,4479,9372,9756629,10108269,19864898,0.0004717869681485
WA11,5p,8,C>T,4471,5427,9898,9756500,10108261,19864761,0.0004982692719031
WA11,5p,9,C>T,5340,4632,9972,9756493,10108240,19864733,0.0005019951690264
WA11,5p,10,C>T,4307,8046,12353,9756446,10108197,19864643,0.0006218586460375
WA11,5p,11,C>T,3530,4006,7536,9756457,10108195,19864652,0.0003793673304722
WA11,5p,12,C>T,4954,5606,10560,9756411,10108221,19864632,0.0005315980683659
WA11,5p,13,C>T,4768,7308,12076,9756334,10108178,19864512,0.0006079182816069
WA11,5p,14,C>T,4754,4488,9242,9756261,10108167,19864428,0.0004652537691998
WA11,5p,15,C>T,5028,4205,9233,9756237,10108096,19864333,0.0004648029208934
WA11,5p,16,C>T,4555,4230,8785,9756275,10108079,19864354,0.0004422494685706
WA11,5p,17,C>T,4669,3966,8635,9756369,10108078,19864447,0.0004346962188275
WA11,5p,18,C>T,5439,4692,10131,9756327,10108075,19864402,0.000510007801896
WA11,5p,19,C>T,4879,4564,9443,9756284,10108088,19864372,0.0004753736992037
WA11,5p,20,C>T,4735,4570,9305,9756292,10108082,19864374,0.0004684265409018
WA11,5p,21,C>T,4864,4489,9353,9756251,10108036,19864287,0.0004708449893016
WA11,5p,22,C>T,4608,4662,9270,9756136,10108029,19864165,0.0004666695025942
WA11,5p,23,C>T,4275,4266,8541,9756095,10108016,19864111,0.0004299714193099
WA11,5p,24,C>T,4980,4637,9617,9756046,10108010,19864056,0.0004841408018583
WA11,5p,25,C>T,4486,4501,8987,9756056,10107943,19863999,0.0004524265229775
WA12,3p,1,C>T,204,15,219,6632243,6940679,13572922,1.613506656856939e-05
WA12,3p,2,C>T,193,198,391,6632243,6940679,13572922,2.880735629365585e-05
WA12,3p,3,C>T,343,389,732,6632243,6940679,13572922,5.393090743467029e-05
WA12,3p,4,C>T,481,345,826,6632243,6940676,13572919,6.085647457263983e-05
WA12,3p,5,C>T,3391,2542,5933,6632243,6940678,13572921,0.0004371203516177
WA12,3p,6,C>T,3242,2903,6145,6632243,6940679,13572922,0.0004527396532596
WA12,3p,7,C>T,3621,2551,6172,6632243,6940676,13572919,0.00045472900855
WA12,3p,8,C>T,3896,2619,6515,6632240,6940664,13572904,0.0004800004479513
WA12,3p,9,C>T,4487,3918,8405,6632231,6940656,13572887,0.0006192492429945
WA12,3p,10,C>T,4330,3351,7681,6632228,6940644,13572872,0.0005659082322444
WA12,3p,11,C>T,4165,2993,7158,6632231,6940642,13572873,0.0005273754495455
WA12,3p,12,C>T,4625,4050,8675,6632223,6940615,13572838,0.0006391441495139
WA12,3p,13,C>T,4132,3608,7740,6632204,6940591,13572795,0.0005702583734595
WA12,3p,14,C>T,4082,3554,7636,6632209,6940533,13572742,0.0005625981839189
WA12,3p,15,C>T,4425,3617,8042,6632188,6940474,13572662,0.0005925145708336
WA12,3p,16,C>T,4267,3881,8148,6632187,6940478,13572665,0.0006003242546692
WA12,3p,17,C>T,3972,3463,7435,6632168,6940473,13572641,0.0005477931671514
WA12,3p,18,C>T,4440,3994,8434,6632160,6940482,13572642,0.0006213970721396
WA12,3p,19,C>T,4361,3444,7805,6632121,6940435,13572556,0.0005750574910134
WA12,3p,20,C>T,4070,3289,7359,6632105,6940432,13572537,0.0005421978219694
WA12,3p,21,C>T,4339,3804,8143,6632096,6940454,13572550,0.0005999609505951
WA12,3p,22,C>T,4420,3735,8155,6632039,6940438,13572477,0.0006008483197282
WA12,3p,23,C>T,4128,3134,7262,6631950,6940459,13572409,0.0005350560832642
WA12,3p,24,C>T,4399,3821,8220,6631933,6940411,13572344,0.000605643358288
WA12,3p,25,C>T,4244,3334,7578,6631986,6940428,13572414,0.0005583384061228
WA12,5p,1,C>T,25,47,72,6632243,6940679,13572922,5.304679419803635e-06
WA12,5p,2,C>T,204,159,363,6631949,6940524,13572473,2.6745310158288767e-05
WA12,5p,3,C>T,335,222,557,6632242,6940678,13572920,4.103759544740557e-05
WA12,5p,4,C>T,430,224,654,6632242,6940679,13572921,4.818417494657193e-05
WA12,5p,5,C>T,2647,2203,4850,6632242,6940677,13572919,0.000357329178786
WA12,5p,6,C>T,2855,2357,5212,6632242,6940679,13572921,0.0003839998774029
WA12,5p,7,C>T,5474,4682,10156,6632238,6940679,13572917,0.000748254778247
WA12,5p,8,C>T,4118,3369,7487,6632204,6940670,13572874,0.0005516149343167
WA12,5p,9,C>T,5084,4071,9155,6632209,6940675,13572884,0.0006745066118593
WA12,5p,10,C>T,4281,3539,7820,6632199,6940665,13572864,0.0005761495878835
WA12,5p,11,C>T,3371,2724,6095,6632166,6940667,13572833,0.0004490587926632
WA12,5p,12,C>T,5058,3667,8725,6632126,6940660,13572786,0.0006428304402648
WA12,5p,13,C>T,4756,3271,8027,6632065,6940658,13572723,0.0005914067501414
WA12,5p,14,C>T,4356,3347,7703,6632026,6940638,13572664,0.0005675378098212
WA12,5p,15,C>T,4951,3657,8608,6631987,6940631,13572618,0.000634218100001
WA12,5p,16,C>T,4338,3568,7906,6631930,6940590,13572520,0.0005825005231158
WA12,5p,17,C>T,4343,3250,7593,6631958,6940621,13572579,0.0005594367879531
WA12,5p,18,C>T,4911,3608,8519,6632019,6940577,13572596,0.0006276617973451
WA12,5p,19,C>T,4406,3044,7450,6631996,6940532,13572528,0.0005489029015081
WA12,5p,20,C>T,4423,3129,7552,6631973,6940532,13572505,0.0005564190250804
WA12,5p,21,C>T,5384,3298,8682,6631936,6940534,13572470,0.0006396772289789
WA12,5p,22,C>T,4885,3495,8380,6631921,6940529,13572450,0.0006174272146885
WA12,5p,23,C>T,4075,3203,7278,6631926,6940534,13572460,0.0005362329305078
WA12,5p,24,C>T,4959,3291,8250,6631934,6940518,13572452,0.0006078488986367
WA12,5p,25,C>T,4645,3509,8154,6631933,6940515,13572448,0.0006007759248736
WA13,3p,1,C>T,17,12,29,5896847,6081528,11978375,2.421029563692905e-06
WA13,3p,2,C>T,19,63,82,5896847,6081528,11978375,6.845669800786834e-06
WA13,3p,3,C>T,40,69,109,5896847,6081528,11978375,9.099731808362988e-06
WA13,3p,4,C>T,94,58,152,5896847,6081522,11978369,1.2689540621097914e-05
WA13,3p,5,C>T,268,223,491,5896847,6081527,11978374,4.099053844870765e-05
WA13,3p,6,C>T,305,240,545,5896847,6081528,11978375,4.549865904181494e-05
WA13,3p,7,C>T,369,229,598,5896847,6081528,11978375,4.992329927890887e-05
WA13,3p,8,C>T,351,287,638,5896845,6081521,11978366,5.326269042037954e-05
WA13,3p,9,C>T,644,270,914,5896842,6081517,11978359,7.630427506806233e-05
WA13,3p,10,C>T,525,326,851,5896843,6081517,11978360,7.104478409398281e-05
WA13,3p,11,C>T,403,369,772,5896841,6081492,11978333,6.44497026422625e-05
WA13,3p,12,C>T,374,301,675,5896836,6081505,11978341,5.635171014082835e-05
WA13,3p,13,C>T,388,252,640,5896834,6081495,11978329,5.342982314144152e-05
WA13,3p,14,C>T,424,236,660,5896832,6081501,11978333,5.509948671488762e-05
WA13,3p,15,C>T,572,286,858,5896825,6081505,11978330,7.162935066908325e-05
WA13,3p,16,C>T,475,414,889,5896830,6081509,11978339,7.42173017477632e-05
WA13,3p,17,C>T,367,347,714,5896823,6081499,11978322,5.9607681276225504e-05
WA13,3p,18,C>T,546,370,916,5896827,6081499,11978326,7.647145352363928e-05
WA13,3p,19,C>T,507,342,849,5896822,6081480,11978302,7.08781595254486e-05
WA13,3p,20,C>T,468,311,779,5896818,6081448,11978266,6.503445490357286e-05
WA13,3p,21,C>T,513,334,847,5896824,6081466,11978290,7.071126179112378e-05
WA13,3p,22,C>T,374,390,764,5896824,6081460,11978284,6.378209099066277e-05
WA13,3p,23,C>T,378,484,862,5896819,6081454,11978273,7.196362948147868e-05
WA13,3p,24,C>T,382,385,767,5896803,6081440,11978243,6.403276340277952e-05
WA13,3p,25,C>T,556,526,1082,5896783,6081437,11978220,9.03306167360426e-05
WA13,5p,1,C>T,11,23,34,5896847,6081528,11978375,2.838448453984785e-06
WA13,5p,2,C>T,39,30,69,5896725,6081443,11978168,5.760480233705188e-06
WA13,5p,3,C>T,68,111,179,5896847,6081528,11978375,1.4943596272449307e-05
WA13,5p,4,C>T,80,71,151,5896841,6081528,11978369,1.260605680122227e-05
WA13,5p,5,C>T,704,506,1210,5896841,6081528,11978369,0.0001010154220495
WA13,5p,6,C>T,304,294,598,5896841,6081528,11978369,4.992332428563521e-05
WA13,5p,7,C>T,742,633,1375,5896845,6081528,11978373,0.0001147902139965
WA13,5p,8,C>T,570,452,1022,5896843,6081526,11978369,8.532046391290835e-05
WA13,5p,9,C>T,582,760,1342,5896837,6081518,11978355,0.0001120354172171
WA13,5p,10,C>T,705,620,1325,5896833,6081518,11978351,0.0001106162275592
WA13,5p,11,C>T,716,492,1208,5896827,6081513,11978340,0.0001008486985675
WA13,5p,12,C>T,541,718,1259,5896822,6081502,11978324,0.0001051065240846
WA13,5p,13,C>T,665,552,1217,5896809,6081508,11978317,0.0001016002498514
WA13,5p,14,C>T,524,391,915,5896802,6081520,11978322,7.638799491280999e-05
WA13,5p,15,C>T,2596,430,3026,5896798,6081508,11978306,0.0002526233676114
WA13,5p,16,C>T,547,361,908,5896754,6081491,11978245,7.580409317057716e-05
WA13,5p,17,C>T,436,564,1000,5896805,6081514,11978319,8.348416835450784e-05
WA13,5p,18,C>T,533,390,923,5896796,6081504,11978300,7.705600961739145e-05
WA13,5p,19,C>T,504,351,855,5896797,6081472,11978269,7.137926189502006e-05
WA13,5p,20,C>T,584,504,1088,5896788,6081482,11978270,9.083114673487907e-05
WA13,5p,21,C>T,923,579,1502,5896782,6081484,11978266,0.0001253937756934
WA13,5p,22,C>T,801,594,1395,5896771,6081483,11978254,0.000116461046827
WA13,5p,23,C>T,496,420,916,5896768,6081501,11978269,7.647181742203319e-05
WA13,5p,24,C>T,531,589,1120,5896781,6081498,11978279,9.350258079645664e-05
WA13,5p,25,C>T,695,433,1128,5896769,6081462,11978231,9.41708337399738e-05
WA14,3p,1,C>T,90,24,114,6684341,7140972,13825313,8.24574459905537e-06
WA14,3p,2,C>T,195,182,377,6684341,7140972,13825313,2.7268822051262057e-05
WA14,3p,3,C>T,354,266,620,6684341,7140972,13825313,4.484527764398535e-05
WA14,3p,4,C>T,485,265,750,6684341,7140971,13825312,5.424832365446798e-05
WA14,3p,5,C>T,2310,2635,4945,6684341,7140970,13825311,0.0003576773064996
WA14,3p,6,C>T,2736,1875,4611,6684341,7140971,13825312,0.0003335186938276
WA14,3p,7,C>T,2263,1911,4174,6684341,7140969,13825310,0.0003019100475866
WA14,3p,8,C>T,2778,2716,5494,6684326,7140932,13825258,0.0003973886056954
WA14,3p,9,C>T,2923,2644,5567,6684323,7140920,13825243,0.0004026692333726
WA14,3p,10,C>T,3053,4094,7147,6684256,7140912,13825168,0.0005169557433226
WA14,3p,11,C>T,3149,2648,5797,6684256,7140894,13825150,0.0004193082896026
WA14,3p,12,C>T,3284,3385,6669,6684291,7140849,13825140,0.0004823820952265
WA14,3p,13,C>T,3140,2812,5952,6684289,7140794,13825083,0.0004305218276085
WA14,3p,14,C>T,2705,2935,5640,6684291,7140742,13825033,0.0004079556265796
WA14,3p,15,C>T,2987,4881,7868,6684271,7140702,13824973,0.000569115035523
WA14,3p,16,C>T,3853,2720,6573,6684263,7140648,13824911,0.0004754460987126
WA14,3p,17,C>T,3593,3083,6676,6684212,7140653,13824865,0.0004828980246823
WA14,3p,18,C>T,3121,2501,5622,6684177,7140647,13824824,0.0004066597882186
WA14,3p,19,C>T,2956,2625,5581,6684172,7140542,13824714,0.00040369732061
WA14,3p,20,C>T,2703,2718,5421,6684176,7140544,13824720,0.0003921236741141
WA14,3p,21,C>T,2982,3978,6960,6684132,7140443,13824575,0.0005034512815041
WA14,3p,22,C>T,3091,2827,5918,6684105,7140560,13824665,0.0004280754723532
WA14,3p,23,C>T,2961,2631,5592,6683638,7140562,13824200,0.0004045080366314
WA14,3p,24,C>T,2649,2665,5314,6683623,7140532,13824155,0.0003843996251488
WA14,3p,25,C>T,3365,3520,6885,6683613,7140513,13824126,0.0004980423355516
WA14,5p,1,C>T,18,116,134,6684341,7140972,13825313,9.69236645853877e-06
WA14,5p,2,C>T,374,263,637,6684184,7140911,13825095,4.607563275333732e-05
WA14,5p,3,C>T,231,327,558,6684338,7140972,13825310,4.036075863760017e-05
WA14,5p,4,C>T,302,261,563,6684341,7140972,13825313,4.072240534445766e-05
WA14,5p,5,C>T,1963,1794,3757,6684341,7140972,13825313,0.0002717479163039
WA14,5p,6,C>T,2181,1702,3883,6684340,7140972,13825312,0.0002808616543337
WA14,5p,7,C>T,3218,3715,6933,6684336,7140972,13825308,0.0005014716489498
WA14,5p,8,C>T,3539,3144,6683,6684277,7140970,13825247,0.0004833910019835
WA14,5p,9,C>T,3401,2777,6178,6684241,7140959,13825200,0.000446865144808
WA14,5p,10,C>T,3352,2445,5797,6684210,7140628,13824838,0.0004193177525841
WA14,5p,11,C>T,2584,2295,4879,6684218,7140646,13824864,0.0003529148641172
WA14,5p,12,C>T,2786,2524,5310,6684139,7140917,13825056,0.0003840852434883
WA14,5p,13,C>T,3500,2821,6321,6684018,7140931,13824949,0.0004572168765324
WA14,5p,14,C>T,3255,2882,6137,6683951,7140942,13824893,0.0004439094031324
WA14,5p,15,C>T,3788,2387,6175,6684030,7140908,13824938,0.0004466566143009
WA14,5p,16,C>T,2905,2900,5805,6683910,7140868,13824778,0.0004198982435739
WA14,5p,17,C>T,2669,2708,5377,6683904,7140873,13824777,0.0003889393658935
WA14,5p,18,C>T,5080,2986,8066,6683891,7140646,13824537,0.0005834553446527
WA14,5p,19,C>T,2685,3627,6312,6683958,7140595,13824553,0.0004565789577427
WA14,5p,20,C>T,3095,3451,6546,6683860,7140558,13824418,0.0004735099879069
WA14,5p,21,C>T,2910,3184,6094,6683480,7140494,13823974,0.0004408283754005
WA14,5p,22,C>T,2852,3466,6318,6683768,7140398,13824166,0.0004570257619881
WA14,5p,23,C>T,3306,2799,6105,6683762,7140257,13824019,0.0004416226569133
WA14,5p,24,C>T,3749,3836,7585,6683714,7140421,13824135,0.0005486780908895
WA14,5p,25,C>T,3285,3544,6829,6683731,7140511,13824242,0.0004939873014375
WA18,3p,1,C>T,149,194,343,14112928,14131239,28244167,1.2144100408413532e-05
WA18,3p,2,C>T,220,965,1185,14112928,14131239,28244167,4.195556555093305e-05
WA18,3p,3,C>T,484,809,1293,14112928,14131239,28244167,4.577936393025859e-05
WA18,3p,4,C>T,896,1397,2293,14112928,14131238,28244166,8.118490735396471e-05
WA18,3p,5,C>T,4766,4868,9634,14112928,14131239,28244167,0.000341096977652
WA18,3p,6,C>T,5009,4905,9914,14112928,14131239,28244167,0.0003510105290058
WA18,3p,7,C>T,5118,4822,9940,14112928,14131237,28244165,0.0003519310979807
WA18,3p,8,C>T,6325,5107,11432,14112927,14131187,28244114,0.0004047568990834
WA18,3p,9,C>T,6242,8060,14302,14112909,14131177,28244086,0.0005063714931331
WA18,3p,10,C>T,6064,6056,12120,14112909,14131197,28244106,0.0004291160782359
WA18,3p,11,C>T,5935,6239,12174,14112900,14131167,28244067,0.0004310285767272
WA18,3p,12,C>T,6649,5734,12383,14112895,14131136,28244031,0.0004384289197246
WA18,3p,13,C>T,6426,6254,12680,14112898,14131061,28243959,0.0004489455603585
WA18,3p,14,C>T,6705,6220,12925,14112830,14131006,28243836,0.0004576219745788
WA18,3p,15,C>T,7345,5654,12999,14112809,14130957,28243766,0.0004602431559587
WA18,3p,16,C>T,6869,6253,13122,14112765,14130927,28243692,0.0004645993165482
WA18,3p,17,C>T,5976,7392,13368,14112743,14130850,28243593,0.0004733108850563
WA18,3p,18,C>T,6628,6623,13251,14112708,14130769,28243477,0.0004691702795657
WA18,3p,19,C>T,6298,5600,11898,14112724,14130771,28243495,0.0004212651444164
WA18,3p,20,C>T,6535,6470,13005,14112697,14130797,28243494,0.0004604600266525
WA18,3p,21,C>T,6211,6710,12921,14112659,14130783,28243442,0.0004574867326723
WA18,3p,22,C>T,6256,6742,12998,14112575,14130715,28243290,0.0004602155060547
WA18,3p,23,C>T,6488,6329,12817,14112548,14130648,28243196,0.0004538084146001
WA18,3p,24,C>T,7464,7603,15067,14112551,14130690,28243241,0.0005334727696442
WA18,3p,25,C>T,7048,8325,15373,14112486,14130651,28243137,0.0005443092245737
WA18,5p,1,C>T,78,71,149,14112926,14131239,28244165,5.27542591540589e-06
WA18,5p,2,C>T,332,739,1071,14112820,14131183,28244003,3.791955410853058e-05
WA18,5p,3,C>T,789,512,1301,14112928,14131239,28244167,4.606260825465307e-05
WA18,5p,4,C>T,976,683,1659,14112928,14131239,28244167,5.873779177130626e-05
WA18,5p,5,C>T,4149,3532,7681,14112925,14131239,28244164,0.0002719499858448
WA18,5p,6,C>T,5068,4665,9733,14112927,14131239,28244166,0.0003446021383672
WA18,5p,7,C>T,8068,8200,16268,14112921,14131239,28244160,0.0005759774764057
WA18,5p,8,C>T,6879,5485,12364,14112828,14131230,28244058,0.0004377557927405
WA18,5p,9,C>T,7616,7058,14674,14112833,14131230,28244063,0.0005195428150687
WA18,5p,10,C>T,6853,6693,13546,14112791,14131213,28244004,0.0004796062201379
WA18,5p,11,C>T,9697,4861,14558,14112776,14131211,28243987,0.0005154371441963
WA18,5p,12,C>T,7376,7421,14797,14112682,14131223,28243905,0.0005239006433423
WA18,5p,13,C>T,7098,6417,13515,14112608,14131206,28243814,0.0004785118610397
WA18,5p,14,C>T,6312,6915,13227,14112535,14131179,28243714,0.0004683165960397
WA18,5p,15,C>T,8273,7807,16080,14112545,14131148,28243693,0.0005693306466686
WA18,5p,16,C>T,6273,5809,12082,14112522,14131083,28243605,0.0004277782528115
WA18,5p,17,C>T,6676,5458,12134,14112485,14130990,28243475,0.0004296213550209
WA18,5p,18,C>T,8268,6531,14799,14112481,14130987,28243468,0.0005239795622832
WA18,5p,19,C>T,7148,5112,12260,14112359,14130867,28243226,0.000434086389423
WA18,5p,20,C>T,7004,5545,12549,14112397,14130866,28243263,0.0004443183494768
WA18,5p,21,C>T,8381,5897,14278,14112347,14130679,28243026,0.0005055407306568
WA18,5p,22,C>T,7333,6617,13950,14112376,14129592,28241968,0.0004939457476901
WA18,5p,23,C>T,6740,4875,11615,14112288,14129275,28241563,0.0004112732712421
WA18,5p,24,C>T,9122,7293,16415,14112253,14129481,28241734,0.0005812320164193
WA18,5p,25,C>T,6998,6412,13410,14112273,14130551,28242824,0.0004748108758529
WA22,3p,1,C>T,5,2,7,1513709,1653397,3167106,2.210219676891143e-06
WA22,3p,2,C>T,23,49,72,1513709,1653396,3167105,2.2733695283231848e-05
WA22,3p,3,C>T,39,7,46,1513709,1653396,3167105,1.452430531984257e-05
WA22,3p,4,C>T,29,99,128,1513709,1653394,3167103,4.041548380333699e-05
WA22,3p,5,C>T,330,208,538,1513709,1653397,3167106,0.0001698711694524
WA22,3p,6,C>T,302,285,587,1513709,1653397,3167106,0.0001853427071907
WA22,3p,7,C>T,509,217,726,1513709,1653397,3167106,0.0002292313550604
WA22,3p,8,C>T,595,228,823,1513709,1653395,3167104,0.0002598588489673
WA22,3p,9,C>T,499,178,677,1513709,1653397,3167106,0.0002137598173221
WA22,3p,10,C>T,542,209,751,1513706,1653396,3167102,0.0002371252962487
WA22,3p,11,C>T,549,196,745,1513685,1653390,3167075,0.0002352328252409
WA22,3p,12,C>T,492,380,872,1513662,1653379,3167041,0.0002753358734541
WA22,3p,13,C>T,671,228,899,1513689,1653380,3167069,0.0002838586718508
WA22,3p,14,C>T,521,231,752,1513686,1653352,3167038,0.0002374458405614
WA22,3p,15,C>T,486,292,778,1513677,1653343,3167020,0.0002456568003991
WA22,3p,16,C>T,679,419,1098,1513637,1653341,3166978,0.0003467027557501
WA22,3p,17,C>T,662,324,986,1513671,1653319,3166990,0.0003113366319438
WA22,3p,18,C>T,505,228,733,1513665,1653288,3166953,0.0002314527560086
WA22,3p,19,C>T,588,462,1050,1513662,1653275,3166937,0.0003315506434134
WA22,3p,20,C>T,669,392,1061,1513684,1653304,3166988,0.0003350186360036
WA22,3p,21,C>T,624,336,960,1513677,1653327,3167004,0.000303125603883
WA22,3p,22,C>T,647,359,1006,1513684,1653356,3167040,0.0003176467616449
WA22,3p,23,C>T,603,229,832,1513676,1653329,3167005,0.0002627087737468
WA22,3p,24,C>T,581,264,845,1513672,1653285,3166957,0.0002668176422982
WA22,3p,25,C>T,548,348,896,1513669,1653296,3166965,0.0002829207143116
WA22,5p,1,C>T,2,3,5,1513709,1653397,3167106,1.5787283406365306e-06
WA22,5p,2,C>T,15,62,77,1513674,1653378,3167052,2.4312830986040013e-05
WA22,5p,3,C>T,33,110,143,1513709,1653397,3167106,4.5151630542204775e-05
WA22,5p,4,C>T,47,64,111,1513709,1653397,3167106,3.504776916213098e-05
WA22,5p,5,C>T,358,337,695,1513708,1653396,3167104,0.000219443377925
WA22,5p,6,C>T,465,297,762,1513704,1653397,3167101,0.0002405985789528
WA22,5p,7,C>T,453,351,804,1513707,1653397,3167104,0.0002538596774845
WA22,5p,8,C>T,625,365,990,1513692,1653397,3167089,0.0003125898893273
WA22,5p,9,C>T,556,233,789,1513700,1653389,3167089,0.000249124669373
WA22,5p,10,C>T,445,253,698,1513705,1653389,3167094,0.000220391311404
WA22,5p,11,C>T,399,178,577,1513699,1653381,3167080,0.000182186746151
WA22,5p,12,C>T,617,324,941,1513692,1653345,3167037,0.0002971231469667
WA22,5p,13,C>T,732,286,1018,1513697,1653377,3167074,0.0003214323378613
WA22,5p,14,C>T,507,334,841,1513677,1653376,3167053,0.0002655465506892
WA22,5p,15,C>T,579,302,881,1513695,1653381,3167076,0.0002781745685926
WA22,5p,16,C>T,536,334,870,1513668,1653368,3167036,0.0002747048028503
WA22,5p,17,C>T,748,384,1132,1513675,1653395,3167070,0.0003574281591502
WA22,5p,18,C>T,667,315,982,1513651,1653392,3167043,0.0003100684139748
WA22,5p,19,C>T,596,354,950,1513674,1653350,3167024,0.0002999661511879
WA22,5p,20,C>T,578,237,815,1513678,1653356,3167034,0.0002573385697785
WA22,5p,21,C>T,813,384,1197,1513690,1653371,3167061,0.0003779529349134
WA22,5p,22,C>T,670,296,966,1513691,1653380,3167071,0.0003050136861472
WA22,5p,23,C>T,598,270,868,1513634,1653393,3167027,0.0002740740764129
WA22,5p,24,C>T,701,191,892,1513632,1653375,3167007,0.0002816539401396
WA22,5p,25,C>T,573,255,828,1513644,1653364,3167008,0.0002614455031373
WA25,3p,1,C>T,7,24,31,3375244,3569089,6944333,4.464071639421669e-06
WA25,3p,2,C>T,28,376,404,3375244,3569089,6944333,5.817693362343079e-05
WA25,3p,3,C>T,83,243,326,3375244,3569089,6944333,4.694475336940207e-05
WA25,3p,4,C>T,101,168,269,3375244,3569087,6944331,3.873663280163345e-05
WA25,3p,5,C>T,782,674,1456,3375244,3569089,6944333,0.0002096673647418
WA25,3p,6,C>T,689,648,1337,3375244,3569089,6944333,0.0001925310897389
WA25,3p,7,C>T,792,764,1556,3375244,3569089,6944333,0.0002240675958367
WA25,3p,8,C>T,964,706,1670,3375239,3569076,6944315,0.0002404844826307
WA25,3p,9,C>T,979,787,1766,3375240,3569076,6944316,0.0002543087036937
WA25,3p,10,C>T,910,884,1794,3375240,3569075,6944315,0.0002583408154728
WA25,3p,11,C>T,1003,848,1851,3375233,3569054,6944287,0.0002665500432225
WA25,3p,12,C>T,766,748,1514,3375226,3569069,6944295,0.0002180206918052
WA25,3p,13,C>T,958,800,1758,3375230,3569053,6944283,0.0002531578854145
WA25,3p,14,C>T,1102,1228,2330,3375223,3569037,6944260,0.0003355289116478
WA25,3p,15,C>T,805,985,1790,3375218,3569039,6944257,0.0002577669576457
WA25,3p,16,C>T,893,861,1754,3375196,3569030,6944226,0.0002525839452805
WA25,3p,17,C>T,1019,1003,2022,3375198,3569022,6944220,0.0002911774108539
WA25,3p,18,C>T,1103,973,2076,3375213,3569006,6944219,0.000298953705233
WA25,3p,19,C>T,1066,799,1865,3375204,3569005,6944209,0.0002685691055669
WA25,3p,20,C>T,924,881,1805,3375190,3568979,6944169,0.0002599303098758
WA25,3p,21,C>T,941,919,1860,3375199,3568998,6944197,0.0002678495440149
WA25,3p,22,C>T,839,805,1644,3375179,3568994,6944173,0.0002367452538984
WA25,3p,23,C>T,937,756,1693,3375175,3568972,6944147,0.0002438024425462
WA25,3p,24,C>T,978,845,1823,3375177,3568962,6944139,0.0002625235468356
WA25,3p,25,C>T,957,893,1850,3375156,3568970,6944126,0.0002664122165986
WA25,5p,1,C>T,4,22,26,3375244,3569089,6944333,3.744060084676239e-06
WA25,5p,2,C>T,34,97,131,3375147,3569045,6944192,1.886468576905708e-05
WA25,5p,3,C>T,77,174,251,3375243,3569089,6944332,3.614458525312442e-05
WA25,5p,4,C>T,266,94,360,3375243,3569089,6944332,5.184083940687167e-05
WA25,5p,5,C>T,654,722,1376,3375244,3569088,6944332,0.0001981472083995
WA25,5p,6,C>T,747,657,1404,3375244,3569089,6944333,0.0002021792445725
WA25,5p,7,C>T,1247,743,1990,3375242,3569089,6944331,0.0002865646813206
WA25,5p,8,C>T,1000,1439,2439,3375221,3569088,6944309,0.0003512228502504
WA25,5p,9,C>T,1306,1036,2342,3375227,3569087,6944314,0.0003372543349854
WA25,5p,10,C>T,942,1081,2023,3375217,3569085,6944302,0.0002913179755143
WA25,5p,11,C>T,878,677,1555,3375193,3569088,6944281,0.0002239252703051
WA25,5p,12,C>T,941,978,1919,3375142,3569084,6944226,0.0002763446926986
WA25,5p,13,C>T,967,1506,2473,3375133,3569081,6944214,0.0003561238176127
WA25,5p,14,C>T,1021,1103,2124,3375151,3569071,6944222,0.0003058657974932
WA25,5p,15,C>T,1034,1327,2361,3375137,3569055,6944192,0.0003399963595476
WA25,5p,16,C>T,1352,1507,2859,3375081,3569035,6944116,0.0004117154724949
WA25,5p,17,C>T,959,1085,2044,3375076,3568871,6943947,0.0002943570853867
WA25,5p,18,C>T,1046,956,2002,3375102,3568996,6944098,0.0002883023828292
WA25,5p,19,C>T,1022,969,1991,3375134,3569021,6944155,0.0002867159503208
WA25,5p,20,C>T,981,910,1891,3375145,3569019,6944164,0.0002723149971688
WA25,5p,21,C>T,1265,744,2009,3375130,3569013,6944143,0.0002893085583058
WA25,5p,22,C>T,1012,798,1810,3375139,3569001,6944140,0.0002606514269585
WA25,5p,23,C>T,1176,703,1879,3375144,3569002,6944146,0.0002705876287739
WA25,5p,24,C>T,1256,935,2191,3375124,3568967,6944091,0.0003155200587089
WA25,5p,25,C>T,1196,1315,2511,3375125,3568950,6944075,0.0003616032372922
WA26,3p,1,C>T,22,12,34,2709623,2900126,5609749,6.060877233544674e-06
WA26,3p,2,C>T,353,53,406,2709623,2900126,5609749,7.237400461232758e-05
WA26,3p,3,C>T,29,58,87,2709623,2900126,5609749,1.5508715274070196e-05
WA26,3p,4,C>T,95,57,152,2709623,2900126,5609749,2.7095686455846776e-05
WA26,3p,5,C>T,818,515,1333,2709623,2900126,5609749,0.0002376220397739
WA26,3p,6,C>T,732,480,1212,2709623,2900126,5609749,0.0002160524472663
WA26,3p,7,C>T,704,539,1243,2709623,2900126,5609749,0.0002215785412145
WA26,3p,8,C>T,1030,604,1634,2709619,2900114,5609733,0.000291279460181
WA26,3p,9,C>T,1058,947,2005,2709613,2900111,5609724,0.0003574150885141
WA26,3p,10,C>T,1170,866,2036,2709609,2900074,5609683,0.000362943859751
WA26,3p,11,C>T,1229,697,1926,2709594,2900076,5609670,0.0003433357042392
WA26,3p,12,C>T,954,731,1685,2709607,2900081,5609688,0.0003003732114869
WA26,3p,13,C>T,1213,875,2088,2709604,2900084,5609688,0.0003722132139969
WA26,3p,14,C>T,1044,796,1840,2709584,2900069,5609653,0.0003280060281803
WA26,3p,15,C>T,1078,892,1970,2709593,2900082,5609675,0.0003511789898701
WA26,3p,16,C>T,1112,973,2085,2709580,2900075,5609655,0.0003716806113744
WA26,3p,17,C>T,1182,841,2023,2709570,2900078,5609648,0.0003606286882884
WA26,3p,18,C>T,1180,857,2037,2709582,2900059,5609641,0.0003631248416788
WA26,3p,19,C>T,1693,876,2569,2709567,2900016,5609583,0.0004579663051602
WA26,3p,20,C>T,1132,976,2108,2709563,2899983,5609546,0.0003757879871205
WA26,3p,21,C>T,1504,4464,5968,2709562,2900021,5609583,0.0010638936976242
WA26,3p,22,C>T,1376,3268,4644,2709522,2900007,5609529,0.0008278769928812
WA26,3p,23,C>T,1356,2417,3773,2709541,2899974,5609515,0.0006726071683559
WA26,3p,24,C>T,1255,4552,5807,2709558,2899951,5609509,0.0010352064681596
WA26,3p,25,C>T,1508,3948,5456,2709500,2900002,5609502,0.0009726353605008
WA26,5p,1,C>T,10,15,25,2709622,2900126,5609748,4.45652817203197e-06
WA26,5p,2,C>T,36,85,121,2709554,2900092,5609646,2.156998855186228e-05
WA26,5p,3,C>T,68,66,134,2709623,2900126,5609749,2.3886986743970185e-05
WA26,5p,4,C>T,113,192,305,2709623,2900126,5609749,5.436963400679781e-05
WA26,5p,5,C>T,649,717,1366,2709623,2900125,5609748,0.0002435046993198
WA26,5p,6,C>T,820,606,1426,2709621,2900126,5609747,0.0002542004122467
WA26,5p,7,C>T,1278,987,2265,2709622,2900126,5609748,0.000403761452386
WA26,5p,8,C>T,1104,923,2027,2709609,2900124,5609733,0.0003613362703715
WA26,5p,9,C>T,1295,1692,2987,2709594,2900123,5609717,0.0005324689284682
WA26,5p,10,C>T,1046,1000,2046,2709601,2900123,5609724,0.000364723825985
WA26,5p,11,C>T,890,729,1619,2709605,2900103,5609708,0.0002886068223158
WA26,5p,12,C>T,1012,1230,2242,2709595,2900107,5609702,0.0003996647237232
WA26,5p,13,C>T,1098,967,2065,2709592,2900104,5609696,0.0003681126392588
WA26,5p,14,C>T,1135,1577,2712,2709563,2900089,5609652,0.0004834524494567
WA26,5p,15,C>T,1167,1408,2575,2709545,2900085,5609630,0.0004590320573727
WA26,5p,16,C>T,1422,1386,2808,2709540,2900076,5609616,0.0005005690229063
WA26,5p,17,C>T,1090,841,1931,2709554,2900055,5609609,0.0003442307654597
WA26,5p,18,C>T,1709,917,2626,2709554,2900082,5609636,0.0004681230653824
WA26,5p,19,C>T,1550,790,2340,2709570,2900086,5609656,0.0004171378779732
WA26,5p,20,C>T,1212,944,2156,2709563,2900082,5609645,0.0003843380463469
WA26,5p,21,C>T,1229,1030,2259,2709545,2900061,5609606,0.0004027020792547
WA26,5p,22,C>T,1205,1579,2784,2709542,2900059,5609601,0.0004962919822639
WA26,5p,23,C>T,1092,1416,2508,2709528,2900065,5609593,0.0004470912595619
WA26,5p,24,C>T,1432,2118,3550,2709495,2900057,5609552,0.0006328491116581
WA26,5p,25,C>T,1325,1620,2945,2709506,2900041,5609547,0.000524997829593
