Sample,End,Position,Substitution,Pos_Count,Neg_Count,Combined_Count,Pos_Total,Neg_Total,Combined_Total,Frequency
DAL192,3p,1,C>G,5,4,9,6350003,6167708,12517711,7.189812897901222e-07
DAL192,3p,2,C>G,49,42,91,6350003,6167706,12517709,7.269700869384326e-06
DAL192,3p,3,C>G,33,65,98,6350003,6167708,12517711,7.828907377714664e-06
DAL192,3p,4,C>G,102,49,151,6350003,6167708,12517711,1.2062908306478716e-05
DAL192,3p,5,C>G,204,131,335,6350003,6167708,12517711,2.676208134218788e-05
DAL192,3p,6,C>G,225,128,353,6350003,6167708,12517711,2.8200043921768127e-05
DAL192,3p,7,C>G,149,141,290,6350003,6167708,12517711,2.316717489323727e-05
DAL192,3p,8,C>G,241,157,398,6350003,6167618,12517621,3.17951789721066e-05
DAL192,3p,9,C>G,292,195,487,6350003,6167637,12517640,3.890509712693447e-05
DAL192,3p,10,C>G,208,306,514,6350003,6167645,12517648,4.106202698781752e-05
DAL192,3p,11,C>G,194,265,459,6349987,6167644,12517631,3.666828012425035e-05
DAL192,3p,12,C>G,254,291,545,6349997,6167646,12517643,4.35385479518788e-05
DAL192,3p,13,C>G,221,279,500,6349992,6167621,12517613,3.994371770400635e-05
DAL192,3p,14,C>G,259,283,542,6349967,6167610,12517577,4.3299114517130594e-05
DAL192,3p,15,C>G,280,362,642,6349968,6167615,12517583,5.128785644960373e-05
DAL192,3p,16,C>G,339,364,703,6349943,6167587,12517530,5.616123947775639e-05
DAL192,3p,17,C>G,332,409,741,6349922,6167606,12517528,5.9196991610484114e-05
DAL192,3p,18,C>G,341,471,812,6349922,6167564,12517486,6.486925569559255e-05
DAL192,3p,19,C>G,306,310,616,6349921,6167519,12517440,4.921134033796048e-05
DAL192,3p,20,C>G,386,341,727,6349910,6167516,12517426,5.807903318142245e-05
DAL192,3p,21,C>G,359,341,700,6349882,6167507,12517389,5.592220550148278e-05
DAL192,3p,22,C>G,383,413,796,6349894,6167488,12517382,6.359157210349576e-05
DAL192,3p,23,C>G,418,428,846,6349902,6167465,12517367,6.758609857807956e-05
DAL192,3p,24,C>G,328,407,735,6349899,6167465,12517364,5.871843305028119e-05
DAL192,3p,25,C>G,362,339,701,6349856,6167384,12517240,5.600276099203978e-05
DAL192,5p,1,C>G,2,11,13,6350003,6167708,12517711,1.0385285296968431e-06
DAL192,5p,2,C>G,34,34,68,6349992,6167694,12517686,5.432313927670018e-06
DAL192,5p,3,C>G,25,24,49,6350003,6167707,12517710,3.914454001570575e-06
DAL192,5p,4,C>G,139,166,305,6350003,6167708,12517711,2.4365477042887476e-05
DAL192,5p,5,C>G,216,215,431,6350003,6167707,12517710,3.443121785054934e-05
DAL192,5p,6,C>G,159,226,385,6350002,6167707,12517709,3.0756426755087535e-05
DAL192,5p,7,C>G,133,462,595,6350002,6167708,12517710,4.753265573335698e-05
DAL192,5p,8,C>G,269,293,562,6349926,6167708,12517634,4.4896663379037925e-05
DAL192,5p,9,C>G,415,337,752,6349914,6167708,12517622,6.007530823346479e-05
DAL192,5p,10,C>G,324,414,738,6349896,6167708,12517604,5.8956969720403365e-05
DAL192,5p,11,C>G,513,302,815,6349942,6167706,12517648,6.510807781142272e-05
DAL192,5p,12,C>G,525,350,875,6349906,6167700,12517606,6.990154507179728e-05
DAL192,5p,13,C>G,333,359,692,6349906,6167705,12517611,5.528211413503743e-05
DAL192,5p,14,C>G,364,461,825,6349889,6167679,12517568,6.590737114429896e-05
DAL192,5p,15,C>G,636,981,1617,6349890,6167649,12517539,0.0001291787467169
DAL192,5p,16,C>G,409,596,1005,6349904,6167639,12517543,8.028732156142783e-05
DAL192,5p,17,C>G,405,385,790,6349778,6167623,12517401,6.31121428481839e-05
DAL192,5p,18,C>G,390,378,768,6349859,6167631,12517490,6.135415326874636e-05
DAL192,5p,19,C>G,344,1008,1352,6349822,6167638,12517460,0.0001080091328432
DAL192,5p,20,C>G,398,645,1043,6349836,6167621,12517457,8.332363354633454e-05
DAL192,5p,21,C>G,458,517,975,6349784,6167624,12517408,7.789152514642009e-05
DAL192,5p,22,C>G,465,728,1193,6349783,6167584,12517367,9.530758345584978e-05
DAL192,5p,23,C>G,405,670,1075,6349801,6167567,12517368,8.588067395637805e-05
DAL192,5p,24,C>G,370,549,919,6349759,6167564,12517323,7.341825404681177e-05
DAL192,5p,25,C>G,391,534,925,6349777,6167551,12517328,7.389756024608447e-05
DAL193,3p,1,C>G,24,26,50,6484405,6362696,12847101,3.891928614868054e-06
DAL193,3p,2,C>G,24,129,153,6484402,6362696,12847098,1.1909304342505987e-05
DAL193,3p,3,C>G,76,161,237,6484405,6362696,12847101,1.8447741634474574e-05
DAL193,3p,4,C>G,154,265,419,6484405,6362696,12847101,3.26143617925943e-05
DAL193,3p,5,C>G,736,855,1591,6484405,6362696,12847101,0.0001238411685251
DAL193,3p,6,C>G,976,737,1713,6484405,6362696,12847101,0.0001333374743453
DAL193,3p,7,C>G,1136,852,1988,6484405,6362696,12847101,0.0001547430817271
DAL193,3p,8,C>G,1197,1060,2257,6484400,6362644,12847044,0.0001756824371427
DAL193,3p,9,C>G,1526,1291,2817,6484400,6362631,12847031,0.0002192724529114
DAL193,3p,10,C>G,1154,970,2124,6484393,6362640,12847033,0.000165330002655
DAL193,3p,11,C>G,1130,2147,3277,6484398,6362639,12847037,0.0002550782721338
DAL193,3p,12,C>G,1497,1260,2757,6484368,6362594,12846962,0.000214603265737
DAL193,3p,13,C>G,1343,1022,2365,6484385,6362543,12846928,0.000184090702462
DAL193,3p,14,C>G,1286,993,2279,6484363,6362486,12846849,0.0001773975859761
DAL193,3p,15,C>G,1194,1442,2636,6484332,6362438,12846770,0.0002051877631498
DAL193,3p,16,C>G,1307,1047,2354,6484341,6362460,12846801,0.000183236278043
DAL193,3p,17,C>G,1142,1202,2344,6484294,6362445,12846739,0.0001824587547081
DAL193,3p,18,C>G,1339,1328,2667,6484244,6362380,12846624,0.0002076031804153
DAL193,3p,19,C>G,1235,1025,2260,6484265,6362400,12846665,0.0001759211437365
DAL193,3p,20,C>G,1340,1051,2391,6484261,6362382,12846643,0.0001861186615055
DAL193,3p,21,C>G,1261,1606,2867,6484248,6362443,12846691,0.0002231703089924
DAL193,3p,22,C>G,1370,1104,2474,6484224,6362407,12846631,0.0001925796732232
DAL193,3p,23,C>G,1529,1073,2602,6484218,6362399,12846617,0.0002025435957186
DAL193,3p,24,C>G,1678,1292,2970,6484164,6362319,12846483,0.0002311916810227
DAL193,3p,25,C>G,1310,1318,2628,6484128,6362355,12846483,0.0002045696086625
DAL193,5p,1,C>G,22,40,62,6484405,6362696,12847101,4.825991482436387e-06
DAL193,5p,2,C>G,68,208,276,6484386,6362681,12847067,2.148350281040801e-05
DAL193,5p,3,C>G,88,161,249,6484400,6362696,12847096,1.9381812045305804e-05
DAL193,5p,4,C>G,216,384,600,6484403,6362696,12847099,4.6703150649029794e-05
DAL193,5p,5,C>G,964,1040,2004,6484403,6362696,12847099,0.0001559885231677
DAL193,5p,6,C>G,787,865,1652,6484404,6362696,12847100,0.0001285893314444
DAL193,5p,7,C>G,586,775,1361,6484404,6362696,12847100,0.0001059383051427
DAL193,5p,8,C>G,784,972,1756,6484314,6362693,12847007,0.0001366855330584
DAL193,5p,9,C>G,1240,1351,2591,6484295,6362695,12846990,0.0002016814833669
DAL193,5p,10,C>G,1223,1085,2308,6484284,6362694,12846978,0.0001796531448874
DAL193,5p,11,C>G,1320,1430,2750,6484315,6362677,12846992,0.0002140578899714
DAL193,5p,12,C>G,1416,1151,2567,6484218,6362670,12846888,0.000199814927942
DAL193,5p,13,C>G,1371,1461,2832,6484143,6362652,12846795,0.0002204440874163
DAL193,5p,14,C>G,1452,1304,2756,6484145,6362627,12846772,0.0002145285990908
DAL193,5p,15,C>G,1258,1488,2746,6484166,6362534,12846700,0.0002137513914079
DAL193,5p,16,C>G,1235,1965,3200,6484111,6362519,12846630,0.000249092563575
DAL193,5p,17,C>G,1280,1366,2646,6484043,6362598,12846641,0.0002059682371446
DAL193,5p,18,C>G,1334,1467,2801,6483967,6362571,12846538,0.0002180353959954
DAL193,5p,19,C>G,1466,1204,2670,6483980,6362593,12846573,0.0002078375298999
DAL193,5p,20,C>G,1303,1202,2505,6483952,6362554,12846506,0.0001949946545776
DAL193,5p,21,C>G,1489,1398,2887,6484003,6362532,12846535,0.0002247298590631
DAL193,5p,22,C>G,1578,1281,2859,6484010,6362499,12846509,0.0002225507334327
DAL193,5p,23,C>G,2053,1175,3228,6483966,6362463,12846429,0.0002512760550033
DAL193,5p,24,C>G,1499,1258,2757,6483905,6362426,12846331,0.0002146138068527
DAL193,5p,25,C>G,1737,1464,3201,6483942,6362403,12846345,0.0002491759329209
DAL195,3p,1,C>G,11,1,12,2363278,2267461,4630739,2.5913790433881077e-06
DAL195,3p,2,C>G,118,24,142,2363278,2267460,4630738,3.0664658635405414e-05
DAL195,3p,3,C>G,28,30,58,2363278,2267461,4630739,1.2524998709709183e-05
DAL195,3p,4,C>G,37,40,77,2363278,2267461,4630739,1.662801552840702e-05
DAL195,3p,5,C>G,133,183,316,2363278,2267461,4630739,6.823964814255348e-05
DAL195,3p,6,C>G,194,175,369,2363278,2267461,4630739,7.968490558418429e-05
DAL195,3p,7,C>G,141,155,296,2363278,2267461,4630739,6.392068307023998e-05
DAL195,3p,8,C>G,267,177,444,2363278,2267413,4630691,9.58820184719732e-05
DAL195,3p,9,C>G,224,202,426,2363276,2267438,4630714,9.199445269131283e-05
DAL195,3p,10,C>G,267,184,451,2363274,2267432,4630706,9.739335643420249e-05
DAL195,3p,11,C>G,364,170,534,2363274,2267431,4630705,0.0001153172141175
DAL195,3p,12,C>G,272,216,488,2363273,2267414,4630687,0.0001053839311531
DAL195,3p,13,C>G,358,364,722,2363269,2267412,4630681,0.0001559165919656
DAL195,3p,14,C>G,237,232,469,2363250,2267410,4630660,0.0001012814587985
DAL195,3p,15,C>G,294,255,549,2363254,2267411,4630665,0.0001185574858038
DAL195,3p,16,C>G,159,195,354,2363259,2267394,4630653,7.644710152110296e-05
DAL195,3p,17,C>G,200,234,434,2363234,2267398,4630632,9.372370769260006e-05
DAL195,3p,18,C>G,195,264,459,2363236,2267374,4630610,9.91230097114635e-05
DAL195,3p,19,C>G,212,273,485,2363215,2267369,4630584,0.0001047384088054
DAL195,3p,20,C>G,375,310,685,2363222,2267380,4630602,0.0001479289301909
DAL195,3p,21,C>G,423,299,722,2363235,2267382,4630617,0.000155918746897
DAL195,3p,22,C>G,225,276,501,2363231,2267383,4630614,0.0001081929955725
DAL195,3p,23,C>G,395,235,630,2363219,2267370,4630589,0.0001360518068003
DAL195,3p,24,C>G,297,260,557,2363198,2267373,4630571,0.0001202875412125
DAL195,3p,25,C>G,246,291,537,2363180,2267377,4630557,0.0001159687700637
DAL195,5p,1,C>G,1,16,17,2363278,2267461,4630739,3.671120311466485e-06
DAL195,5p,2,C>G,5,16,21,2363264,2267447,4630711,4.534940746680154e-06
DAL195,5p,3,C>G,11,30,41,2363278,2267459,4630737,8.853882222203507e-06
DAL195,5p,4,C>G,48,46,94,2363278,2267461,4630739,2.0299135839873506e-05
DAL195,5p,5,C>G,291,235,526,2363277,2267461,4630738,0.0001135888059311
DAL195,5p,6,C>G,286,137,423,2363277,2267461,4630738,9.134613100546824e-05
DAL195,5p,7,C>G,206,149,355,2363277,2267461,4630738,7.666164658851354e-05
DAL195,5p,8,C>G,295,152,447,2363212,2267460,4630672,9.653026601754562e-05
DAL195,5p,9,C>G,302,181,483,2363181,2267461,4630642,0.0001043051913751
DAL195,5p,10,C>G,742,179,921,2363146,2267458,4630604,0.0001988941399437
DAL195,5p,11,C>G,391,271,662,2362948,2267450,4630398,0.0001429682718418
DAL195,5p,12,C>G,251,291,542,2362864,2267454,4630318,0.0001170545953863
DAL195,5p,13,C>G,303,371,674,2363073,2267445,4630518,0.0001455560695369
DAL195,5p,14,C>G,278,249,527,2363094,2267434,4630528,0.0001138099154135
DAL195,5p,15,C>G,244,179,423,2363178,2267432,4630610,9.134865600860362e-05
DAL195,5p,16,C>G,402,249,651,2363170,2267429,4630599,0.000140586563423
DAL195,5p,17,C>G,229,270,499,2363159,2267431,4630590,0.0001077616459241
DAL195,5p,18,C>G,288,272,560,2363182,2267420,4630602,0.0001209345998641
DAL195,5p,19,C>G,363,318,681,2363138,2267420,4630558,0.000147066509047
DAL195,5p,20,C>G,366,351,717,2363110,2267401,4630511,0.0001548425217
DAL195,5p,21,C>G,477,305,782,2363086,2267400,4630486,0.0001688807611123
DAL195,5p,22,C>G,643,288,931,2363094,2267388,4630482,0.0002010589826285
DAL195,5p,23,C>G,538,252,790,2363068,2267398,4630466,0.0001706091784282
DAL195,5p,24,C>G,474,242,716,2363067,2267402,4630469,0.0001546279653313
DAL195,5p,25,C>G,402,168,570,2363135,2267374,4630509,0.0001230966185358
DAL212,3p,1,C>G,8,11,19,4131322,4008153,8139475,2.334302888085534e-06
DAL212,3p,2,C>G,146,48,194,4131322,4008153,8139475,2.3834461067820712e-05
DAL212,3p,3,C>G,20,31,51,4131322,4008153,8139475,6.265760383808538e-06
DAL212,3p,4,C>G,126,79,205,4131322,4008153,8139475,2.5185899581975497e-05
DAL212,3p,5,C>G,335,312,647,4131322,4008151,8139473,7.948917577341924e-05
DAL212,3p,6,C>G,438,368,806,4131322,4008151,8139473,9.902361000521778e-05
DAL212,3p,7,C>G,326,288,614,4131322,4008153,8139475,7.543484069918515e-05
DAL212,3p,8,C>G,330,314,644,4131319,4008093,8139412,7.912119450397646e-05
DAL212,3p,9,C>G,446,421,867,4131316,4008115,8139431,0.0001065185023375
DAL212,3p,10,C>G,385,364,749,4131317,4008102,8139419,9.202131012053807e-05
DAL212,3p,11,C>G,415,395,810,4131313,4008105,8139418,9.951571475994968e-05
DAL212,3p,12,C>G,496,558,1054,4131314,4008034,8139348,0.0001294944017628
DAL212,3p,13,C>G,313,417,730,4131307,4007923,8139230,8.968907378216368e-05
DAL212,3p,14,C>G,389,549,938,4131271,4007904,8139175,0.0001152450954795
DAL212,3p,15,C>G,423,441,864,4131254,4007935,8139189,0.0001061530823279
DAL212,3p,16,C>G,444,429,873,4131236,4007982,8139218,0.0001072584614394
DAL212,3p,17,C>G,583,443,1026,4131249,4007981,8139230,0.0001260561502746
DAL212,3p,18,C>G,419,543,962,4131222,4007954,8139176,0.0001181937827613
DAL212,3p,19,C>G,409,442,851,4131233,4007956,8139189,0.0001045558715985
DAL212,3p,20,C>G,403,411,814,4131221,4007928,8139149,0.0001000104556385
DAL212,3p,21,C>G,429,556,985,4131228,4007917,8139145,0.0001210200825762
DAL212,3p,22,C>G,420,497,917,4131183,4007898,8139081,0.0001126662825938
DAL212,3p,23,C>G,453,540,993,4131172,4007904,8139076,0.0001220040210952
DAL212,3p,24,C>G,395,475,870,4131124,4007904,8139028,0.0001068923709317
DAL212,3p,25,C>G,468,449,917,4131071,4007924,8138995,0.0001126674730725
DAL212,5p,1,C>G,16,9,25,4131322,4008153,8139475,3.071451168533597e-06
DAL212,5p,2,C>G,22,23,45,4131307,4008143,8139450,5.528629084274736e-06
DAL212,5p,3,C>G,13,37,50,4131321,4008153,8139474,6.142903091772269e-06
DAL212,5p,4,C>G,118,137,255,4131322,4008153,8139475,3.132880191904269e-05
DAL212,5p,5,C>G,311,466,777,4131322,4008153,8139475,9.54607023180242e-05
DAL212,5p,6,C>G,196,207,403,4131322,4008153,8139475,4.951179283676158e-05
DAL212,5p,7,C>G,214,208,422,4131322,4008153,8139475,5.184609572484712e-05
DAL212,5p,8,C>G,327,298,625,4131248,4008153,8139401,7.678697732179555e-05
DAL212,5p,9,C>G,357,432,789,4131243,4008153,8139396,9.693593971837712e-05
DAL212,5p,10,C>G,486,519,1005,4131179,4008148,8139327,0.0001234745821122
DAL212,5p,11,C>G,416,531,947,4131234,4008143,8139377,0.0001163479711039
DAL212,5p,12,C>G,375,515,890,4131187,4008141,8139328,0.0001093456363965
DAL212,5p,13,C>G,463,684,1147,4131181,4008142,8139323,0.0001409208112271
DAL212,5p,14,C>G,395,464,859,4131134,4008108,8139242,0.000105538083276
DAL212,5p,15,C>G,417,600,1017,4131156,4008091,8139247,0.0001249501335934
DAL212,5p,16,C>G,367,526,893,4131154,4008081,8139235,0.0001097154708028
DAL212,5p,17,C>G,505,426,931,4131159,4008081,8139240,0.0001143841439741
DAL212,5p,18,C>G,456,529,985,4131113,4008066,8139179,0.0001210195770359
DAL212,5p,19,C>G,549,487,1036,4131040,4008052,8139092,0.0001272869258634
DAL212,5p,20,C>G,425,602,1027,4131020,4008040,8139060,0.0001261816475121
DAL212,5p,21,C>G,450,599,1049,4130973,4008040,8139013,0.0001288854066211
DAL212,5p,22,C>G,437,495,932,4131015,4007967,8138982,0.0001145106353595
DAL212,5p,23,C>G,470,484,954,4131005,4007962,8138967,0.0001172138921315
DAL212,5p,24,C>G,518,418,936,4131060,4007918,8138978,0.000115002153833
DAL212,5p,25,C>G,497,508,1005,4131016,4007614,8138630,0.0001234851565926
DAL218,3p,1,C>G,48,22,70,6952891,6658031,13610922,5.1429285980773385e-06
DAL218,3p,2,C>G,121,175,296,6952891,6658031,13610922,2.1747240929012743e-05
DAL218,3p,3,C>G,51,227,278,6952891,6658030,13610921,2.0424775075838e-05
DAL218,3p,4,C>G,146,324,470,6952891,6658031,13610922,3.453109201566213e-05
DAL218,3p,5,C>G,741,1061,1802,6952891,6658031,13610922,0.0001323936761962
DAL218,3p,6,C>G,1433,1146,2579,6952891,6658030,13610921,0.000189480197556
DAL218,3p,7,C>G,889,1280,2169,6952891,6658026,13610917,0.0001593573746721
DAL218,3p,8,C>G,2229,1618,3847,6952887,6657945,13610832,0.0002826425305962
DAL218,3p,9,C>G,1024,1560,2584,6952882,6657945,13610827,0.0001898488607635
DAL218,3p,10,C>G,954,1292,2246,6952881,6657960,13610841,0.0001650155196141
DAL218,3p,11,C>G,1132,1230,2362,6952866,6657905,13610771,0.0001735390302283
DAL218,3p,12,C>G,1220,1310,2530,6952858,6657882,13610740,0.0001858826191669
DAL218,3p,13,C>G,907,1825,2732,6952870,6657811,13610681,0.0002007247102477
DAL218,3p,14,C>G,1549,1243,2792,6952816,6657779,13610595,0.0002051343089703
DAL218,3p,15,C>G,1057,1267,2324,6952788,6657738,13610526,0.0001707501973105
DAL218,3p,16,C>G,1126,1046,2172,6952760,6657689,13610449,0.0001595832731161
DAL218,3p,17,C>G,1214,1239,2453,6952737,6657651,13610388,0.0001802299831569
DAL218,3p,18,C>G,1168,2752,3920,6952711,6657672,13610383,0.0002880154070609
DAL218,3p,19,C>G,1692,3015,4707,6952716,6657697,13610413,0.0003458381461312
DAL218,3p,20,C>G,1166,2347,3513,6952697,6657752,13610449,0.0002581105149433
DAL218,3p,21,C>G,1521,2420,3941,6952660,6657692,13610352,0.0002895590062622
DAL218,3p,22,C>G,1371,1456,2827,6952654,6657637,13610291,0.0002077104743756
DAL218,3p,23,C>G,1284,1764,3048,6952651,6657632,13610283,0.000223948319076
DAL218,3p,24,C>G,1514,1507,3021,6952669,6657588,13610257,0.0002219649489352
DAL218,3p,25,C>G,1214,2291,3505,6952605,6657566,13610171,0.0002575279913823
DAL218,5p,1,C>G,11,33,44,6952891,6658031,13610922,3.232697975934327e-06
DAL218,5p,2,C>G,74,57,131,6952874,6658014,13610888,9.624647561569826e-06
DAL218,5p,3,C>G,102,309,411,6952891,6658031,13610922,3.0196337911568373e-05
DAL218,5p,4,C>G,282,302,584,6952891,6658031,13610922,4.2906718589673793e-05
DAL218,5p,5,C>G,1169,1378,2547,6952891,6658031,13610922,0.0001871291305614
DAL218,5p,6,C>G,937,1335,2272,6952891,6658031,13610922,0.0001669247682118
DAL218,5p,7,C>G,774,1365,2139,6952888,6658031,13610919,0.0001571532385138
DAL218,5p,8,C>G,807,2850,3657,6952719,6658029,13610748,0.0002686847188707
DAL218,5p,9,C>G,3305,1690,4995,6952736,6658029,13610765,0.0003669889238407
DAL218,5p,10,C>G,1005,2398,3403,6952716,6658028,13610744,0.0002500230700099
DAL218,5p,11,C>G,1132,1509,2641,6952715,6658016,13610731,0.0001940380718713
DAL218,5p,12,C>G,1581,1173,2754,6952625,6658005,13610630,0.0002023418460423
DAL218,5p,13,C>G,1420,1837,3257,6952475,6658005,13610480,0.0002393008916658
DAL218,5p,14,C>G,3171,1467,4638,6952554,6657955,13610509,0.0003407660947874
DAL218,5p,15,C>G,1400,1869,3269,6952449,6657923,13610372,0.0002401844710783
DAL218,5p,16,C>G,1471,1461,2932,6952253,6657920,13610173,0.0002154270926607
DAL218,5p,17,C>G,1350,1394,2744,6952350,6657874,13610224,0.0002016131402392
DAL218,5p,18,C>G,1232,1380,2612,6952457,6657843,13610300,0.0001919134772929
DAL218,5p,19,C>G,2290,1519,3809,6952296,6657770,13610066,0.0002798663871284
DAL218,5p,20,C>G,1531,1308,2839,6952289,6657772,13610061,0.0002085956852067
DAL218,5p,21,C>G,1338,1865,3203,6952371,6657729,13610100,0.0002353399313744
DAL218,5p,22,C>G,1551,1400,2951,6952322,6657786,13610108,0.0002168241427621
DAL218,5p,23,C>G,1214,1531,2745,6952288,6657745,13610033,0.0002016894448382
DAL218,5p,24,C>G,1864,1356,3220,6952375,6657772,13610147,0.0002365881867403
DAL218,5p,25,C>G,2470,1203,3673,6952272,6657720,13609992,0.0002698752504777
DAL224,3p,1,C>G,18,14,32,4609472,4586477,9195949,3.479793113250193e-06
DAL224,3p,2,C>G,27,90,117,4609471,4586476,9195947,1.2722996337408208e-05
DAL224,3p,3,C>G,61,82,143,4609472,4586477,9195949,1.55503254748368e-05
DAL224,3p,4,C>G,109,186,295,4609472,4586477,9195949,3.207934276277522e-05
DAL224,3p,5,C>G,388,435,823,4609472,4586477,9195949,8.94959291314034e-05
DAL224,3p,6,C>G,446,1109,1555,4609472,4586477,9195949,0.000169096196597
DAL224,3p,7,C>G,769,263,1032,4609472,4586476,9195948,0.0001122233401058
DAL224,3p,8,C>G,552,402,954,4609469,4586423,9195892,0.0001037419752211
DAL224,3p,9,C>G,584,518,1102,4609466,4586431,9195897,0.0001198360529701
DAL224,3p,10,C>G,450,542,992,4609461,4586371,9195832,0.0001078749590031
DAL224,3p,11,C>G,802,618,1420,4609461,4586382,9195843,0.0001544175993435
DAL224,3p,12,C>G,455,603,1058,4609458,4586384,9195842,0.000115051998501
DAL224,3p,13,C>G,1549,621,2170,4609454,4586364,9195818,0.0002359768320773
DAL224,3p,14,C>G,577,661,1238,4609412,4586293,9195705,0.0001346280682122
DAL224,3p,15,C>G,397,411,808,4609400,4586272,9195672,8.786742284848785e-05
DAL224,3p,16,C>G,800,532,1332,4609379,4586240,9195619,0.0001448515863913
DAL224,3p,17,C>G,475,551,1026,4609381,4586216,9195597,0.0001115751375359
DAL224,3p,18,C>G,431,497,928,4609363,4586282,9195645,0.000100917336413
DAL224,3p,19,C>G,462,595,1057,4609353,4586195,9195548,0.0001149469286659
DAL224,3p,20,C>G,426,488,914,4609344,4586225,9195569,9.939569808023842e-05
DAL224,3p,21,C>G,461,994,1455,4609343,4586223,9195566,0.0001582284331383
DAL224,3p,22,C>G,1184,922,2106,4609324,4586172,9195496,0.0002290251662335
DAL224,3p,23,C>G,989,771,1760,4609323,4586083,9195406,0.0001913999229615
DAL224,3p,24,C>G,687,982,1669,4609325,4586202,9195527,0.0001815012886156
DAL224,3p,25,C>G,721,1866,2587,4609265,4586173,9195438,0.0002813351577162
DAL224,5p,1,C>G,12,9,21,4609472,4586477,9195949,2.283614230570439e-06
DAL224,5p,2,C>G,181,123,304,4609461,4586469,9195930,3.305810287812108e-05
DAL224,5p,3,C>G,465,50,515,4609468,4586477,9195945,5.600294477620299e-05
DAL224,5p,4,C>G,76,69,145,4609471,4586477,9195948,1.5767814259062798e-05
DAL224,5p,5,C>G,245,270,515,4609471,4586477,9195948,5.600292650632648e-05
DAL224,5p,6,C>G,314,223,537,4609472,4586477,9195949,5.83952781817298e-05
DAL224,5p,7,C>G,291,359,650,4609471,4586477,9195948,7.068330529924701e-05
DAL224,5p,8,C>G,359,299,658,4609397,4586477,9195874,7.15538294674329e-05
DAL224,5p,9,C>G,390,365,755,4609357,4586473,9195830,8.210243121066831e-05
DAL224,5p,10,C>G,628,524,1152,4609338,4586470,9195808,0.0001252744728902
DAL224,5p,11,C>G,1055,451,1506,4609388,4586469,9195857,0.0001637694018077
DAL224,5p,12,C>G,898,447,1345,4609357,4586464,9195821,0.0001462620901385
DAL224,5p,13,C>G,1061,555,1616,4609320,4586461,9195781,0.0001757327626658
DAL224,5p,14,C>G,412,507,919,4609270,4586428,9195698,9.993803624259952e-05
DAL224,5p,15,C>G,798,693,1491,4609299,4586416,9195715,0.0001621407362015
DAL224,5p,16,C>G,732,771,1503,4609292,4586373,9195665,0.0001634465805355
DAL224,5p,17,C>G,704,685,1389,4609285,4586385,9195670,0.0001510493525757
DAL224,5p,18,C>G,1272,818,2090,4609226,4586351,9195577,0.0002272831819036
DAL224,5p,19,C>G,2126,642,2768,4609203,4586337,9195540,0.000301015492293
DAL224,5p,20,C>G,1214,917,2131,4609148,4586313,9195461,0.0002317447705993
DAL224,5p,21,C>G,1460,1203,2663,4609195,4586347,9195542,0.0002895968502998
DAL224,5p,22,C>G,1140,871,2011,4609138,4586312,9195450,0.000218695115519
DAL224,5p,23,C>G,1776,1385,3161,4609100,4586313,9195413,0.0003437583499512
DAL224,5p,24,C>G,2077,1310,3387,4609109,4586316,9195425,0.0003683353406721
DAL224,5p,25,C>G,1654,1126,2780,4609125,4586257,9195382,0.0003023256673839
DAL227,3p,1,C>G,8,9,17,3765386,3771243,7536629,2.2556503710080463e-06
DAL227,3p,2,C>G,22,27,49,3765386,3771243,7536629,6.501580481140839e-06
DAL227,3p,3,C>G,31,57,88,3765386,3771243,7536629,1.167630780286518e-05
DAL227,3p,4,C>G,37,33,70,3765386,3771243,7536629,9.287972115915485e-06
DAL227,3p,5,C>G,134,102,236,3765386,3771243,7536629,3.1313734562229345e-05
DAL227,3p,6,C>G,131,131,262,3765386,3771243,7536629,3.476355277671224e-05
DAL227,3p,7,C>G,144,122,266,3765386,3771243,7536629,3.529429404047884e-05
DAL227,3p,8,C>G,143,152,295,3765386,3771207,7536593,3.914235517295414e-05
DAL227,3p,9,C>G,348,125,473,3765384,3771218,7536602,6.276037927968069e-05
DAL227,3p,10,C>G,189,185,374,3765382,3771209,7536591,4.962455837128484e-05
DAL227,3p,11,C>G,135,233,368,3765378,3771214,7536592,4.882843598273597e-05
DAL227,3p,12,C>G,178,152,330,3765377,3771173,7536550,4.378661323815273e-05
DAL227,3p,13,C>G,174,283,457,3765373,3771183,7536556,6.0637776724541024e-05
DAL227,3p,14,C>G,276,249,525,3765341,3771166,7536507,6.96609185130459e-05
DAL227,3p,15,C>G,250,351,601,3765341,3771186,7536527,7.974495414134388e-05
DAL227,3p,16,C>G,215,281,496,3765340,3771079,7536419,6.581375053589776e-05
DAL227,3p,17,C>G,261,301,562,3765328,3771049,7536377,7.457164098876688e-05
DAL227,3p,18,C>G,269,353,622,3765321,3771036,7536357,8.253324517402772e-05
DAL227,3p,19,C>G,225,236,461,3765313,3771111,7536424,6.116959449202964e-05
DAL227,3p,20,C>G,295,273,568,3765308,3771082,7536390,7.536764949796919e-05
DAL227,3p,21,C>G,291,456,747,3765307,3771104,7536411,9.911879805918228e-05
DAL227,3p,22,C>G,275,238,513,3765309,3771137,7536446,6.806921989489476e-05
DAL227,3p,23,C>G,266,274,540,3765319,3771112,7536431,7.165195302657187e-05
DAL227,3p,24,C>G,403,302,705,3765312,3771081,7536393,9.354607701588812e-05
DAL227,3p,25,C>G,231,218,449,3765249,3771100,7536349,5.957792029005026e-05
DAL227,5p,1,C>G,0,26,26,3765386,3771243,7536629,3.449818214482894e-06
DAL227,5p,2,C>G,6,20,26,3765373,3771238,7536611,3.449826453826528e-06
DAL227,5p,3,C>G,16,30,46,3765386,3771243,7536629,6.10352453331589e-06
DAL227,5p,4,C>G,26,55,81,3765385,3771243,7536628,1.074751201731066e-05
DAL227,5p,5,C>G,166,154,320,3765386,3771242,7536628,4.245930673505446e-05
DAL227,5p,6,C>G,143,99,242,3765386,3771243,7536629,3.2109846457879246e-05
DAL227,5p,7,C>G,101,81,182,3765386,3771243,7536629,2.414872750138026e-05
DAL227,5p,8,C>G,183,104,287,3765342,3771242,7536584,3.808091305026256e-05
DAL227,5p,9,C>G,360,354,714,3765324,3771243,7536567,9.473809494428964e-05
DAL227,5p,10,C>G,281,186,467,3765318,3771238,7536556,6.196464273601894e-05
DAL227,5p,11,C>G,279,264,543,3765365,3771237,7536602,7.204838466990827e-05
DAL227,5p,12,C>G,440,193,633,3765326,3771232,7536558,8.399059623769896e-05
DAL227,5p,13,C>G,265,166,431,3765325,3771231,7536556,5.718792509469843e-05
DAL227,5p,14,C>G,387,445,832,3765297,3771226,7536523,0.0001103957355401
DAL227,5p,15,C>G,424,317,741,3765318,3771201,7536519,9.832125414929624e-05
DAL227,5p,16,C>G,297,317,614,3765316,3771188,7536504,8.147013522450197e-05
DAL227,5p,17,C>G,331,241,572,3765326,3771175,7536501,7.589728973697476e-05
DAL227,5p,18,C>G,532,305,837,3765280,3771169,7536449,0.000111060261935
DAL227,5p,19,C>G,323,225,548,3765279,3771164,7536443,7.271334766281652e-05
DAL227,5p,20,C>G,289,302,591,3765254,3771167,7536421,7.84191859770042e-05
DAL227,5p,21,C>G,270,399,669,3765270,3771169,7536439,8.876871424289375e-05
DAL227,5p,22,C>G,350,516,866,3765253,3771158,7536411,0.0001149088073885
DAL227,5p,23,C>G,257,245,502,3765254,3771157,7536411,6.660995532223495e-05
DAL227,5p,24,C>G,310,355,665,3765270,3771180,7536450,8.823783080893524e-05
DAL227,5p,25,C>G,257,596,853,3765247,3771148,7536395,0.000113184088679
WA02,3p,1,C>G,9,15,24,6552698,6754258,13306956,1.8035679985715744e-06
WA02,3p,2,C>G,42,72,114,6552698,6754258,13306956,8.566947993214977e-06
WA02,3p,3,C>G,35,86,121,6552698,6754258,13306956,9.09298865946502e-06
WA02,3p,4,C>G,99,69,168,6552698,6754256,13306954,1.2624977887501528e-05
WA02,3p,5,C>G,223,209,432,6552698,6754256,13306954,3.246422885357536e-05
WA02,3p,6,C>G,233,332,565,6552698,6754257,13306955,4.245899982377636e-05
WA02,3p,7,C>G,250,302,552,6552698,6754257,13306955,4.148206708446824e-05
WA02,3p,8,C>G,209,374,583,6552692,6754207,13306899,4.381186029893216e-05
WA02,3p,9,C>G,303,353,656,6552688,6754191,13306879,4.929781055347388e-05
WA02,3p,10,C>G,410,451,861,6552680,6754207,13306887,6.47033374522531e-05
WA02,3p,11,C>G,317,413,730,6552667,6754202,13306869,5.485888528698975e-05
WA02,3p,12,C>G,343,563,906,6552670,6754189,13306859,6.808518824765483e-05
WA02,3p,13,C>G,425,410,835,6552675,6754177,13306852,6.274962703425273e-05
WA02,3p,14,C>G,378,394,772,6552653,6754155,13306808,5.8015415868328455e-05
WA02,3p,15,C>G,393,476,869,6552632,6754146,13306778,6.53050648323734e-05
WA02,3p,16,C>G,451,480,931,6552629,6754119,13306748,6.996450222097841e-05
WA02,3p,17,C>G,403,404,807,6552608,6754116,13306724,6.064603128463474e-05
WA02,3p,18,C>G,393,549,942,6552611,6754085,13306696,7.079142711308652e-05
WA02,3p,19,C>G,415,549,964,6552605,6754056,13306661,7.244492063035197e-05
WA02,3p,20,C>G,415,427,842,6552618,6754033,13306651,6.327662760524793e-05
WA02,3p,21,C>G,435,491,926,6552597,6754089,13306686,6.958907725033867e-05
WA02,3p,22,C>G,462,508,970,6552593,6754062,13306655,7.289585549486329e-05
WA02,3p,23,C>G,458,576,1034,6552585,6754052,13306637,7.770558406305064e-05
WA02,3p,24,C>G,556,579,1135,6552556,6754026,13306582,8.529613389824674e-05
WA02,3p,25,C>G,509,467,976,6552517,6754038,13306555,7.334730890151509e-05
WA02,5p,1,C>G,85,98,183,6552698,6754258,13306956,1.3752205989108252e-05
WA02,5p,2,C>G,72,38,110,6552562,6754179,13306741,8.266486888111822e-06
WA02,5p,3,C>G,108,43,151,6552698,6754258,13306956,1.1347448657679488e-05
WA02,5p,4,C>G,152,64,216,6552698,6754258,13306956,1.6232111987144167e-05
WA02,5p,5,C>G,388,401,789,6552698,6754258,13306956,5.92922979530405e-05
WA02,5p,6,C>G,415,259,674,6552697,6754258,13306955,5.065020509951375e-05
WA02,5p,7,C>G,399,240,639,6552685,6754258,13306943,4.802004487431861e-05
WA02,5p,8,C>G,436,265,701,6552655,6754257,13306912,5.267938947818998e-05
WA02,5p,9,C>G,689,458,1147,6552662,6754226,13306888,8.619596106918463e-05
WA02,5p,10,C>G,544,340,884,6552618,6754222,13306840,6.643200038476453e-05
WA02,5p,11,C>G,466,408,874,6552625,6754225,13306850,6.568045780932377e-05
WA02,5p,12,C>G,540,321,861,6552628,6754236,13306864,6.47034492875256e-05
WA02,5p,13,C>G,390,297,687,6552614,6754205,13306819,5.162766548489162e-05
WA02,5p,14,C>G,498,362,860,6552607,6754183,13306790,6.462865950390741e-05
WA02,5p,15,C>G,461,380,841,6552586,6754168,13306754,6.320098800954763e-05
WA02,5p,16,C>G,532,418,950,6552525,6754178,13306703,7.139259063646344e-05
WA02,5p,17,C>G,536,401,937,6552567,6754148,13306715,7.041557589532803e-05
WA02,5p,18,C>G,567,409,976,6552548,6754087,13306635,7.334686793468071e-05
WA02,5p,19,C>G,482,538,1020,6552516,6754124,13306640,7.665346022737521e-05
WA02,5p,20,C>G,465,364,829,6552507,6754132,13306639,6.22997287293959e-05
WA02,5p,21,C>G,552,450,1002,6552521,6754152,13306673,7.530056536295736e-05
WA02,5p,22,C>G,570,456,1026,6552516,6754117,13306633,7.710440349561005e-05
WA02,5p,23,C>G,604,436,1040,6552465,6754131,13306596,7.81567276860288e-05
WA02,5p,24,C>G,578,424,1002,6552457,6754135,13306592,7.53010237331993e-05
WA02,5p,25,C>G,480,477,957,6552470,6754083,13306553,7.191945201736317e-05
WA03,3p,1,C>G,25,20,45,5399458,5543742,10943200,4.112142700489802e-06
WA03,3p,2,C>G,91,191,282,5399458,5543742,10943200,2.5769427589736093e-05
WA03,3p,3,C>G,262,235,497,5399458,5543742,10943200,4.541633160318737e-05
WA03,3p,4,C>G,110,150,260,5399458,5543736,10943194,2.375905974069362e-05
WA03,3p,5,C>G,621,643,1264,5399458,5543740,10943198,0.0001155055405193
WA03,3p,6,C>G,550,816,1366,5399458,5543741,10943199,0.0001248263876038
WA03,3p,7,C>G,669,750,1419,5399458,5543739,10943197,0.0001296696020367
WA03,3p,8,C>G,651,664,1315,5399449,5543673,10943122,0.0001201668043178
WA03,3p,9,C>G,965,1101,2066,5399436,5543670,10943106,0.000188794662137
WA03,3p,10,C>G,982,943,1925,5399438,5543654,10943092,0.0001759100627135
WA03,3p,11,C>G,764,1002,1766,5399404,5543644,10943048,0.0001613809973235
WA03,3p,12,C>G,912,1041,1953,5399397,5543595,10942992,0.0001784703854302
WA03,3p,13,C>G,1136,849,1985,5399378,5543551,10942929,0.0001813956756915
WA03,3p,14,C>G,959,1002,1961,5399356,5543493,10942849,0.0001792037887025
WA03,3p,15,C>G,847,789,1636,5399349,5543505,10942854,0.0001495039593875
WA03,3p,16,C>G,958,829,1787,5399342,5543495,10942837,0.0001633031726598
WA03,3p,17,C>G,968,967,1935,5399346,5543438,10942784,0.0001768288581772
WA03,3p,18,C>G,1107,991,2098,5399325,5543443,10942768,0.0001917247994291
WA03,3p,19,C>G,1002,1413,2415,5399297,5543425,10942722,0.0002206946315551
WA03,3p,20,C>G,983,887,1870,5399252,5543409,10942661,0.0001708907915542
WA03,3p,21,C>G,1088,945,2033,5399248,5543303,10942551,0.000185788487529
WA03,3p,22,C>G,1134,907,2041,5399256,5543263,10942519,0.0001865201239312
WA03,3p,23,C>G,1018,1111,2129,5399255,5543267,10942522,0.0001945620945518
WA03,3p,24,C>G,1073,1127,2200,5399198,5543130,10942328,0.0002010541084127
WA03,3p,25,C>G,1273,941,2214,5399050,5543142,10942192,0.0002023360584424
WA03,5p,1,C>G,144,43,187,5399457,5543742,10943199,1.7088239005797117e-05
WA03,5p,2,C>G,101,101,202,5399258,5543638,10942896,1.84594644781418e-05
WA03,5p,3,C>G,393,121,514,5399457,5543742,10943199,4.696981202662951e-05
WA03,5p,4,C>G,290,203,493,5399458,5543742,10943200,4.5050807807588274e-05
WA03,5p,5,C>G,765,712,1477,5399456,5543740,10943196,0.0001349697108596
WA03,5p,6,C>G,720,752,1472,5399452,5543742,10943194,0.0001345128305319
WA03,5p,7,C>G,1163,568,1731,5399453,5543742,10943195,0.0001581804948189
WA03,5p,8,C>G,791,673,1464,5399403,5543732,10943135,0.0001337825038254
WA03,5p,9,C>G,1160,958,2118,5399319,5543732,10943051,0.000193547485066
WA03,5p,10,C>G,1070,856,1926,5399344,5543717,10943061,0.0001760019431491
WA03,5p,11,C>G,1479,985,2464,5399321,5543705,10943026,0.0002251662382964
WA03,5p,12,C>G,1317,1217,2534,5399213,5543665,10942878,0.0002315661382681
WA03,5p,13,C>G,1237,1113,2350,5399156,5543662,10942818,0.0002147527264
WA03,5p,14,C>G,1159,817,1976,5399124,5543629,10942753,0.0001805761310704
WA03,5p,15,C>G,1274,841,2115,5399092,5543505,10942597,0.00019328135725
WA03,5p,16,C>G,1145,1001,2146,5399083,5543501,10942584,0.0001961145557575
WA03,5p,17,C>G,1155,1260,2415,5399113,5543491,10942604,0.0002206970114243
WA03,5p,18,C>G,1328,1285,2613,5399074,5543600,10942674,0.0002387898972408
WA03,5p,19,C>G,1541,1161,2702,5399071,5543546,10942617,0.0002469244788518
WA03,5p,20,C>G,1536,1195,2731,5399050,5543533,10942583,0.0002495754430192
WA03,5p,21,C>G,1352,1015,2367,5399034,5543509,10942543,0.0002163116928121
WA03,5p,22,C>G,1439,1096,2535,5398989,5543454,10942443,0.0002316667310946
WA03,5p,23,C>G,1433,1048,2481,5398935,5543457,10942392,0.000226732875225
WA03,5p,24,C>G,1928,1265,3193,5398952,5543428,10942380,0.0002918012351974
WA03,5p,25,C>G,1415,931,2346,5398991,5543444,10942435,0.0002143946936856
WA07,3p,1,C>G,33,20,53,5691729,6013979,11705708,4.527705628741124e-06
WA07,3p,2,C>G,32,77,109,5691729,6013979,11705708,9.311696481750612e-06
WA07,3p,3,C>G,37,117,154,5691729,6013979,11705708,1.3155974845776096e-05
WA07,3p,4,C>G,83,111,194,5691729,6013979,11705708,1.6573111169354303e-05
WA07,3p,5,C>G,193,264,457,5691729,6013979,11705708,3.904078249688101e-05
WA07,3p,6,C>G,243,248,491,5691729,6013979,11705708,4.194534837192248e-05
WA07,3p,7,C>G,232,217,449,5691729,6013979,11705708,3.835735523216537e-05
WA07,3p,8,C>G,210,355,565,5691713,6013800,11705513,4.826785464250905e-05
WA07,3p,9,C>G,287,457,744,5691720,6013901,11705621,6.355920800784513e-05
WA07,3p,10,C>G,249,546,795,5691718,6013892,11705610,6.791615302406283e-05
WA07,3p,11,C>G,305,479,784,5691711,6013883,11705594,6.697652421568696e-05
WA07,3p,12,C>G,314,556,870,5691705,6013884,11705589,7.432347060878355e-05
WA07,3p,13,C>G,355,592,947,5691711,6013848,11705559,8.090173224533745e-05
WA07,3p,14,C>G,374,440,814,5691695,6013877,11705572,6.953953211342427e-05
WA07,3p,15,C>G,355,535,890,5691211,6013856,11705067,7.60354468710004e-05
WA07,3p,16,C>G,431,485,916,5691636,6013850,11705486,7.825390590360793e-05
WA07,3p,17,C>G,443,405,848,5691662,6013813,11705475,7.244473205914326e-05
WA07,3p,18,C>G,383,414,797,5691639,6013769,11705408,6.8088186246904e-05
WA07,3p,19,C>G,643,463,1106,5691628,6013742,11705370,9.44865476272856e-05
WA07,3p,20,C>G,450,518,968,5691604,6013772,11705376,8.269704450331198e-05
WA07,3p,21,C>G,346,460,806,5691611,6013735,11705346,6.88574263417758e-05
WA07,3p,22,C>G,435,523,958,5691577,6013736,11705313,8.18431766839554e-05
WA07,3p,23,C>G,382,605,987,5691568,6013670,11705238,8.432122439543733e-05
WA07,3p,24,C>G,615,697,1312,5691554,6013661,11705215,0.0001120867920836
WA07,3p,25,C>G,491,493,984,5691455,6013662,11705117,8.406579788993139e-05
WA07,5p,1,C>G,81,5,86,5691729,6013979,11705708,7.346843095693144e-06
WA07,5p,2,C>G,107,72,179,5691636,6013923,11705559,1.52918796957924e-05
WA07,5p,3,C>G,77,46,123,5691729,6013979,11705708,1.0507694195002985e-05
WA07,5p,4,C>G,118,230,348,5691728,6013979,11705707,2.9729088554839107e-05
WA07,5p,5,C>G,299,411,710,5691729,6013978,11705707,6.065417492510277e-05
WA07,5p,6,C>G,267,208,475,5691728,6013979,11705707,4.057849730904763e-05
WA07,5p,7,C>G,311,176,487,5691728,6013979,11705707,4.1603638293697256e-05
WA07,5p,8,C>G,388,262,650,5691579,6013975,11705554,5.5529195798848993e-05
WA07,5p,9,C>G,425,667,1092,5691672,6013971,11705643,9.328833964951776e-05
WA07,5p,10,C>G,444,771,1215,5691582,6013961,11705543,0.0001037969789184
WA07,5p,11,C>G,382,384,766,5691326,6013942,11705268,6.544062041125415e-05
WA07,5p,12,C>G,414,574,988,5691520,6013938,11705458,8.440506984006948e-05
WA07,5p,13,C>G,362,482,844,5691511,6013949,11705460,7.210310402154208e-05
WA07,5p,14,C>G,413,444,857,5691556,6013950,11705506,7.321340914267183e-05
WA07,5p,15,C>G,542,539,1081,5691563,6013633,11705196,9.235214856718332e-05
WA07,5p,16,C>G,447,398,845,5691534,6013925,11705459,7.218854040665983e-05
WA07,5p,17,C>G,405,460,865,5691561,6013916,11705477,7.389703127860574e-05
WA07,5p,18,C>G,544,414,958,5691474,6013905,11705379,8.184271521665381e-05
WA07,5p,19,C>G,492,313,805,5691482,6013884,11705366,6.87718777866493e-05
WA07,5p,20,C>G,521,329,850,5691421,6013876,11705297,7.26166965263675e-05
WA07,5p,21,C>G,549,407,956,5691379,6013853,11705232,8.167287927313188e-05
WA07,5p,22,C>G,452,334,786,5691396,6013861,11705257,6.714931590139371e-05
WA07,5p,23,C>G,443,458,901,5691314,6013795,11705109,7.697493462042941e-05
WA07,5p,24,C>G,420,490,910,5691332,6013785,11705117,7.774377650389996e-05
WA07,5p,25,C>G,503,645,1148,5691334,6013719,11705053,9.807730046160406e-05
WA08,3p,1,C>G,9,27,36,6798117,7189085,13987202,2.573781375288639e-06
WA08,3p,2,C>G,39,52,91,6798117,7189085,13987202,6.505947365312949e-06
WA08,3p,3,C>G,47,68,115,6798117,7189085,13987202,8.221801615505374e-06
WA08,3p,4,C>G,151,111,262,6798117,7189081,13987198,1.8731414254663444e-05
WA08,3p,5,C>G,383,246,629,6798117,7189085,13987202,4.496968014045983e-05
WA08,3p,6,C>G,275,355,630,6798117,7189085,13987202,4.504117406755118e-05
WA08,3p,7,C>G,239,427,666,6798117,7189084,13987201,4.761495884702022e-05
WA08,3p,8,C>G,336,349,685,6798110,7189053,13987163,4.8973476608515966e-05
WA08,3p,9,C>G,496,287,783,6798103,7189051,13987154,5.5979937019353616e-05
WA08,3p,10,C>G,403,325,728,6798074,7189042,13987116,5.204789893785109e-05
WA08,3p,11,C>G,424,361,785,6798109,7189046,13987155,5.612292135176882e-05
WA08,3p,12,C>G,401,305,706,6798091,7189018,13987109,5.047504813181909e-05
WA08,3p,13,C>G,416,399,815,6798090,7189013,13987103,5.826796299419544e-05
WA08,3p,14,C>G,349,387,736,6798067,7188981,13987048,5.262010969005039e-05
WA08,3p,15,C>G,435,361,796,6798069,7188978,13987047,5.69097966139672e-05
WA08,3p,16,C>G,425,401,826,6798049,7188961,13987010,5.905479441281589e-05
WA08,3p,17,C>G,458,364,822,6798000,7188943,13986943,5.876909629216334e-05
WA08,3p,18,C>G,469,541,1010,6798023,7188956,13986979,7.221001761709944e-05
WA08,3p,19,C>G,410,505,915,6798028,7188946,13986974,6.541800964240014e-05
WA08,3p,20,C>G,505,473,978,6798009,7188917,13986926,6.992244042758215e-05
WA08,3p,21,C>G,578,597,1175,6798010,7188926,13986936,8.400696192504206e-05
WA08,3p,22,C>G,561,462,1023,6798012,7188920,13986932,7.31396992564202e-05
WA08,3p,23,C>G,474,654,1128,6798009,7188864,13986873,8.064704669871529e-05
WA08,3p,24,C>G,458,517,975,6798015,7188867,13986882,6.970817370161555e-05
WA08,3p,25,C>G,497,433,930,6797966,7188892,13986858,6.649098746837925e-05
WA08,5p,1,C>G,53,33,86,6798116,7189085,13987201,6.1484781694350425e-06
WA08,5p,2,C>G,40,45,85,6797941,7188997,13986938,6.077098504333115e-06
WA08,5p,3,C>G,74,44,118,6798117,7189084,13987201,8.4362839999225e-06
WA08,5p,4,C>G,100,71,171,6798115,7189085,13987200,1.2225463280713795e-05
WA08,5p,5,C>G,486,411,897,6798116,7189084,13987200,6.413006177076184e-05
WA08,5p,6,C>G,342,359,701,6798112,7189085,13987197,5.011726080643606e-05
WA08,5p,7,C>G,320,247,567,6798110,7189085,13987195,4.053707694787983e-05
WA08,5p,8,C>G,448,427,875,6798069,7189064,13987133,6.255749480611931e-05
WA08,5p,9,C>G,490,461,951,6798054,7189067,13987121,6.799111840099189e-05
WA08,5p,10,C>G,658,457,1115,6798015,7189037,13987052,7.971658359459877e-05
WA08,5p,11,C>G,501,508,1009,6797997,7189047,13987044,7.21381873110573e-05
WA08,5p,12,C>G,585,381,966,6798016,7189056,13987072,6.906377546351374e-05
WA08,5p,13,C>G,473,427,900,6797995,7189043,13987038,6.434528883098766e-05
WA08,5p,14,C>G,494,555,1049,6797984,7189041,13987025,7.49980785763949e-05
WA08,5p,15,C>G,628,432,1060,6797997,7189013,13987010,7.578460299949739e-05
WA08,5p,16,C>G,469,521,990,6797921,7188997,13986918,7.07804249656715e-05
WA08,5p,17,C>G,583,435,1018,6797959,7188875,13986834,7.27827326756005e-05
WA08,5p,18,C>G,644,704,1348,6797991,7188972,13986963,9.63754604913161e-05
WA08,5p,19,C>G,489,451,940,6797966,7188988,13986954,6.720548305227857e-05
WA08,5p,20,C>G,518,496,1014,6797883,7188971,13986854,7.249664577895787e-05
WA08,5p,21,C>G,578,433,1011,6797885,7188979,13986864,7.228210698266602e-05
WA08,5p,22,C>G,622,461,1083,6797887,7188939,13986826,7.743000449136924e-05
WA08,5p,23,C>G,613,375,988,6797851,7188919,13986770,7.063818165309075e-05
WA08,5p,24,C>G,602,336,938,6797841,7188876,13986717,6.706362901315584e-05
WA08,5p,25,C>G,494,477,971,6797835,7188817,13986652,6.942333304639309e-05
WA09,3p,1,C>G,24,32,56,4741672,4881751,9623423,5.819135249484513e-06
WA09,3p,2,C>G,29,63,92,4741672,4881751,9623423,9.560007909867414e-06
WA09,3p,3,C>G,58,119,177,4741672,4881751,9623423,1.8392623913549262e-05
WA09,3p,4,C>G,123,130,253,4741672,4881748,9623420,2.629002994777325e-05
WA09,3p,5,C>G,516,621,1137,4741672,4881751,9623423,0.0001181492281904
WA09,3p,6,C>G,507,608,1115,4741672,4881751,9623423,0.0001158631393424
WA09,3p,7,C>G,558,608,1166,4741672,4881748,9623420,0.0001211627467158
WA09,3p,8,C>G,671,812,1483,4741663,4881718,9623381,0.0001541038435452
WA09,3p,9,C>G,696,932,1628,4741664,4881723,9623387,0.0001691712076008
WA09,3p,10,C>G,727,1084,1811,4741658,4881705,9623363,0.0001881878507544
WA09,3p,11,C>G,775,795,1570,4741648,4881712,9623360,0.0001631446812755
WA09,3p,12,C>G,851,1063,1914,4741642,4881680,9623322,0.0001988918171916
WA09,3p,13,C>G,868,915,1783,4741628,4881645,9623273,0.000185279997772
WA09,3p,14,C>G,793,763,1556,4741616,4881571,9623187,0.0001616927947051
WA09,3p,15,C>G,898,877,1775,4741598,4881557,9623155,0.0001844509415051
WA09,3p,16,C>G,882,1401,2283,4741586,4881546,9623132,0.0002372408484056
WA09,3p,17,C>G,788,880,1668,4741582,4881528,9623110,0.0001733327375453
WA09,3p,18,C>G,864,1659,2523,4741560,4881490,9623050,0.0002621829877221
WA09,3p,19,C>G,963,1277,2240,4741552,4881442,9622994,0.0002327757868289
WA09,3p,20,C>G,904,1280,2184,4741534,4881501,9623035,0.0002269554251855
WA09,3p,21,C>G,895,1723,2618,4741546,4881493,9623039,0.0002720554286436
WA09,3p,22,C>G,985,897,1882,4741524,4881498,9623022,0.0001955726589838
WA09,3p,23,C>G,906,914,1820,4741501,4881486,9622987,0.0001891304643766
WA09,3p,24,C>G,884,992,1876,4741491,4881450,9622941,0.0001949507951882
WA09,3p,25,C>G,894,887,1781,4741451,4881469,9622920,0.0001850789573227
WA09,5p,1,C>G,69,43,112,4741672,4881751,9623423,1.1638270498969026e-05
WA09,5p,2,C>G,57,46,103,4741495,4881667,9623162,1.0703342622726291e-05
WA09,5p,3,C>G,108,106,214,4741672,4881750,9623422,2.223741201414632e-05
WA09,5p,4,C>G,162,121,283,4741672,4881751,9623423,2.940741563578781e-05
WA09,5p,5,C>G,747,983,1730,4741671,4881751,9623422,0.0001797697326377
WA09,5p,6,C>G,646,659,1305,4741669,4881751,9623420,0.0001356066762128
WA09,5p,7,C>G,650,507,1157,4741667,4881751,9623418,0.0001202275532456
WA09,5p,8,C>G,754,815,1569,4741639,4881744,9623383,0.0001630403777964
WA09,5p,9,C>G,1004,984,1988,4741618,4881747,9623365,0.0002065805464097
WA09,5p,10,C>G,885,1017,1902,4741622,4881737,9623359,0.0001976440866437
WA09,5p,11,C>G,1019,1281,2300,4741614,4881733,9623347,0.0002390020852412
WA09,5p,12,C>G,1280,1026,2306,4741580,4881734,9623314,0.0002396263906591
WA09,5p,13,C>G,960,847,1807,4741530,4881708,9623238,0.0001877746346915
WA09,5p,14,C>G,942,1021,1963,4741498,4881705,9623203,0.0002039861364246
WA09,5p,15,C>G,1043,865,1908,4741496,4881672,9623168,0.0001982715047684
WA09,5p,16,C>G,1083,739,1822,4741451,4881636,9623087,0.0001893363325095
WA09,5p,17,C>G,967,930,1897,4741476,4881638,9623114,0.0001971295362395
WA09,5p,18,C>G,1021,1006,2027,4741455,4881610,9623065,0.0002106397493937
WA09,5p,19,C>G,1014,956,1970,4741379,4881580,9622959,0.000204718735682
WA09,5p,20,C>G,1041,891,1932,4741390,4881557,9622947,0.0002007700967281
WA09,5p,21,C>G,1009,898,1907,4741379,4881587,9622966,0.0001981717487103
WA09,5p,22,C>G,996,747,1743,4741354,4881580,9622934,0.0001811297884823
WA09,5p,23,C>G,1003,862,1865,4741312,4881565,9622877,0.0001938089824903
WA09,5p,24,C>G,1053,1229,2282,4741363,4881548,9622911,0.0002371423782262
WA09,5p,25,C>G,1392,919,2311,4741301,4881503,9622804,0.0002401586897124
WA11,3p,1,C>G,34,31,65,9756642,10108269,19864911,3.272101244249219e-06
WA11,3p,2,C>G,53,158,211,9756642,10108269,19864911,1.0621744039024387e-05
WA11,3p,3,C>G,115,183,298,9756642,10108269,19864911,1.5001325704404112e-05
WA11,3p,4,C>G,424,172,596,9756642,10108267,19864909,3.0002654429476625e-05
WA11,3p,5,C>G,1310,612,1922,9756642,10108269,19864911,9.675351679149228e-05
WA11,3p,6,C>G,802,750,1552,9756642,10108269,19864911,7.812770970884289e-05
WA11,3p,7,C>G,900,835,1735,9756642,10108265,19864907,8.733995079866219e-05
WA11,3p,8,C>G,803,1202,2005,9756629,10108160,19864789,0.0001009323582545
WA11,3p,9,C>G,890,1058,1948,9756610,10108092,19864702,9.8063389020384e-05
WA11,3p,10,C>G,1137,1201,2338,9756615,10107969,19864584,0.0001176969021853
WA11,3p,11,C>G,787,1004,1791,9756587,10107918,19864505,9.016081699493644e-05
WA11,3p,12,C>G,1193,1125,2318,9756581,10108019,19864600,0.0001166899912406
WA11,3p,13,C>G,1001,1373,2374,9756565,10107963,19864528,0.0001195095096143
WA11,3p,14,C>G,1000,1196,2196,9756515,10107914,19864429,0.000110549364394
WA11,3p,15,C>G,980,1257,2237,9756471,10107972,19864443,0.000112613275892
WA11,3p,16,C>G,1206,1231,2437,9756477,10108011,19864488,0.0001226812390029
WA11,3p,17,C>G,1068,1170,2238,9756469,10108044,19864513,0.0001126632200849
WA11,3p,18,C>G,926,1478,2404,9756421,10108016,19864437,0.0001210202937037
WA11,3p,19,C>G,1167,1272,2439,9756438,10108000,19864438,0.0001227822302347
WA11,3p,20,C>G,1045,1609,2654,9756433,10107963,19864396,0.0001336058745506
WA11,3p,21,C>G,1318,1603,2921,9756421,10107904,19864325,0.0001470475337067
WA11,3p,22,C>G,1186,1266,2452,9756405,10107842,19864247,0.0001234378529425
WA11,3p,23,C>G,1203,1324,2527,9756375,10107816,19864191,0.0001272138392144
WA11,3p,24,C>G,1273,1210,2483,9756358,10107704,19864062,0.0001249996098481
WA11,3p,25,C>G,1098,1474,2572,9756281,10107693,19863974,0.000129480636654
WA11,5p,1,C>G,143,35,178,9756641,10108269,19864910,8.960523858401574e-06
WA11,5p,2,C>G,128,746,874,9756471,10108196,19864667,4.3997717152771805e-05
WA11,5p,3,C>G,198,89,287,9756642,10108269,19864911,1.444758549383886e-05
WA11,5p,4,C>G,291,165,456,9756638,10108269,19864907,2.295505335111813e-05
WA11,5p,5,C>G,1144,914,2058,9756638,10108267,19864905,0.0001035997906861
WA11,5p,6,C>G,962,719,1681,9756642,10108269,19864911,8.462157217819904e-05
WA11,5p,7,C>G,948,1347,2295,9756629,10108269,19864898,0.000115530419537
WA11,5p,8,C>G,1140,766,1906,9756500,10108261,19864761,9.59488009948874e-05
WA11,5p,9,C>G,1343,730,2073,9756493,10108240,19864733,0.0001043557947645
WA11,5p,10,C>G,1314,931,2245,9756446,10108197,19864643,0.0001130148676721
WA11,5p,11,C>G,1670,1337,3007,9756457,10108195,19864652,0.0001513744111902
WA11,5p,12,C>G,2254,1134,3388,9756411,10108221,19864632,0.0001705543802674
WA11,5p,13,C>G,1196,1536,2732,9756334,10108178,19864512,0.0001375316947126
WA11,5p,14,C>G,1242,1083,2325,9756261,10108167,19864428,0.0001170433903256
WA11,5p,15,C>G,1367,946,2313,9756237,10108096,19864333,0.0001164398522719
WA11,5p,16,C>G,1270,1641,2911,9756275,10108079,19864354,0.000146543904725
WA11,5p,17,C>G,1383,4282,5665,9756369,10108078,19864447,0.0002851828696766
WA11,5p,18,C>G,1493,1113,2606,9756327,10108075,19864402,0.0001311894513612
WA11,5p,19,C>G,1433,936,2369,9756284,10108088,19864372,0.0001192587412277
WA11,5p,20,C>G,1249,1532,2781,9756292,10108082,19864374,0.0001399993777805
WA11,5p,21,C>G,1668,1228,2896,9756251,10108036,19864287,0.0001457892749938
WA11,5p,22,C>G,1484,1275,2759,9756136,10108029,19864165,0.0001388933287656
WA11,5p,23,C>G,1340,1460,2800,9756095,10108016,19864111,0.0001409577302502
WA11,5p,24,C>G,1534,1108,2642,9756046,10108010,19864056,0.0001330040551637
WA11,5p,25,C>G,2000,1118,3118,9756056,10107943,19863999,0.0001569673860736
WA12,3p,1,C>G,29,23,52,6632243,6940679,13572922,3.83115735874707e-06
WA12,3p,2,C>G,49,54,103,6632243,6940679,13572922,7.588638614441312e-06
WA12,3p,3,C>G,61,106,167,6632243,6940679,13572922,1.2303909209822322e-05
WA12,3p,4,C>G,133,155,288,6632243,6940676,13572919,2.121872236915287e-05
WA12,3p,5,C>G,762,809,1571,6632243,6940678,13572921,0.0001157451664236
WA12,3p,6,C>G,674,844,1518,6632243,6940679,13572922,0.0001118403244341
WA12,3p,7,C>G,860,788,1648,6632243,6940676,13572919,0.0001214182446679
WA12,3p,8,C>G,872,919,1791,6632240,6940664,13572904,0.0001319540755611
WA12,3p,9,C>G,972,1071,2043,6632231,6940656,13572887,0.000150520666679
WA12,3p,10,C>G,887,1035,1922,6632228,6940644,13572872,0.0001416059917164
WA12,3p,11,C>G,904,1071,1975,6632231,6940642,13572873,0.0001455108288422
WA12,3p,12,C>G,943,979,1922,6632223,6940615,13572838,0.0001416063464398
WA12,3p,13,C>G,1165,1047,2212,6632204,6940591,13572795,0.0001629730648698
WA12,3p,14,C>G,973,995,1968,6632209,6940533,13572742,0.0001449964937077
WA12,3p,15,C>G,973,1474,2447,6632188,6940474,13572662,0.0001802888777455
WA12,3p,16,C>G,1002,1123,2125,6632187,6940478,13572665,0.0001565646835017
WA12,3p,17,C>G,959,1130,2089,6632168,6940473,13572641,0.0001539125657268
WA12,3p,18,C>G,1126,1091,2217,6632160,6940482,13572642,0.0001633432901273
WA12,3p,19,C>G,1026,1075,2101,6632121,6940435,13572556,0.0001547976667033
WA12,3p,20,C>G,1038,1157,2195,6632105,6940432,13572537,0.0001617236335402
WA12,3p,21,C>G,1065,1148,2213,6632096,6940454,13572550,0.0001630496848418
WA12,3p,22,C>G,1196,1219,2415,6632039,6940438,13572477,0.0001779336225804
WA12,3p,23,C>G,1009,1348,2357,6631950,6940459,13572409,0.0001736611385642
WA12,3p,24,C>G,1244,1046,2290,6631933,6940411,13572344,0.0001687254611288
WA12,3p,25,C>G,1029,906,1935,6631986,6940428,13572414,0.0001425685953876
WA12,5p,1,C>G,152,34,186,6632243,6940679,13572922,1.370375516782606e-05
WA12,5p,2,C>G,137,23,160,6631949,6940524,13572473,1.1788566460953723e-05
WA12,5p,3,C>G,219,57,276,6632242,6940678,13572920,2.033460743892987e-05
WA12,5p,4,C>G,286,256,542,6632242,6940679,13572921,3.9932450796700285e-05
WA12,5p,5,C>G,890,923,1813,6632242,6940677,13572919,0.0001335748043585
WA12,5p,6,C>G,707,788,1495,6632242,6940679,13572921,0.000110145782179
WA12,5p,7,C>G,779,686,1465,6632238,6940679,13572917,0.0001079355307337
WA12,5p,8,C>G,956,756,1712,6632204,6940670,13572874,0.0001261339344931
WA12,5p,9,C>G,1387,1167,2554,6632209,6940675,13572884,0.0001881692940129
WA12,5p,10,C>G,1039,1185,2224,6632199,6940665,13572864,0.0001638563533827
WA12,5p,11,C>G,1057,1093,2150,6632166,6940667,13572833,0.0001584046602503
WA12,5p,12,C>G,1230,1191,2421,6632126,6940660,13572786,0.0001783716327657
WA12,5p,13,C>G,1069,1451,2520,6632065,6940658,13572723,0.0001856665018508
WA12,5p,14,C>G,1074,1538,2612,6632026,6940638,13572664,0.0001924456392643
WA12,5p,15,C>G,1235,1476,2711,6631987,6940631,13572618,0.0001997403890686
WA12,5p,16,C>G,1151,1261,2412,6631930,6940590,13572520,0.0001777120240014
WA12,5p,17,C>G,955,1159,2114,6631958,6940621,13572579,0.0001557552179287
WA12,5p,18,C>G,1330,1327,2657,6632019,6940577,13572596,0.0001957621077058
WA12,5p,19,C>G,1176,3283,4459,6631996,6940532,13572528,0.0003285312802449
WA12,5p,20,C>G,1027,1223,2250,6631973,6940532,13572505,0.0001657763250041
WA12,5p,21,C>G,1198,1186,2384,6631936,6940534,13572470,0.000175649679093
WA12,5p,22,C>G,1174,1192,2366,6631921,6940529,13572450,0.0001743237219514
WA12,5p,23,C>G,1283,1533,2816,6631926,6940534,13572460,0.0002074789684405
WA12,5p,24,C>G,1284,1337,2621,6631934,6940518,13572452,0.0001931117531305
WA12,5p,25,C>G,1145,1268,2413,6631933,6940515,13572448,0.0001777866454157
WA13,3p,1,C>G,1,11,12,5896847,6081528,11978375,1.0018053367005123e-06
WA13,3p,2,C>G,193,21,214,5896847,6081528,11978375,1.786552850449247e-05
WA13,3p,3,C>G,130,24,154,5896847,6081528,11978375,1.2856501820989909e-05
WA13,3p,4,C>G,83,30,113,5896847,6081522,11978369,9.433671645947791e-06
WA13,3p,5,C>G,185,102,287,5896847,6081527,11978374,2.3959846303012413e-05
WA13,3p,6,C>G,80,151,231,5896847,6081528,11978375,1.9284752731484864e-05
WA13,3p,7,C>G,193,78,271,5896847,6081528,11978375,2.2624103853819904e-05
WA13,3p,8,C>G,147,330,477,5896845,6081521,11978366,3.982179205410822e-05
WA13,3p,9,C>G,193,172,365,5896842,6081517,11978359,3.0471619693482225e-05
WA13,3p,10,C>G,129,159,288,5896843,6081517,11978360,2.404335818926798e-05
WA13,3p,11,C>G,135,193,328,5896841,6081492,11978333,2.7382775215883545e-05
WA13,3p,12,C>G,198,148,346,5896836,6081505,11978341,2.8885469198113497e-05
WA13,3p,13,C>G,112,248,360,5896834,6081495,11978329,3.005427551706085e-05
WA13,3p,14,C>G,145,148,293,5896832,6081501,11978333,2.44608327385789e-05
WA13,3p,15,C>G,394,149,543,5896825,6081505,11978330,4.533186178707716e-05
WA13,3p,16,C>G,192,124,316,5896830,6081509,11978339,2.638095315218579e-05
WA13,3p,17,C>G,147,131,278,5896823,6081499,11978322,2.3208592989902928e-05
WA13,3p,18,C>G,161,120,281,5896827,6081499,11978326,2.3459037598408992e-05
WA13,3p,19,C>G,265,198,463,5896822,6081480,11978302,3.865322480598669e-05
WA13,3p,20,C>G,208,211,419,5896818,6081448,11978266,3.498002131527218e-05
WA13,3p,21,C>G,181,200,381,5896824,6081466,11978290,3.1807545150434664e-05
WA13,3p,22,C>G,136,159,295,5896824,6081460,11978284,2.4627901625975808e-05
WA13,3p,23,C>G,166,146,312,5896819,6081454,11978273,2.6047160554781143e-05
WA13,3p,24,C>G,191,132,323,5896803,6081440,11978243,2.696555746948864e-05
WA13,3p,25,C>G,183,114,297,5896783,6081437,11978220,2.4795002930318527e-05
WA13,5p,1,C>G,84,10,94,5896847,6081528,11978375,7.847475137487348e-06
WA13,5p,2,C>G,55,2,57,5896725,6081443,11978168,4.758657584365155e-06
WA13,5p,3,C>G,69,11,80,5896847,6081528,11978375,6.678702244670083e-06
WA13,5p,4,C>G,75,49,124,5896841,6081528,11978369,1.0351993664579878e-05
WA13,5p,5,C>G,175,147,322,5896841,6081528,11978369,2.6881789999957425e-05
WA13,5p,6,C>G,136,101,237,5896841,6081528,11978369,1.978566531052767e-05
WA13,5p,7,C>G,165,195,360,5896845,6081528,11978373,3.0054165119085872e-05
WA13,5p,8,C>G,175,124,299,5896843,6081526,11978369,2.4961662142817607e-05
WA13,5p,9,C>G,226,166,392,5896837,6081518,11978355,3.272569564017764e-05
WA13,5p,10,C>G,203,177,380,5896833,6081518,11978351,3.172389922452598e-05
WA13,5p,11,C>G,219,219,438,5896827,6081513,11978340,3.656600163294747e-05
WA13,5p,12,C>G,189,8878,9067,5896822,6081502,11978324,0.0007569506385033
WA13,5p,13,C>G,170,899,1069,5896809,6081508,11978317,8.924459087198978e-05
WA13,5p,14,C>G,168,661,829,5896802,6081520,11978322,6.92083582324803e-05
WA13,5p,15,C>G,213,465,678,5896798,6081508,11978306,5.6602327574533496e-05
WA13,5p,16,C>G,212,273,485,5896754,6081491,11978245,4.04900717926541e-05
WA13,5p,17,C>G,244,382,626,5896805,6081514,11978319,5.226108938992191e-05
WA13,5p,18,C>G,192,158,350,5896796,6081504,11978300,2.9219505272033597e-05
WA13,5p,19,C>G,187,216,403,5896797,6081472,11978269,3.364426028502115e-05
WA13,5p,20,C>G,268,192,460,5896788,6081482,11978270,3.840287453864373e-05
WA13,5p,21,C>G,236,118,354,5896782,6081484,11978266,2.9553526361829e-05
WA13,5p,22,C>G,223,176,399,5896771,6081483,11978254,3.3310363931170604e-05
WA13,5p,23,C>G,195,171,366,5896768,6081501,11978269,3.0555333162078764e-05
WA13,5p,24,C>G,203,157,360,5896781,6081498,11978279,3.005440097028964e-05
WA13,5p,25,C>G,312,208,520,5896769,6081462,11978231,4.3412086475874445e-05
WA14,3p,1,C>G,26,28,54,6684341,7140972,13825313,3.905879020605175e-06
WA14,3p,2,C>G,46,97,143,6684341,7140972,13825313,1.0343346295306298e-05
WA14,3p,3,C>G,349,99,448,6684341,7140972,13825313,3.240432965242812e-05
WA14,3p,4,C>G,201,123,324,6684341,7140971,13825312,2.3435275818730165e-05
WA14,3p,5,C>G,872,633,1505,6684341,7140970,13825311,0.0001088583106738
WA14,3p,6,C>G,883,840,1723,6684341,7140971,13825312,0.0001246264822088
WA14,3p,7,C>G,863,666,1529,6684341,7140969,13825310,0.0001105942651557
WA14,3p,8,C>G,758,721,1479,6684326,7140932,13825258,0.0001069781120902
WA14,3p,9,C>G,1105,1601,2706,6684323,7140920,13825243,0.0001957289285982
WA14,3p,10,C>G,974,1294,2268,6684256,7140912,13825168,0.0001640486394089
WA14,3p,11,C>G,941,1245,2186,6684256,7140894,13825150,0.0001581176334433
WA14,3p,12,C>G,1011,2049,3060,6684291,7140849,13825140,0.000221335914139
WA14,3p,13,C>G,1077,1082,2159,6684289,7140794,13825083,0.0001561654277229
WA14,3p,14,C>G,1000,1146,2146,6684291,7140742,13825033,0.0001552256692624
WA14,3p,15,C>G,1249,846,2095,6684271,7140702,13824973,0.0001515373664744
WA14,3p,16,C>G,1603,853,2456,6684263,7140648,13824911,0.0001776503299008
WA14,3p,17,C>G,1213,838,2051,6684212,7140653,13824865,0.0001483558790628
WA14,3p,18,C>G,1736,1222,2958,6684177,7140647,13824824,0.0002139629408663
WA14,3p,19,C>G,1664,1222,2886,6684172,7140542,13824714,0.0002087565789787
WA14,3p,20,C>G,1223,866,2089,6684176,7140544,13824720,0.0001511061345184
WA14,3p,21,C>G,1337,1103,2440,6684132,7140443,13824575,0.0001764972883434
WA14,3p,22,C>G,1569,1046,2615,6684105,7140560,13824665,0.0001891546739107
WA14,3p,23,C>G,1161,1318,2479,6683638,7140562,13824200,0.0001793232158099
WA14,3p,24,C>G,1073,854,1927,6683623,7140532,13824155,0.0001393936916939
WA14,3p,25,C>G,1112,842,1954,6683613,7140513,13824126,0.0001413470913097
WA14,5p,1,C>G,72,20,92,6684341,7140972,13825313,6.654460553623632e-06
WA14,5p,2,C>G,114,79,193,6684184,7140911,13825095,1.396012106969247e-05
WA14,5p,3,C>G,145,74,219,6684338,7140972,13825310,1.5840512798628024e-05
WA14,5p,4,C>G,302,548,850,6684341,7140972,13825313,6.148142902804443e-05
WA14,5p,5,C>G,824,859,1683,6684341,7140972,13825313,0.0001217332294755
WA14,5p,6,C>G,712,778,1490,6684340,7140972,13825312,0.0001077733363268
WA14,5p,7,C>G,915,895,1810,6684336,7140972,13825308,0.0001309193256309
WA14,5p,8,C>G,1261,886,2147,6684277,7140970,13825247,0.0001552955979737
WA14,5p,9,C>G,1491,684,2175,6684241,7140959,13825200,0.0001573214130717
WA14,5p,10,C>G,1103,908,2011,6684210,7140628,13824838,0.0001454628256765
WA14,5p,11,C>G,1056,850,1906,6684218,7140646,13824864,0.0001378675406861
WA14,5p,12,C>G,1102,808,1910,6684139,7140917,13825056,0.0001381549557556
WA14,5p,13,C>G,935,795,1730,6684018,7140931,13824949,0.0001251360854929
WA14,5p,14,C>G,1092,840,1932,6683951,7140942,13824893,0.0001397479170363
WA14,5p,15,C>G,949,998,1947,6684030,7140908,13824938,0.0001408324579828
WA14,5p,16,C>G,1098,1423,2521,6683910,7140868,13824778,0.0001823537419552
WA14,5p,17,C>G,1087,1052,2139,6683904,7140873,13824777,0.000154722206369
WA14,5p,18,C>G,1043,797,1840,6683891,7140646,13824537,0.0001330966816465
WA14,5p,19,C>G,1102,721,1823,6683958,7140595,13824553,0.0001318668314266
WA14,5p,20,C>G,1440,871,2311,6683860,7140558,13824418,0.0001671679777043
WA14,5p,21,C>G,1391,959,2350,6683480,7140494,13823974,0.0001699945326864
WA14,5p,22,C>G,1020,873,1893,6683768,7140398,13824166,0.00013693411957
WA14,5p,23,C>G,989,1276,2265,6683762,7140257,13824019,0.0001638452609186
WA14,5p,24,C>G,1474,1300,2774,6683714,7140421,13824135,0.0002006635496542
WA14,5p,25,C>G,1166,1369,2535,6683731,7140511,13824242,0.0001833735260132
WA18,3p,1,C>G,30,25,55,14112928,14131239,28244167,1.947304730212082e-06
WA18,3p,2,C>G,167,977,1144,14112928,14131239,28244167,4.050393838841132e-05
WA18,3p,3,C>G,257,221,478,14112928,14131239,28244167,1.692384838257046e-05
WA18,3p,4,C>G,781,392,1173,14112928,14131238,28244166,4.1530700534758224e-05
WA18,3p,5,C>G,1470,1331,2801,14112928,14131239,28244167,9.917091907861896e-05
WA18,3p,6,C>G,1372,1868,3240,14112928,14131239,28244167,0.0001147139513797
WA18,3p,7,C>G,1376,1575,2951,14112928,14131237,28244165,0.0001044817575594
WA18,3p,8,C>G,1480,2366,3846,14112927,14131187,28244114,0.0001361699644747
WA18,3p,9,C>G,1446,1358,2804,14112909,14131177,28244086,9.927742041289635e-05
WA18,3p,10,C>G,1728,1323,3051,14112909,14131197,28244106,0.0001080225375163
WA18,3p,11,C>G,1680,1770,3450,14112900,14131167,28244067,0.0001221495473721
WA18,3p,12,C>G,1901,2418,4319,14112895,14131136,28244031,0.0001529172659525
WA18,3p,13,C>G,1586,1478,3064,14112898,14131061,28243959,0.0001084833751528
WA18,3p,14,C>G,1553,1760,3313,14112830,14131006,28243836,0.0001172999305051
WA18,3p,15,C>G,1884,2949,4833,14112809,14130957,28243766,0.000171117406935
WA18,3p,16,C>G,1498,2103,3601,14112765,14130927,28243692,0.000127497495724
WA18,3p,17,C>G,2722,2309,5031,14112743,14130850,28243593,0.0001781288945779
WA18,3p,18,C>G,2495,1690,4185,14112708,14130769,28243477,0.0001481758071076
WA18,3p,19,C>G,1902,1420,3322,14112724,14130771,28243495,0.0001176200041814
WA18,3p,20,C>G,1933,1356,3289,14112697,14130797,28243494,0.000116451597667
WA18,3p,21,C>G,2355,2189,4544,14112659,14130783,28243442,0.0001608869060647
WA18,3p,22,C>G,2429,1988,4417,14112575,14130715,28243290,0.0001563911286539
WA18,3p,23,C>G,2338,1708,4046,14112548,14130648,28243196,0.0001432557420201
WA18,3p,24,C>G,2575,1690,4265,14112551,14130690,28243241,0.000151009581372
WA18,3p,25,C>G,2005,1771,3776,14112486,14130651,28243137,0.0001336961967078
WA18,5p,1,C>G,403,29,432,14112926,14131239,28244165,1.529519460037144e-05
WA18,5p,2,C>G,317,187,504,14112820,14131183,28244003,1.7844496051073214e-05
WA18,5p,3,C>G,463,173,636,14112928,14131239,28244167,2.2517923789361533e-05
WA18,5p,4,C>G,792,271,1063,14112928,14131239,28244167,3.763608960391716e-05
WA18,5p,5,C>G,1872,1419,3291,14112925,14131239,28244164,0.0001165196463241
WA18,5p,6,C>G,1584,1176,2760,14112927,14131239,28244166,9.771929537590168e-05
WA18,5p,7,C>G,1476,1257,2733,14112921,14131239,28244160,9.676336630298086e-05
WA18,5p,8,C>G,2024,3102,5126,14112828,14131230,28244058,0.0001814895012607
WA18,5p,9,C>G,2341,1613,3954,14112833,14131230,28244063,0.0001399940228146
WA18,5p,10,C>G,2306,2007,4313,14112791,14131213,28244004,0.0001527049776653
WA18,5p,11,C>G,2208,2056,4264,14112776,14131211,28243987,0.0001509701870348
WA18,5p,12,C>G,2348,2905,5253,14112682,14131223,28243905,0.000185987029768
WA18,5p,13,C>G,2128,1685,3813,14112608,14131206,28243814,0.0001350030134032
WA18,5p,14,C>G,2121,2133,4254,14112535,14131179,28243714,0.0001506175852085
WA18,5p,15,C>G,2641,2913,5554,14112545,14131148,28243693,0.000196645672363
WA18,5p,16,C>G,1925,2113,4038,14112522,14131083,28243605,0.0001429704175511
WA18,5p,17,C>G,2419,3426,5845,14112485,14130990,28243475,0.000206950454928
WA18,5p,18,C>G,1968,3531,5499,14112481,14130987,28243468,0.0001946998860055
WA18,5p,19,C>G,2200,2309,4509,14112359,14130867,28243226,0.0001596489012976
WA18,5p,20,C>G,2258,2701,4959,14112397,14130866,28243263,0.0001755816953586
WA18,5p,21,C>G,2486,2056,4542,14112347,14130679,28243026,0.0001608184618744
WA18,5p,22,C>G,2215,2108,4323,14112376,14129592,28241968,0.0001530700693379
WA18,5p,23,C>G,2479,2084,4563,14112288,14129275,28241563,0.0001615703776735
WA18,5p,24,C>G,2134,2149,4283,14112253,14129481,28241734,0.0001516549939886
WA18,5p,25,C>G,2027,2750,4777,14112273,14130551,28242824,0.000169140309765
WA22,3p,1,C>G,0,12,12,1513709,1653397,3167106,3.7889480175276734e-06
WA22,3p,2,C>G,0,0,0,1513709,1653396,3167105,0.0
WA22,3p,3,C>G,0,6,6,1513709,1653396,3167105,1.8944746069359875e-06
WA22,3p,4,C>G,6,9,15,1513709,1653394,3167103,4.736189508203554e-06
WA22,3p,5,C>G,21,19,40,1513709,1653397,3167106,1.2629826725092244e-05
WA22,3p,6,C>G,88,51,139,1513709,1653397,3167106,4.388864786969555e-05
WA22,3p,7,C>G,75,43,118,1513709,1653397,3167106,3.7257988839022125e-05
WA22,3p,8,C>G,66,70,136,1513709,1653395,3167104,4.294143798245969e-05
WA22,3p,9,C>G,25,185,210,1513709,1653397,3167106,6.630659030673429e-05
WA22,3p,10,C>G,143,120,263,1513706,1653396,3167102,8.304121559709792e-05
WA22,3p,11,C>G,68,113,181,1513685,1653390,3167075,5.715052532699731e-05
WA22,3p,12,C>G,97,125,222,1513662,1653379,3167041,7.009697695735546e-05
WA22,3p,13,C>G,68,79,147,1513689,1653380,3167069,4.641515546393211e-05
WA22,3p,14,C>G,94,71,165,1513686,1653352,3167038,5.209915384659104e-05
WA22,3p,15,C>G,154,145,299,1513677,1653343,3167020,9.441051840531478e-05
WA22,3p,16,C>G,126,73,199,1513637,1653341,3166978,6.283592749933849e-05
WA22,3p,17,C>G,107,109,216,1513671,1653319,3166990,6.820356237310506e-05
WA22,3p,18,C>G,98,91,189,1513665,1653288,3166953,5.967881430510652e-05
WA22,3p,19,C>G,123,131,254,1513662,1653275,3166937,8.020367945431184e-05
WA22,3p,20,C>G,131,89,220,1513684,1653304,3166988,6.946663517512539e-05
WA22,3p,21,C>G,59,79,138,1513677,1653327,3167004,4.357430555818685e-05
WA22,3p,22,C>G,163,185,348,1513684,1653356,3167040,0.0001098817823582
WA22,3p,23,C>G,90,197,287,1513676,1653329,3167005,9.062189671314064e-05
WA22,3p,24,C>G,38,131,169,1513672,1653285,3166957,5.3363528459653855e-05
WA22,3p,25,C>G,135,162,297,1513669,1653296,3166965,9.378063856089348e-05
WA22,5p,1,C>G,8,5,13,1513709,1653397,3167106,4.10469368565498e-06
WA22,5p,2,C>G,1,21,22,1513674,1653378,3167052,6.946523138868576e-06
WA22,5p,3,C>G,12,18,30,1513709,1653397,3167106,9.472370043819183e-06
WA22,5p,4,C>G,28,19,47,1513709,1653397,3167106,1.4840046401983388e-05
WA22,5p,5,C>G,75,81,156,1513708,1653396,3167104,4.9256355332821405e-05
WA22,5p,6,C>G,44,125,169,1513704,1653397,3167101,5.3361102156199e-05
WA22,5p,7,C>G,55,90,145,1513707,1653397,3167104,4.578315079012246e-05
WA22,5p,8,C>G,89,79,168,1513692,1653397,3167089,5.304555697676952e-05
WA22,5p,9,C>G,87,177,264,1513700,1653389,3167089,8.335730382063782e-05
WA22,5p,10,C>G,254,82,336,1513705,1653389,3167094,0.0001060909464638
WA22,5p,11,C>G,92,78,170,1513699,1653381,3167080,5.367720423860465e-05
WA22,5p,12,C>G,102,66,168,1513692,1653345,3167037,5.304642793879579e-05
WA22,5p,13,C>G,181,65,246,1513697,1653377,3167074,7.767421916886059e-05
WA22,5p,14,C>G,95,72,167,1513677,1653376,3167053,5.273040899536573e-05
WA22,5p,15,C>G,219,78,297,1513695,1653381,3167076,9.37773517275872e-05
WA22,5p,16,C>G,174,81,255,1513668,1653368,3167036,8.051692497338205e-05
WA22,5p,17,C>G,313,41,354,1513675,1653395,3167070,0.0001117752370487
WA22,5p,18,C>G,359,56,415,1513651,1653392,3167043,0.000131037058859
WA22,5p,19,C>G,147,138,285,1513674,1653350,3167024,8.998984535639768e-05
WA22,5p,20,C>G,47,85,132,1513678,1653356,3167034,4.167937571873242e-05
WA22,5p,21,C>G,63,178,241,1513690,1653371,3167061,7.609578722986391e-05
WA22,5p,22,C>G,132,70,202,1513691,1653380,3167071,6.378132981546672e-05
WA22,5p,23,C>G,124,117,241,1513634,1653393,3167027,7.60966041653576e-05
WA22,5p,24,C>G,149,94,243,1513632,1653375,3167007,7.67285958003882e-05
WA22,5p,25,C>G,130,73,203,1513644,1653364,3167008,6.409835403004982e-05
WA25,3p,1,C>G,28,11,39,3375244,3569089,6944333,5.616090127014359e-06
WA25,3p,2,C>G,52,122,174,3375244,3569089,6944333,2.5056402105140985e-05
WA25,3p,3,C>G,25,122,147,3375244,3569089,6944333,2.116833970951566e-05
WA25,3p,4,C>G,233,107,340,3375244,3569087,6944331,4.896079982362592e-05
WA25,3p,5,C>G,243,265,508,3375244,3569089,6944333,7.315317396213575e-05
WA25,3p,6,C>G,258,691,949,3375244,3569089,6944333,0.0001366581930906
WA25,3p,7,C>G,304,341,645,3375244,3569089,6944333,9.288149056216054e-05
WA25,3p,8,C>G,199,355,554,3375239,3569076,6944315,7.977748705235865e-05
WA25,3p,9,C>G,410,298,708,3375240,3569076,6944316,0.000101953885739
WA25,3p,10,C>G,271,400,671,3375240,3569075,6944315,9.66258011049326e-05
WA25,3p,11,C>G,462,414,876,3375233,3569054,6944287,0.0001261468600016
WA25,3p,12,C>G,357,515,872,3375226,3569069,6944295,0.0001255707022815
WA25,3p,13,C>G,311,308,619,3375230,3569053,6944283,8.91380722819044e-05
WA25,3p,14,C>G,315,450,765,3375223,3569037,6944260,0.0001101629259273
WA25,3p,15,C>G,288,661,949,3375218,3569039,6944257,0.0001366596887183
WA25,3p,16,C>G,487,361,848,3375196,3569030,6944226,0.0001221158412759
WA25,3p,17,C>G,404,538,942,3375198,3569022,6944220,0.000135652384285
WA25,3p,18,C>G,496,452,948,3375213,3569006,6944219,0.0001365164318694
WA25,3p,19,C>G,495,518,1013,3375204,3569005,6944209,0.0001458769458119
WA25,3p,20,C>G,385,480,865,3375190,3568979,6944169,0.0001245649407438
WA25,3p,21,C>G,393,509,902,3375199,3568998,6944197,0.0001298926283341
WA25,3p,22,C>G,583,395,978,3375179,3568994,6944173,0.0001408375050563
WA25,3p,23,C>G,430,479,909,3375175,3568972,6944147,0.0001309016067776
WA25,3p,24,C>G,350,501,851,3375177,3568962,6944139,0.0001225493902123
WA25,3p,25,C>G,596,342,938,3375156,3568970,6944126,0.0001350781941456
WA25,5p,1,C>G,32,19,51,3375244,3569089,6944333,7.344117858403392e-06
WA25,5p,2,C>G,26,30,56,3375147,3569045,6944192,8.064293153184705e-06
WA25,5p,3,C>G,48,26,74,3375243,3569089,6944332,1.0656172544745845e-05
WA25,5p,4,C>G,95,48,143,3375243,3569089,6944332,2.059233343106292e-05
WA25,5p,5,C>G,334,956,1290,3375244,3569088,6944332,0.0001857630078746
WA25,5p,6,C>G,257,348,605,3375244,3569089,6944333,8.71213981241971e-05
WA25,5p,7,C>G,220,465,685,3375242,3569089,6944331,9.864161140936398e-05
WA25,5p,8,C>G,321,275,596,3375221,3569088,6944309,8.582567394394461e-05
WA25,5p,9,C>G,336,504,840,3375227,3569087,6944314,0.0001209622721553
WA25,5p,10,C>G,423,304,727,3375217,3569085,6944302,0.0001046901474043
WA25,5p,11,C>G,460,292,752,3375193,3569088,6944281,0.0001082905487263
WA25,5p,12,C>G,435,307,742,3375142,3569084,6944226,0.0001068513611164
WA25,5p,13,C>G,369,398,767,3375133,3569081,6944214,0.000110451665228
WA25,5p,14,C>G,366,333,699,3375151,3569071,6944222,0.0001006592243162
WA25,5p,15,C>G,466,472,938,3375137,3569055,6944192,0.0001350769103158
WA25,5p,16,C>G,356,508,864,3375081,3569035,6944116,0.0001244218846574
WA25,5p,17,C>G,469,306,775,3375076,3568871,6943947,0.0001116079947038
WA25,5p,18,C>G,314,452,766,3375102,3568996,6944098,0.0001103095031204
WA25,5p,19,C>G,342,564,906,3375134,3569021,6944155,0.0001304694379661
WA25,5p,20,C>G,394,644,1038,3375145,3569019,6944164,0.000149478036521
WA25,5p,21,C>G,435,444,879,3375130,3569013,6944143,0.0001265814946495
WA25,5p,22,C>G,354,282,636,3375139,3569001,6944140,9.158801521858718e-05
WA25,5p,23,C>G,399,359,758,3375144,3569002,6944146,0.0001091566911179
WA25,5p,24,C>G,442,477,919,3375124,3568967,6944091,0.0001323427357158
WA25,5p,25,C>G,449,570,1019,3375125,3568950,6944075,0.0001467438067705
WA26,3p,1,C>G,2,9,11,2709623,2900126,5609749,1.9608720461468062e-06
WA26,3p,2,C>G,50,33,83,2709623,2900126,5609749,1.4795670893653174e-05
WA26,3p,3,C>G,88,20,108,2709623,2900126,5609749,1.9252198271259557e-05
WA26,3p,4,C>G,135,38,173,2709623,2900126,5609749,3.083916945303614e-05
WA26,3p,5,C>G,591,210,801,2709623,2900126,5609749,0.0001427871371785
WA26,3p,6,C>G,188,455,643,2709623,2900126,5609749,0.000114621884152
WA26,3p,7,C>G,206,258,464,2709623,2900126,5609749,8.271314812837437e-05
WA26,3p,8,C>G,411,340,751,2709619,2900114,5609733,0.000133874464257
WA26,3p,9,C>G,219,303,522,2709613,2900111,5609724,9.305270633635452e-05
WA26,3p,10,C>G,605,224,829,2709609,2900074,5609683,0.0001477801865096
WA26,3p,11,C>G,351,364,715,2709594,2900076,5609670,0.0001274584779496
WA26,3p,12,C>G,256,305,561,2709607,2900081,5609688,0.0001000055618066
WA26,3p,13,C>G,319,414,733,2709604,2900084,5609688,0.0001306668035726
WA26,3p,14,C>G,302,435,737,2709584,2900069,5609653,0.0001313806754178
WA26,3p,15,C>G,321,358,679,2709593,2900082,5609675,0.0001210408802648
WA26,3p,16,C>G,548,343,891,2709580,2900075,5609655,0.0001588332972348
WA26,3p,17,C>G,419,208,627,2709570,2900078,5609648,0.0001117717190098
WA26,3p,18,C>G,384,230,614,2709582,2900059,5609641,0.0001094544196322
WA26,3p,19,C>G,367,442,809,2709567,2900016,5609583,0.0001442174935284
WA26,3p,20,C>G,397,219,616,2709563,2899983,5609546,0.0001098128083805
WA26,3p,21,C>G,376,264,640,2709562,2900021,5609583,0.000114090476957
WA26,3p,22,C>G,403,243,646,2709522,2900007,5609529,0.0001151611837642
WA26,3p,23,C>G,314,232,546,2709541,2899974,5609515,9.733461805521512e-05
WA26,3p,24,C>G,337,210,547,2709558,2899951,5609509,9.751299088743776e-05
WA26,3p,25,C>G,365,329,694,2709500,2900002,5609502,0.000123718647395
WA26,5p,1,C>G,22,6,28,2709622,2900126,5609748,4.991311552675807e-06
WA26,5p,2,C>G,60,14,74,2709554,2900092,5609646,1.3191563246593456e-05
WA26,5p,3,C>G,32,67,99,2709623,2900126,5609749,1.7647848415321256e-05
WA26,5p,4,C>G,105,75,180,2709623,2900126,5609749,3.208699711876592e-05
WA26,5p,5,C>G,388,272,660,2709623,2900125,5609748,0.0001176523437416
WA26,5p,6,C>G,212,253,465,2709621,2900126,5609747,8.289143877611593e-05
WA26,5p,7,C>G,207,128,335,2709622,2900126,5609748,5.97174775052284e-05
WA26,5p,8,C>G,258,142,400,2709609,2900124,5609733,7.130464141519748e-05
WA26,5p,9,C>G,248,247,495,2709594,2900123,5609717,8.823974542744313e-05
WA26,5p,10,C>G,238,360,598,2709601,2900123,5609724,0.0001066006099408
WA26,5p,11,C>G,444,677,1121,2709605,2900103,5609708,0.000199832148126
WA26,5p,12,C>G,316,539,855,2709595,2900107,5609702,0.0001524145132843
WA26,5p,13,C>G,228,350,578,2709592,2900104,5609696,0.0001030358864366
WA26,5p,14,C>G,295,217,512,2709563,2900089,5609652,9.127125889449112e-05
WA26,5p,15,C>G,340,341,681,2709545,2900085,5609630,0.0001213983809983
WA26,5p,16,C>G,331,453,784,2709540,2900076,5609616,0.0001397600120935
WA26,5p,17,C>G,347,187,534,2709554,2900055,5609609,9.51938004948295e-05
WA26,5p,18,C>G,375,208,583,2709554,2900082,5609636,0.0001039283119261
WA26,5p,19,C>G,258,310,568,2709570,2900086,5609656,0.0001012539806362
WA26,5p,20,C>G,360,238,598,2709563,2900082,5609645,0.0001066021111852
WA26,5p,21,C>G,444,258,702,2709545,2900061,5609606,0.0001251424788122
WA26,5p,22,C>G,342,306,648,2709542,2900059,5609601,0.000115516237251
WA26,5p,23,C>G,326,211,537,2709528,2900065,5609593,9.57288701693688e-05
WA26,5p,24,C>G,382,207,589,2709495,2900057,5609552,0.0001049994723286
WA26,5p,25,C>G,308,243,551,2709506,2900041,5609547,9.822540037546704e-05
