Sample,End,Position,Substitution,Pos_Count,Neg_Count,Combined_Count,Pos_Total,Neg_Total,Combined_Total,Frequency
DAL192,3p,1,C>A,11,7,18,6350003,6167708,12517711,1.4379625795802444e-06
DAL192,3p,2,C>A,18,53,71,6350003,6167706,12517709,5.671964414574584e-06
DAL192,3p,3,C>A,66,76,142,6350003,6167708,12517711,1.1343927016688594e-05
DAL192,3p,4,C>A,296,129,425,6350003,6167708,12517711,3.39518942400891e-05
DAL192,3p,5,C>A,351,206,557,6350003,6167708,12517711,4.4496953157010895e-05
DAL192,3p,6,C>A,380,446,826,6350003,6167708,12517711,6.598650504073788e-05
DAL192,3p,7,C>A,279,235,514,6350003,6167708,12517711,4.1061820328013646e-05
DAL192,3p,8,C>A,427,330,757,6350003,6167618,12517621,6.0474749954484165e-05
DAL192,3p,9,C>A,325,360,685,6350003,6167637,12517640,5.4722775219610085e-05
DAL192,3p,10,C>A,430,276,706,6350003,6167645,12517648,5.640037169922017e-05
DAL192,3p,11,C>A,389,306,695,6349987,6167644,12517631,5.55216877698344e-05
DAL192,3p,12,C>A,693,303,996,6349997,6167646,12517643,7.956769497260786e-05
DAL192,3p,13,C>A,512,284,796,6349992,6167621,12517613,6.35903985847781e-05
DAL192,3p,14,C>A,411,425,836,6349967,6167610,12517577,6.678608807439331e-05
DAL192,3p,15,C>A,319,345,664,6349968,6167615,12517583,5.304538424071165e-05
DAL192,3p,16,C>A,405,303,708,6349943,6167587,12517530,5.656067930334499e-05
DAL192,3p,17,C>A,416,354,770,6349922,6167606,12517528,6.151374296905907e-05
DAL192,3p,18,C>A,402,376,778,6349922,6167564,12517486,6.215305533395443e-05
DAL192,3p,19,C>A,321,466,787,6349921,6167519,12517440,6.287228059411509e-05
DAL192,3p,20,C>A,476,390,866,6349910,6167516,12517426,6.918355259300115e-05
DAL192,3p,21,C>A,338,267,605,6349882,6167507,12517389,4.833276332628154e-05
DAL192,3p,22,C>A,466,288,754,6349894,6167488,12517382,6.023623789702991e-05
DAL192,3p,23,C>A,478,401,879,6349902,6167465,12517367,7.022243575665714e-05
DAL192,3p,24,C>A,416,392,808,6349899,6167465,12517364,6.455033184303021e-05
DAL192,3p,25,C>A,396,374,770,6349856,6167384,12517240,6.151515829368135e-05
DAL192,5p,1,C>A,8,2,10,6350003,6167708,12517711,7.988680997668024e-07
DAL192,5p,2,C>A,21,26,47,6349992,6167694,12517686,3.754687567654277e-06
DAL192,5p,3,C>A,23,15,38,6350003,6167707,12517710,3.03569902162616e-06
DAL192,5p,4,C>A,152,68,220,6350003,6167708,12517711,1.7575098194869652e-05
DAL192,5p,5,C>A,205,325,530,6350003,6167707,12517710,4.234001267004908e-05
DAL192,5p,6,C>A,288,244,532,6350002,6167707,12517709,4.2499789697939135e-05
DAL192,5p,7,C>A,107,192,299,6350002,6167708,12517710,2.3886158091216365e-05
DAL192,5p,8,C>A,181,182,363,6349926,6167708,12517634,2.8999090403186417e-05
DAL192,5p,9,C>A,269,274,543,6349914,6167708,12517622,4.33788462377279e-05
DAL192,5p,10,C>A,508,628,1136,6349896,6167708,12517604,9.075219187314122e-05
DAL192,5p,11,C>A,309,272,581,6349942,6167706,12517648,4.6414470194400735e-05
DAL192,5p,12,C>A,345,289,634,6349906,6167700,12517606,5.0648662372022255e-05
DAL192,5p,13,C>A,375,418,793,6349906,6167705,12517611,6.335074640041139e-05
DAL192,5p,14,C>A,264,441,705,6349889,6167679,12517568,5.6320844432400926e-05
DAL192,5p,15,C>A,389,414,803,6349890,6167649,12517539,6.414998986621891e-05
DAL192,5p,16,C>A,269,435,704,6349904,6167639,12517543,5.6241069034074815e-05
DAL192,5p,17,C>A,345,440,785,6349778,6167623,12517401,6.271269890610678e-05
DAL192,5p,18,C>A,394,498,892,6349859,6167631,12517490,7.126029259859605e-05
DAL192,5p,19,C>A,385,469,854,6349822,6167638,12517460,6.82247037338246e-05
DAL192,5p,20,C>A,412,425,837,6349836,6167621,12517457,6.686661675770087e-05
DAL192,5p,21,C>A,567,539,1106,6349784,6167624,12517408,8.835695057634936e-05
DAL192,5p,22,C>A,784,442,1226,6349783,6167584,12517367,9.794392063442736e-05
DAL192,5p,23,C>A,370,548,918,6349801,6167567,12517368,7.333810110879539e-05
DAL192,5p,24,C>A,802,419,1221,6349759,6167564,12517323,9.754481848874556e-05
DAL192,5p,25,C>A,468,540,1008,6349777,6167551,12517328,8.052836835465205e-05
DAL193,3p,1,C>A,30,22,52,6484405,6362696,12847101,4.047605759462777e-06
DAL193,3p,2,C>A,153,185,338,6484402,6362696,12847098,2.6309443580176627e-05
DAL193,3p,3,C>A,243,206,449,6484405,6362696,12847101,3.494951896151513e-05
DAL193,3p,4,C>A,368,217,585,6484405,6362696,12847101,4.553556479395624e-05
DAL193,3p,5,C>A,1028,813,1841,6484405,6362696,12847101,0.0001433008115994
DAL193,3p,6,C>A,1073,939,2012,6484405,6362696,12847101,0.0001566112074622
DAL193,3p,7,C>A,1240,1045,2285,6484405,6362696,12847101,0.0001778611376994
DAL193,3p,8,C>A,1259,1311,2570,6484400,6362644,12847044,0.0002000460183681
DAL193,3p,9,C>A,1149,1738,2887,6484400,6362631,12847031,0.0002247211826608
DAL193,3p,10,C>A,1202,1335,2537,6484393,6362640,12847033,0.0001974775031713
DAL193,3p,11,C>A,1369,1006,2375,6484398,6362639,12847037,0.000184867530155
DAL193,3p,12,C>A,1521,1270,2791,6484368,6362594,12846962,0.0002172498058295
DAL193,3p,13,C>A,1329,1280,2609,6484385,6362543,12846928,0.0002030835698619
DAL193,3p,14,C>A,987,1191,2178,6484363,6362486,12846849,0.0001695357359614
DAL193,3p,15,C>A,1482,1248,2730,6484332,6362438,12846770,0.0002125047774654
DAL193,3p,16,C>A,1111,1269,2380,6484341,6362460,12846801,0.0001852601281828
DAL193,3p,17,C>A,1191,1039,2230,6484294,6362445,12846739,0.0001735849074228
DAL193,3p,18,C>A,1298,1320,2618,6484244,6362380,12846624,0.0002037889487541
DAL193,3p,19,C>A,1298,1077,2375,6484265,6362400,12846665,0.0001848728833514
DAL193,3p,20,C>A,1260,1727,2987,6484261,6362382,12846643,0.0002325121045241
DAL193,3p,21,C>A,1812,1319,3131,6484248,6362443,12846691,0.000243720347909
DAL193,3p,22,C>A,1329,1404,2733,6484224,6362407,12846631,0.0002127406010182
DAL193,3p,23,C>A,1586,1967,3553,6484218,6362399,12846617,0.0002765708668671
DAL193,3p,24,C>A,1774,1517,3291,6484164,6362319,12846483,0.0002561790647292
DAL193,3p,25,C>A,1358,1198,2556,6484128,6362355,12846483,0.0001989649618498
DAL193,5p,1,C>A,6,18,24,6484405,6362696,12847101,1.8681257351366665e-06
DAL193,5p,2,C>A,85,79,164,6484386,6362681,12847067,1.2765559640967078e-05
DAL193,5p,3,C>A,101,96,197,6484400,6362696,12847096,1.5334204710543146e-05
DAL193,5p,4,C>A,260,378,638,6484403,6362696,12847099,4.966101685680168e-05
DAL193,5p,5,C>A,1143,1081,2224,6484403,6362696,12847099,0.000173113011739
DAL193,5p,6,C>A,1105,1107,2212,6484404,6362696,12847100,0.0001721789353239
DAL193,5p,7,C>A,504,696,1200,6484404,6362696,12847100,9.340629402744588e-05
DAL193,5p,8,C>A,944,1009,1953,6484314,6362693,12847007,0.0001520198439994
DAL193,5p,9,C>A,984,1116,2100,6484295,6362695,12846990,0.000163462414153
DAL193,5p,10,C>A,1733,2218,3951,6484284,6362694,12846978,0.0003075431436093
DAL193,5p,11,C>A,1131,1020,2151,6484315,6362677,12846992,0.000167432189574
DAL193,5p,12,C>A,1089,903,1992,6484218,6362670,12846888,0.0001550570068019
DAL193,5p,13,C>A,1368,1180,2548,6484143,6362652,12846795,0.0001983374063336
DAL193,5p,14,C>A,1557,1210,2767,6484145,6362627,12846772,0.0002153848453136
DAL193,5p,15,C>A,1686,1520,3206,6484166,6362534,12846700,0.0002495582523138
DAL193,5p,16,C>A,1285,1708,2993,6484111,6362519,12846630,0.0002329793883687
DAL193,5p,17,C>A,1192,1483,2675,6484043,6362598,12846641,0.0002082256365691
DAL193,5p,18,C>A,2037,1385,3422,6483967,6362571,12846538,0.0002663752677958
DAL193,5p,19,C>A,1412,1099,2511,6483980,6362593,12846573,0.0001954606882317
DAL193,5p,20,C>A,1101,998,2099,6483952,6362554,12846506,0.0001633907305223
DAL193,5p,21,C>A,1288,1150,2438,6484003,6362532,12846535,0.0001897788002757
DAL193,5p,22,C>A,1550,1314,2864,6484010,6362499,12846509,0.0002229399442292
DAL193,5p,23,C>A,1038,1247,2285,6483966,6362463,12846429,0.0001778704416612
DAL193,5p,24,C>A,1767,1234,3001,6483905,6362426,12846331,0.0002336075568969
DAL193,5p,25,C>A,1278,1253,2531,6483942,6362403,12846345,0.0001970210203758
DAL195,3p,1,C>A,7,7,14,2363278,2267461,4630739,3.0232755506194584e-06
DAL195,3p,2,C>A,52,35,87,2363278,2267460,4630738,1.878750212169205e-05
DAL195,3p,3,C>A,78,30,108,2363278,2267461,4630739,2.3322411390492965e-05
DAL195,3p,4,C>A,58,57,115,2363278,2267461,4630739,2.4834049165802692e-05
DAL195,3p,5,C>A,200,226,426,2363278,2267461,4630739,9.19939560402778e-05
DAL195,3p,6,C>A,214,200,414,2363278,2267461,4630739,8.94025769968897e-05
DAL195,3p,7,C>A,268,246,514,2363278,2267461,4630739,0.0001109974023584
DAL195,3p,8,C>A,236,203,439,2363278,2267413,4630691,9.480226601170322e-05
DAL195,3p,9,C>A,263,231,494,2363276,2267438,4630714,0.0001066790132148
DAL195,3p,10,C>A,302,205,507,2363274,2267432,4630706,0.0001094865448162
DAL195,3p,11,C>A,220,246,466,2363274,2267431,4630705,0.0001006326250538
DAL195,3p,12,C>A,268,296,564,2363273,2267414,4630687,0.0001217961827262
DAL195,3p,13,C>A,255,274,529,2363269,2267412,4630681,0.0001142380569942
DAL195,3p,14,C>A,298,220,518,2363250,2267410,4630660,0.0001118631037476
DAL195,3p,15,C>A,364,220,584,2363254,2267411,4630665,0.0001261157954635
DAL195,3p,16,C>A,324,242,566,2363259,2267394,4630653,0.000122228981528
DAL195,3p,17,C>A,372,261,633,2363234,2267398,4630632,0.0001366984031553
DAL195,3p,18,C>A,341,251,592,2363236,2267374,4630610,0.0001278449275581
DAL195,3p,19,C>A,379,365,744,2363215,2267369,4630584,0.0001606708786623
DAL195,3p,20,C>A,304,437,741,2363222,2267380,4630602,0.0001600223901773
DAL195,3p,21,C>A,312,289,601,2363235,2267382,4630617,0.0001297883197854
DAL195,3p,22,C>A,333,259,592,2363231,2267383,4630614,0.0001278448171236
DAL195,3p,23,C>A,288,332,620,2363219,2267370,4630589,0.0001338922543114
DAL195,3p,24,C>A,401,367,768,2363198,2267373,4630571,0.0001658542758549
DAL195,3p,25,C>A,294,396,690,2363180,2267377,4630557,0.0001490101514785
DAL195,5p,1,C>A,3,0,3,2363278,2267461,4630739,6.478447608470268e-07
DAL195,5p,2,C>A,19,6,25,2363264,2267447,4630711,5.39873898414304e-06
DAL195,5p,3,C>A,38,22,60,2363278,2267459,4630737,1.2956900812980742e-05
DAL195,5p,4,C>A,51,66,117,2363278,2267461,4630739,2.5265945673034045e-05
DAL195,5p,5,C>A,244,321,565,2363277,2267461,4630738,0.0001220107896408
DAL195,5p,6,C>A,351,276,627,2363277,2267461,4630738,0.0001353995842563
DAL195,5p,7,C>A,212,211,423,2363277,2267461,4630738,9.134613100546824e-05
DAL195,5p,8,C>A,351,269,620,2363212,2267460,4630672,0.0001338898544314
DAL195,5p,9,C>A,321,237,558,2363181,2267461,4630642,0.0001205016496632
DAL195,5p,10,C>A,470,455,925,2363146,2267458,4630604,0.000199757958141
DAL195,5p,11,C>A,280,297,577,2362948,2267450,4630398,0.0001246113185086
DAL195,5p,12,C>A,261,354,615,2362864,2267454,4630318,0.0001328202512224
DAL195,5p,13,C>A,415,309,724,2363073,2267445,4630518,0.0001563539975441
DAL195,5p,14,C>A,322,345,667,2363094,2267434,4630528,0.0001440440485404
DAL195,5p,15,C>A,372,389,761,2363178,2267432,4630610,0.0001643411991076
DAL195,5p,16,C>A,286,394,680,2363170,2267429,4630599,0.0001468492521161
DAL195,5p,17,C>A,286,321,607,2363159,2267431,4630590,0.0001310848077674
DAL195,5p,18,C>A,295,332,627,2363182,2267420,4630602,0.0001354035609192
DAL195,5p,19,C>A,370,328,698,2363138,2267420,4630558,0.0001507377728558
DAL195,5p,20,C>A,362,318,680,2363110,2267401,4630511,0.0001468520428954
DAL195,5p,21,C>A,487,288,775,2363086,2267400,4630486,0.0001673690407443
DAL195,5p,22,C>A,386,297,683,2363094,2267388,4630482,0.0001475008433247
DAL195,5p,23,C>A,312,301,613,2363068,2267398,4630466,0.0001323840840209
DAL195,5p,24,C>A,390,337,727,2363067,2267402,4630469,0.0001570035346311
DAL195,5p,25,C>A,441,333,774,2363135,2267374,4630509,0.0001671522504329
DAL212,3p,1,C>A,7,5,12,4131322,4008153,8139475,1.4742965608961266e-06
DAL212,3p,2,C>A,38,232,270,4131322,4008153,8139475,3.3171672620162846e-05
DAL212,3p,3,C>A,135,92,227,4131322,4008153,8139475,2.788877661028506e-05
DAL212,3p,4,C>A,173,91,264,4131322,4008153,8139475,3.243452433971478e-05
DAL212,3p,5,C>A,326,422,748,4131322,4008151,8139473,9.189784154330384e-05
DAL212,3p,6,C>A,462,417,879,4131322,4008151,8139473,0.000107992249621
DAL212,3p,7,C>A,439,393,832,4131322,4008153,8139475,0.0001022178948887
DAL212,3p,8,C>A,509,290,799,4131319,4008093,8139412,9.816433914390868e-05
DAL212,3p,9,C>A,515,592,1107,4131316,4008115,8139431,0.00013600459295
DAL212,3p,10,C>A,541,477,1018,4131317,4008102,8139419,0.000125070352073
DAL212,3p,11,C>A,475,435,910,4131313,4008105,8139418,0.000111801605471
DAL212,3p,12,C>A,471,535,1006,4131314,4008034,8139348,0.0001235971235042
DAL212,3p,13,C>A,453,480,933,4131307,4007923,8139230,0.0001146300079982
DAL212,3p,14,C>A,518,494,1012,4131271,4007904,8139175,0.0001243369260398
DAL212,3p,15,C>A,518,534,1052,4131254,4007935,8139189,0.0001292512067234
DAL212,3p,16,C>A,440,563,1003,4131236,4007982,8139218,0.0001232305118255
DAL212,3p,17,C>A,503,493,996,4131249,4007981,8139230,0.0001223702979274
DAL212,3p,18,C>A,561,501,1062,4131222,4007954,8139176,0.0001304800387655
DAL212,3p,19,C>A,715,431,1146,4131233,4007956,8139189,0.0001408002689211
DAL212,3p,20,C>A,529,487,1016,4131221,4007928,8139149,0.0001248287750967
DAL212,3p,21,C>A,604,537,1141,4131228,4007917,8139145,0.0001401867149436
DAL212,3p,22,C>A,545,490,1035,4131183,4007898,8139081,0.0001271642338981
DAL212,3p,23,C>A,495,454,949,4131172,4007904,8139076,0.0001165980020336
DAL212,3p,24,C>A,528,563,1091,4131124,4007904,8139028,0.0001340454904443
DAL212,3p,25,C>A,653,817,1470,4131071,4007924,8138995,0.0001806119797345
DAL212,5p,1,C>A,2,4,6,4131322,4008153,8139475,7.371482804480633e-07
DAL212,5p,2,C>A,176,51,227,4131307,4008143,8139450,2.7888862269563668e-05
DAL212,5p,3,C>A,44,33,77,4131321,4008153,8139474,9.460070761329295e-06
DAL212,5p,4,C>A,231,71,302,4131322,4008153,8139475,3.710313011588585e-05
DAL212,5p,5,C>A,369,709,1078,4131322,4008153,8139475,0.0001324409743871
DAL212,5p,6,C>A,484,558,1042,4131322,4008153,8139475,0.0001280180847044
DAL212,5p,7,C>A,259,269,528,4131322,4008153,8139475,6.486904867942957e-05
DAL212,5p,8,C>A,362,417,779,4131248,4008153,8139401,9.570728853388598e-05
DAL212,5p,9,C>A,469,389,858,4131243,4008153,8139396,0.0001054132272222
DAL212,5p,10,C>A,674,815,1489,4131179,4008148,8139327,0.0001829389579752
DAL212,5p,11,C>A,459,456,915,4131234,4008143,8139377,0.0001124164662725
DAL212,5p,12,C>A,481,824,1305,4131187,4008141,8139328,0.0001603326466263
DAL212,5p,13,C>A,528,526,1054,4131181,4008142,8139323,0.000129494799506
DAL212,5p,14,C>A,584,538,1122,4131134,4008108,8139242,0.0001378506745468
DAL212,5p,15,C>A,658,461,1119,4131156,4008091,8139247,0.0001374820053992
DAL212,5p,16,C>A,583,512,1095,4131154,4008081,8139235,0.0001345335280281
DAL212,5p,17,C>A,666,436,1102,4131159,4008081,8139240,0.0001353934765408
DAL212,5p,18,C>A,564,579,1143,4131113,4008066,8139179,0.0001404318543676
DAL212,5p,19,C>A,641,632,1273,4131040,4008052,8139092,0.0001564056531121
DAL212,5p,20,C>A,482,548,1030,4131020,4008040,8139060,0.0001265502404454
DAL212,5p,21,C>A,699,653,1352,4130973,4008040,8139013,0.0001661135078663
DAL212,5p,22,C>A,561,558,1119,4131015,4007967,8138982,0.0001374864817246
DAL212,5p,23,C>A,616,530,1146,4131005,4007962,8138967,0.0001408041094158
DAL212,5p,24,C>A,637,492,1129,4131060,4007918,8138978,0.0001387152047836
DAL212,5p,25,C>A,495,510,1005,4131016,4007614,8138630,0.0001234851565926
DAL218,3p,1,C>A,49,22,71,6952891,6658031,13610922,5.2163990066213e-06
DAL218,3p,2,C>A,39,190,229,6952891,6658031,13610922,1.6824723556567292e-05
DAL218,3p,3,C>A,171,142,313,6952891,6658030,13610921,2.299623956380321e-05
DAL218,3p,4,C>A,174,384,558,6952891,6658031,13610922,4.099648796753078e-05
DAL218,3p,5,C>A,918,1303,2221,6952891,6658031,13610922,0.0001631777773761
DAL218,3p,6,C>A,906,839,1745,6952891,6658030,13610921,0.0001282058723285
DAL218,3p,7,C>A,892,704,1596,6952891,6658026,13610917,0.0001172588151114
DAL218,3p,8,C>A,943,800,1743,6952887,6657945,13610832,0.0001280597688664
DAL218,3p,9,C>A,1226,1453,2679,6952882,6657945,13610827,0.0001968285982916
DAL218,3p,10,C>A,1491,1259,2750,6952881,6657960,13610841,0.0002020448258854
DAL218,3p,11,C>A,1280,1140,2420,6952866,6657905,13610771,0.0001778003611992
DAL218,3p,12,C>A,1305,2212,3517,6952858,6657882,13610740,0.0002583988820593
DAL218,3p,13,C>A,1188,976,2164,6952870,6657811,13610681,0.0001589927792738
DAL218,3p,14,C>A,1358,1200,2558,6952816,6657779,13610595,0.0001879418203245
DAL218,3p,15,C>A,1917,1296,3213,6952788,6657738,13610526,0.00023606729086
DAL218,3p,16,C>A,1311,1331,2642,6952760,6657689,13610449,0.0001941155651808
DAL218,3p,17,C>A,1170,1279,2449,6952737,6657651,13610388,0.0001799360899924
DAL218,3p,18,C>A,1274,1187,2461,6952711,6657672,13610383,0.0001808178359124
DAL218,3p,19,C>A,1316,1229,2545,6952716,6657697,13610413,0.0001869891824737
DAL218,3p,20,C>A,1371,1540,2911,6952697,6657752,13610449,0.0002138797919157
DAL218,3p,21,C>A,1362,1466,2828,6952660,6657692,13610352,0.0002077830169271
DAL218,3p,22,C>A,1657,1235,2892,6952654,6657637,13610291,0.0002124862723361
DAL218,3p,23,C>A,1143,1182,2325,6952651,6657632,13610283,0.0001708267197676
DAL218,3p,24,C>A,1446,1319,2765,6952669,6657588,13610257,0.0002031556053643
DAL218,3p,25,C>A,1025,1001,2026,6952605,6657566,13610171,0.0001488592612098
DAL218,5p,1,C>A,9,44,53,6952891,6658031,13610922,3.893931652829985e-06
DAL218,5p,2,C>A,65,31,96,6952874,6658014,13610888,7.053176839013002e-06
DAL218,5p,3,C>A,68,170,238,6952891,6658031,13610922,1.748595723346295e-05
DAL218,5p,4,C>A,259,140,399,6952891,6658031,13610922,2.9314693009040823e-05
DAL218,5p,5,C>A,1435,818,2253,6952891,6658031,13610922,0.0001655288304495
DAL218,5p,6,C>A,1129,946,2075,6952891,6658031,13610922,0.0001524510977287
DAL218,5p,7,C>A,583,1301,1884,6952888,6658031,13610919,0.0001384182802057
DAL218,5p,8,C>A,879,713,1592,6952719,6658029,13610748,0.0001169663856828
DAL218,5p,9,C>A,937,856,1793,6952736,6658029,13610765,0.0001317339620513
DAL218,5p,10,C>A,1878,1308,3186,6952716,6658028,13610744,0.0002340797828538
DAL218,5p,11,C>A,1256,1143,2399,6952715,6658016,13610731,0.0001762579834984
DAL218,5p,12,C>A,1008,958,1966,6952625,6658005,13610630,0.0001444459220476
DAL218,5p,13,C>A,1508,1030,2538,6952475,6658005,13610480,0.0001864739524248
DAL218,5p,14,C>A,1183,1054,2237,6952554,6657955,13610509,0.0001643582910822
DAL218,5p,15,C>A,1156,1403,2559,6952449,6657923,13610372,0.0001880183730466
DAL218,5p,16,C>A,1313,1079,2392,6952253,6657920,13610173,0.0001757508886918
DAL218,5p,17,C>A,2251,1241,3492,6952350,6657874,13610224,0.0002565718242403
DAL218,5p,18,C>A,1886,1269,3155,6952457,6657843,13610300,0.000231809732335
DAL218,5p,19,C>A,1530,1261,2791,6952296,6657770,13610066,0.0002050688071608
DAL218,5p,20,C>A,1337,1063,2400,6952289,6657772,13610061,0.0001763401354336
DAL218,5p,21,C>A,1555,1000,2555,6952371,6657729,13610100,0.00018772823124
DAL218,5p,22,C>A,1407,1203,2610,6952322,6657786,13610108,0.000191769235042
DAL218,5p,23,C>A,1564,1070,2634,6952288,6657745,13610033,0.0001935336967955
DAL218,5p,24,C>A,1536,1516,3052,6952375,6657772,13610147,0.0002242444552582
DAL218,5p,25,C>A,2667,1068,3735,6952272,6657720,13609992,0.0002744307270716
DAL224,3p,1,C>A,14,26,40,4609472,4586477,9195949,4.3497413915627415e-06
DAL224,3p,2,C>A,78,75,153,4609471,4586476,9195947,1.663776444122612e-05
DAL224,3p,3,C>A,115,116,231,4609472,4586477,9195949,2.511975653627483e-05
DAL224,3p,4,C>A,244,357,601,4609472,4586477,9195949,6.535486440823019e-05
DAL224,3p,5,C>A,460,588,1048,4609472,4586477,9195949,0.0001139632244589
DAL224,3p,6,C>A,459,625,1084,4609472,4586477,9195949,0.0001178779917113
DAL224,3p,7,C>A,440,946,1386,4609472,4586476,9195948,0.0001507185556073
DAL224,3p,8,C>A,513,4730,5243,4609469,4586423,9195892,0.0005701458868807
DAL224,3p,9,C>A,759,1370,2129,4609466,4586431,9195897,0.0002315162947127
DAL224,3p,10,C>A,472,699,1171,4609461,4586371,9195832,0.0001273402993878
DAL224,3p,11,C>A,516,598,1114,4609461,4586382,9195843,0.0001211416941328
DAL224,3p,12,C>A,706,1444,2150,4609458,4586384,9195842,0.0002338013202053
DAL224,3p,13,C>A,591,667,1258,4609454,4586364,9195818,0.0001368013155545
DAL224,3p,14,C>A,586,446,1032,4609412,4586293,9195705,0.0001122263056503
DAL224,3p,15,C>A,524,623,1147,4609400,4586272,9195672,0.000124732591593
DAL224,3p,16,C>A,809,867,1676,4609379,4586240,9195619,0.0001822607047986
DAL224,3p,17,C>A,622,744,1366,4609381,4586216,9195597,0.0001485493546531
DAL224,3p,18,C>A,685,762,1447,4609363,4586282,9195645,0.0001573570967561
DAL224,3p,19,C>A,607,1156,1763,4609353,4586195,9195548,0.0001917232121457
DAL224,3p,20,C>A,568,1155,1723,4609344,4586225,9195569,0.0001873728531643
DAL224,3p,21,C>A,754,946,1700,4609343,4586223,9195566,0.0001848717088214
DAL224,3p,22,C>A,680,1622,2302,4609324,4586172,9195496,0.0002503399490359
DAL224,3p,23,C>A,842,756,1598,4609323,4586083,9195406,0.0001737824300525
DAL224,3p,24,C>A,562,768,1330,4609325,4586202,9195527,0.0001446355385613
DAL224,3p,25,C>A,567,1335,1902,4609265,4586173,9195438,0.0002068416969371
DAL224,5p,1,C>A,5,7,12,4609472,4586477,9195949,1.3049224174688225e-06
DAL224,5p,2,C>A,24,54,78,4609461,4586469,9195930,8.482013238465277e-06
DAL224,5p,3,C>A,64,37,101,4609468,4586477,9195945,1.0983101791061169e-05
DAL224,5p,4,C>A,59,78,137,4609471,4586477,9195948,1.4897865886148986e-05
DAL224,5p,5,C>A,745,354,1099,4609471,4586477,9195948,0.000119509157729
DAL224,5p,6,C>A,1561,375,1936,4609472,4586477,9195949,0.0002105274833516
DAL224,5p,7,C>A,519,207,726,4609471,4586477,9195948,7.89478148419282e-05
DAL224,5p,8,C>A,893,311,1204,4609397,4586477,9195874,0.0001309282837063
DAL224,5p,9,C>A,695,378,1073,4609357,4586473,9195830,0.0001166833227669
DAL224,5p,10,C>A,894,820,1714,4609338,4586470,9195808,0.0001863892765051
DAL224,5p,11,C>A,757,506,1263,4609388,4586469,9195857,0.0001373444584882
DAL224,5p,12,C>A,484,572,1056,4609357,4586464,9195821,0.0001148347711422
DAL224,5p,13,C>A,1074,471,1545,4609320,4586461,9195781,0.0001680118306427
DAL224,5p,14,C>A,1233,437,1670,4609270,4586428,9195698,0.0001816066599838
DAL224,5p,15,C>A,964,678,1642,4609299,4586416,9195715,0.0001785614277954
DAL224,5p,16,C>A,1264,823,2087,4609292,4586373,9195665,0.000226954766186
DAL224,5p,17,C>A,1255,788,2043,4609285,4586385,9195670,0.0002221697820822
DAL224,5p,18,C>A,2499,534,3033,4609226,4586351,9195577,0.0003298324835951
DAL224,5p,19,C>A,1279,445,1724,4609203,4586337,9195540,0.0001874821924541
DAL224,5p,20,C>A,1079,749,1828,4609148,4586313,9195461,0.0001987937309505
DAL224,5p,21,C>A,1276,1495,2771,4609195,4586347,9195542,0.0003013416718666
DAL224,5p,22,C>A,5197,1273,6470,4609138,4586312,9195450,0.000703608850029
DAL224,5p,23,C>A,712,623,1335,4609100,4586313,9195413,0.0001451810810455
DAL224,5p,24,C>A,1000,802,1802,4609109,4586316,9195425,0.0001959670162064
DAL224,5p,25,C>A,1560,885,2445,4609125,4586257,9195382,0.0002658943369617
DAL227,3p,1,C>A,22,14,36,3765386,3771243,7536629,4.776671373899392e-06
DAL227,3p,2,C>A,35,63,98,3765386,3771243,7536629,1.3003160962281678e-05
DAL227,3p,3,C>A,49,80,129,3765386,3771243,7536629,1.711640575647282e-05
DAL227,3p,4,C>A,152,119,271,3765386,3771243,7536629,3.5957720620187086e-05
DAL227,3p,5,C>A,286,175,461,3765386,3771243,7536629,6.116793064910054e-05
DAL227,3p,6,C>A,268,263,531,3765386,3771243,7536629,7.045590276501602e-05
DAL227,3p,7,C>A,394,226,620,3765386,3771243,7536629,8.226489588382287e-05
DAL227,3p,8,C>A,490,271,761,3765386,3771207,7536593,0.0001009740077512
DAL227,3p,9,C>A,476,383,859,3765384,3771218,7536602,0.0001139770947172
DAL227,3p,10,C>A,595,233,828,3765382,3771209,7536591,0.0001098639955385
DAL227,3p,11,C>A,532,359,891,3765378,3771214,7536592,0.0001182231969038
DAL227,3p,12,C>A,497,358,855,3765377,3771173,7536550,0.0001134471342988
DAL227,3p,13,C>A,674,349,1023,3765373,3771183,7536556,0.0001357383929741
DAL227,3p,14,C>A,656,270,926,3765341,3771166,7536507,0.0001228685915106
DAL227,3p,15,C>A,685,335,1020,3765341,3771186,7536527,0.0001353408539503
DAL227,3p,16,C>A,809,581,1390,3765340,3771079,7536419,0.0001844377283163
DAL227,3p,17,C>A,639,302,941,3765328,3771049,7536377,0.0001248610572427
DAL227,3p,18,C>A,470,394,864,3765321,3771036,7536357,0.0001146442505311
DAL227,3p,19,C>A,661,351,1012,3765313,3771111,7536424,0.0001342811922471
DAL227,3p,20,C>A,591,459,1050,3765308,3771082,7536390,0.0001393239999522
DAL227,3p,21,C>A,426,525,951,3765307,3771104,7536411,0.0001261873854809
DAL227,3p,22,C>A,558,255,813,3765309,3771137,7536446,0.0001078757812369
DAL227,3p,23,C>A,464,387,851,3765319,3771112,7536431,0.0001129181704178
DAL227,3p,24,C>A,637,340,977,3765312,3771081,7536393,0.0001296376131127
DAL227,3p,25,C>A,563,300,863,3765249,3771100,7536349,0.0001145116819828
DAL227,5p,1,C>A,7,3,10,3765386,3771243,7536629,1.3268531594164975e-06
DAL227,5p,2,C>A,3,15,18,3765373,3771238,7536611,2.388341391110673e-06
DAL227,5p,3,C>A,13,20,33,3765386,3771243,7536629,4.378615426074443e-06
DAL227,5p,4,C>A,39,23,62,3765385,3771243,7536628,8.2264906799168e-06
DAL227,5p,5,C>A,187,273,460,3765386,3771242,7536628,6.103525343164079e-05
DAL227,5p,6,C>A,205,362,567,3765386,3771243,7536629,7.523257413891542e-05
DAL227,5p,7,C>A,104,123,227,3765386,3771243,7536629,3.01195667187545e-05
DAL227,5p,8,C>A,223,162,385,3765342,3771242,7536584,5.108415165279124e-05
DAL227,5p,9,C>A,163,276,439,3765324,3771243,7536567,5.824933288591477e-05
DAL227,5p,10,C>A,460,412,872,3765318,3771238,7536556,0.0001157027162008
DAL227,5p,11,C>A,462,246,708,3765365,3771237,7536602,9.394154023258756e-05
DAL227,5p,12,C>A,197,391,588,3765326,3771232,7536558,7.801970077056396e-05
DAL227,5p,13,C>A,238,211,449,3765325,3771231,7536556,5.9576283915358685e-05
DAL227,5p,14,C>A,217,252,469,3765297,3771226,7536523,6.22302884234547e-05
DAL227,5p,15,C>A,289,320,609,3765318,3771201,7536519,8.080653681096008e-05
DAL227,5p,16,C>A,235,283,518,3765316,3771188,7536504,6.873213362588277e-05
DAL227,5p,17,C>A,334,368,702,3765326,3771175,7536501,9.31466737681054e-05
DAL227,5p,18,C>A,382,339,721,3765280,3771169,7536449,9.566839767641231e-05
DAL227,5p,19,C>A,300,421,721,3765279,3771164,7536443,9.566847384104146e-05
DAL227,5p,20,C>A,350,469,819,3765254,3771167,7536421,0.0001086722729529
DAL227,5p,21,C>A,334,372,706,3765270,3771169,7536439,9.36781947017683e-05
DAL227,5p,22,C>A,470,306,776,3765253,3771158,7536411,0.000102966783526
DAL227,5p,23,C>A,444,344,788,3765254,3771157,7536411,0.0001045590533743
DAL227,5p,24,C>A,443,358,801,3765270,3771180,7536450,0.0001062834623728
DAL227,5p,25,C>A,448,344,792,3765247,3771148,7536395,0.0001050900330993
WA02,3p,1,C>A,43,30,73,6552698,6754258,13306956,5.485852662321872e-06
WA02,3p,2,C>A,63,93,156,6552698,6754258,13306956,1.1723191990715233e-05
WA02,3p,3,C>A,138,107,245,6552698,6754258,13306956,1.841142331875149e-05
WA02,3p,4,C>A,265,200,465,6552698,6754256,13306954,3.494413522433459e-05
WA02,3p,5,C>A,527,424,951,6552698,6754256,13306954,7.146639268460686e-05
WA02,3p,6,C>A,540,495,1035,6552698,6754257,13306955,7.777887578337795e-05
WA02,3p,7,C>A,504,609,1113,6552698,6754257,13306955,8.364047221922671e-05
WA02,3p,8,C>A,637,621,1258,6552692,6754207,13306899,9.453742754040592e-05
WA02,3p,9,C>A,715,610,1325,6552688,6754191,13306879,9.957255942584282e-05
WA02,3p,10,C>A,756,533,1289,6552680,6754207,13306887,9.686713353769369e-05
WA02,3p,11,C>A,661,587,1248,6552667,6754202,13306869,9.378614909337426e-05
WA02,3p,12,C>A,840,484,1324,6552670,6754189,13306859,9.94975598674338e-05
WA02,3p,13,C>A,726,560,1286,6552675,6754177,13306852,9.664194055814252e-05
WA02,3p,14,C>A,649,634,1283,6552653,6754155,13306808,9.6416811605007e-05
WA02,3p,15,C>A,749,611,1360,6552632,6754146,13306778,0.0001022035537077
WA02,3p,16,C>A,603,598,1201,6552629,6754119,13306748,9.025495936347484e-05
WA02,3p,17,C>A,794,722,1516,6552608,6754116,13306724,0.000113927364842
WA02,3p,18,C>A,781,932,1713,6552611,6754085,13306696,0.0001287321811515
WA02,3p,19,C>A,862,618,1480,6552605,6754056,13306661,0.000111222492254
WA02,3p,20,C>A,764,587,1351,6552618,6754033,13306651,0.0001015281756469
WA02,3p,21,C>A,822,638,1460,6552597,6754089,13306686,0.0001097192794659
WA02,3p,22,C>A,758,695,1453,6552593,6754062,13306655,0.0001091934825093
WA02,3p,23,C>A,846,630,1476,6552585,6754052,13306637,0.0001109220909836
WA02,3p,24,C>A,895,671,1566,6552556,6754026,13306582,0.0001176861195459
WA02,3p,25,C>A,819,718,1537,6552517,6754038,13306555,0.0001155069813336
WA02,5p,1,C>A,41,20,61,6552698,6754258,13306956,4.584068663036085e-06
WA02,5p,2,C>A,87,117,204,6552562,6754179,13306741,1.5330575683407378e-05
WA02,5p,3,C>A,95,50,145,6552698,6754258,13306956,1.0896556658036594e-05
WA02,5p,4,C>A,190,95,285,6552698,6754258,13306956,2.1417369983037444e-05
WA02,5p,5,C>A,724,391,1115,6552698,6754258,13306956,8.379076326697105e-05
WA02,5p,6,C>A,689,417,1106,6552697,6754258,13306955,8.311443151344541e-05
WA02,5p,7,C>A,501,270,771,6552685,6754258,13306943,5.793967855727645e-05
WA02,5p,8,C>A,776,419,1195,6552655,6754257,13306912,8.980295353272044e-05
WA02,5p,9,C>A,765,425,1190,6552662,6754226,13306888,8.942737024614621e-05
WA02,5p,10,C>A,1195,719,1914,6552618,6754222,13306840,0.000143835801738
WA02,5p,11,C>A,677,531,1208,6552625,6754225,13306850,9.078031239549556e-05
WA02,5p,12,C>A,740,537,1277,6552628,6754236,13306864,9.596551073190498e-05
WA02,5p,13,C>A,1083,495,1578,6552614,6754205,13306819,0.0001185858167906
WA02,5p,14,C>A,823,600,1423,6552607,6754183,13306790,0.0001069378865977
WA02,5p,15,C>A,838,575,1413,6552586,6754168,13306754,0.0001061866778329
WA02,5p,16,C>A,805,736,1541,6552525,6754178,13306703,0.0001158062970218
WA02,5p,17,C>A,795,675,1470,6552567,6754148,13306715,0.0001104705406255
WA02,5p,18,C>A,877,749,1626,6552548,6754087,13306635,0.0001221946795715
WA02,5p,19,C>A,802,675,1477,6552516,6754124,13306640,0.0001109972164272
WA02,5p,20,C>A,835,777,1612,6552507,6754132,13306639,0.0001211425364436
WA02,5p,21,C>A,716,614,1330,6552521,6754152,13306673,9.994985222827676e-05
WA02,5p,22,C>A,856,628,1484,6552516,6754117,13306633,0.0001115233282529
WA02,5p,23,C>A,762,556,1318,6552465,6754131,13306596,9.904862220210188e-05
WA02,5p,24,C>A,893,744,1637,6552457,6754135,13306592,0.0001230217323864
WA02,5p,25,C>A,772,627,1399,6552470,6754083,13306553,0.000105136168623
WA03,3p,1,C>A,87,48,135,5399458,5543742,10943200,1.2336428101469405e-05
WA03,3p,2,C>A,169,170,339,5399458,5543742,10943200,3.0978141677023175e-05
WA03,3p,3,C>A,236,187,423,5399458,5543742,10943200,3.865414138460414e-05
WA03,3p,4,C>A,431,207,638,5399458,5543736,10943194,5.830107736370204e-05
WA03,3p,5,C>A,1248,703,1951,5399458,5543740,10943198,0.000178284263887
WA03,3p,6,C>A,1140,777,1917,5399458,5543741,10943199,0.0001751772950487
WA03,3p,7,C>A,1331,934,2265,5399458,5543739,10943197,0.0002069779059994
WA03,3p,8,C>A,1698,1061,2759,5399449,5543673,10943122,0.0002521218350668
WA03,3p,9,C>A,1675,1125,2800,5399436,5543670,10943106,0.000255868854784
WA03,3p,10,C>A,1647,1285,2932,5399438,5543654,10943092,0.0002679315864291
WA03,3p,11,C>A,1623,1345,2968,5399404,5543644,10943048,0.000271222423588
WA03,3p,12,C>A,1639,1858,3497,5399397,5543595,10942992,0.0003195652523551
WA03,3p,13,C>A,1841,1105,2946,5399378,5543551,10942929,0.0002692149423614
WA03,3p,14,C>A,1658,1258,2916,5399356,5543493,10942849,0.0002664753941135
WA03,3p,15,C>A,1683,1347,3030,5399349,5543505,10942854,0.000276893029917
WA03,3p,16,C>A,1735,1329,3064,5399342,5543495,10942837,0.0002800005154056
WA03,3p,17,C>A,1537,1178,2715,5399346,5543438,10942784,0.000248108707985
WA03,3p,18,C>A,1669,1438,3107,5399325,5543443,10942768,0.0002839318168858
WA03,3p,19,C>A,1680,1451,3131,5399297,5543425,10942722,0.0002861262490265
WA03,3p,20,C>A,1621,1185,2806,5399252,5543409,10942661,0.0002564275727814
WA03,3p,21,C>A,1709,1683,3392,5399248,5543303,10942551,0.0003099825625669
WA03,3p,22,C>A,2269,1571,3840,5399256,5543263,10942519,0.0003509246819676
WA03,3p,23,C>A,1761,1212,2973,5399255,5543267,10942522,0.0002716923941299
WA03,3p,24,C>A,1824,1574,3398,5399198,5543130,10942328,0.0003105372092666
WA03,3p,25,C>A,1980,1195,3175,5399050,5543142,10942192,0.0002901612400879
WA03,5p,1,C>A,64,32,96,5399457,5543742,10943199,8.772571896024188e-06
WA03,5p,2,C>A,141,237,378,5399258,5543638,10942896,3.454295828087921e-05
WA03,5p,3,C>A,212,173,385,5399457,5543742,10943199,3.5181668541347005e-05
WA03,5p,4,C>A,404,299,703,5399458,5543742,10943200,6.424080707654068e-05
WA03,5p,5,C>A,1522,1625,3147,5399456,5543740,10943196,0.0002875759513034
WA03,5p,6,C>A,1865,1314,3179,5399452,5543742,10943194,0.0002905001958294
WA03,5p,7,C>A,990,1029,2019,5399453,5543742,10943195,0.0001844982201267
WA03,5p,8,C>A,1667,822,2489,5399403,5543732,10943135,0.0002274485328016
WA03,5p,9,C>A,1929,968,2897,5399319,5543732,10943051,0.0002647342135205
WA03,5p,10,C>A,2791,1598,4389,5399344,5543717,10943061,0.0004010760791701
WA03,5p,11,C>A,1718,1146,2864,5399321,5543705,10943026,0.0002617191990588
WA03,5p,12,C>A,1557,1269,2826,5399213,5543665,10942878,0.0002582501605153
WA03,5p,13,C>A,1861,1088,2949,5399156,5543662,10942818,0.0002694918255973
WA03,5p,14,C>A,1830,1276,3106,5399124,5543629,10942753,0.0002838408214093
WA03,5p,15,C>A,1910,1307,3217,5399092,5543505,10942597,0.0002939887121859
WA03,5p,16,C>A,1985,1212,3197,5399083,5543501,10942584,0.0002921613395885
WA03,5p,17,C>A,2084,1496,3580,5399113,5543491,10942604,0.0003271616152791
WA03,5p,18,C>A,2472,1495,3967,5399074,5543600,10942674,0.0003625256495807
WA03,5p,19,C>A,1865,1370,3235,5399071,5543546,10942617,0.0002956331195727
WA03,5p,20,C>A,2337,1385,3722,5399050,5543533,10942583,0.0003401390695414
WA03,5p,21,C>A,2108,1334,3442,5399034,5543509,10942543,0.0003145521109672
WA03,5p,22,C>A,2210,1290,3500,5398989,5543454,10942443,0.0003198554472707
WA03,5p,23,C>A,1948,1481,3429,5398935,5543457,10942392,0.0003133684115867
WA03,5p,24,C>A,1849,1407,3256,5398952,5543428,10942380,0.0002975586663961
WA03,5p,25,C>A,2162,1368,3530,5398991,5543444,10942435,0.0003225973012405
WA07,3p,1,C>A,51,17,68,5691729,6013979,11705708,5.809131750082951e-06
WA07,3p,2,C>A,56,42,98,5691729,6013979,11705708,8.371983992766606e-06
WA07,3p,3,C>A,179,115,294,5691729,6013979,11705708,2.511595197829982e-05
WA07,3p,4,C>A,286,93,379,5691729,6013979,11705708,3.23773666659035e-05
WA07,3p,5,C>A,534,422,956,5691729,6013979,11705708,8.166955813351913e-05
WA07,3p,6,C>A,456,374,830,5691729,6013979,11705708,7.090557871424779e-05
WA07,3p,7,C>A,490,386,876,5691729,6013979,11705708,7.483528548636272e-05
WA07,3p,8,C>A,636,464,1100,5691713,6013800,11705513,9.39728143482477e-05
WA07,3p,9,C>A,560,522,1082,5691720,6013901,11705621,9.243422454904356e-05
WA07,3p,10,C>A,732,536,1268,5691718,6013892,11705610,0.0001083241283452
WA07,3p,11,C>A,509,515,1024,5691711,6013883,11705594,8.747954183273399e-05
WA07,3p,12,C>A,645,557,1202,5691705,6013884,11705589,0.0001026859904273
WA07,3p,13,C>A,587,667,1254,5691711,6013848,11705559,0.000107128587366
WA07,3p,14,C>A,772,808,1580,5691695,6013877,11705572,0.0001349784529965
WA07,3p,15,C>A,774,793,1567,5691211,6013856,11705067,0.0001338736463447
WA07,3p,16,C>A,663,685,1348,5691636,6013850,11705486,0.0001151596781201
WA07,3p,17,C>A,644,486,1130,5691662,6013813,11705475,9.653602267315082e-05
WA07,3p,18,C>A,629,525,1154,5691639,6013769,11705408,9.85869095720542e-05
WA07,3p,19,C>A,687,559,1246,5691628,6013742,11705370,0.0001064468701117
WA07,3p,20,C>A,845,656,1501,5691604,6013772,11705376,0.0001282316774787
WA07,3p,21,C>A,980,553,1533,5691611,6013735,11705346,0.0001309657997294
WA07,3p,22,C>A,1032,561,1593,5691577,6013736,11705313,0.0001360920464066
WA07,3p,23,C>A,703,664,1367,5691568,6013670,11705238,0.0001167853229468
WA07,3p,24,C>A,787,541,1328,5691554,6013661,11705215,0.0001134537041822
WA07,3p,25,C>A,718,482,1200,5691455,6013662,11705117,0.0001025192657194
WA07,5p,1,C>A,27,8,35,5691729,6013979,11705708,2.989994283130931e-06
WA07,5p,2,C>A,101,72,173,5691636,6013923,11705559,1.477930272274908e-05
WA07,5p,3,C>A,80,70,150,5691729,6013979,11705708,1.2814261213418274e-05
WA07,5p,4,C>A,206,244,450,5691728,6013979,11705707,3.844278692436092e-05
WA07,5p,5,C>A,560,622,1182,5691729,6013978,11705707,0.0001009763869879
WA07,5p,6,C>A,563,480,1043,5691728,6013979,11705707,8.910183724912985e-05
WA07,5p,7,C>A,423,491,914,5691728,6013979,11705707,7.808157166414639e-05
WA07,5p,8,C>A,537,441,978,5691579,6013975,11705554,8.355008229426817e-05
WA07,5p,9,C>A,565,369,934,5691672,6013971,11705643,7.979057622037508e-05
WA07,5p,10,C>A,773,567,1340,5691582,6013961,11705543,0.0001144756804532
WA07,5p,11,C>A,488,474,962,5691326,6013942,11705268,8.218521780107897e-05
WA07,5p,12,C>A,572,389,961,5691520,6013938,11705458,8.209845355901494e-05
WA07,5p,13,C>A,737,470,1207,5691511,6013949,11705460,0.0001031142731682
WA07,5p,14,C>A,586,416,1002,5691556,6013950,11705506,8.560074207812973e-05
WA07,5p,15,C>A,721,584,1305,5691563,6013633,11705196,0.0001114889490103
WA07,5p,16,C>A,604,831,1435,5691534,6013925,11705459,0.0001225923733533
WA07,5p,17,C>A,553,589,1142,5691561,6013916,11705477,9.75611673065523e-05
WA07,5p,18,C>A,692,805,1497,5691474,6013905,11705379,0.0001278899213771
WA07,5p,19,C>A,561,649,1210,5691482,6013884,11705366,0.0001033713939401
WA07,5p,20,C>A,647,591,1238,5691421,6013876,11705297,0.0001057640827054
WA07,5p,21,C>A,598,589,1187,5691379,6013853,11705232,0.0001014076440347
WA07,5p,22,C>A,595,515,1110,5691396,6013861,11705257,9.482918657830409e-05
WA07,5p,23,C>A,651,471,1122,5691314,6013795,11705109,9.585557896128948e-05
WA07,5p,24,C>A,641,847,1488,5691332,6013785,11705117,0.000127123889492
WA07,5p,25,C>A,881,558,1439,5691334,6013719,11705053,0.0001229383583312
WA08,3p,1,C>A,46,37,83,6798117,7189085,13987202,5.93399594858214e-06
WA08,3p,2,C>A,31,118,149,6798117,7189085,13987202,1.065259513661131e-05
WA08,3p,3,C>A,165,69,234,6798117,7189085,13987202,1.6729578939376154e-05
WA08,3p,4,C>A,263,107,370,6798117,7189081,13987198,2.6452760588646847e-05
WA08,3p,5,C>A,546,407,953,6798117,7189085,13987202,6.813371251805758e-05
WA08,3p,6,C>A,514,411,925,6798117,7189085,13987202,6.613188255949975e-05
WA08,3p,7,C>A,600,531,1131,6798117,7189084,13987201,8.085963732129108e-05
WA08,3p,8,C>A,619,533,1152,6798110,7189053,13987163,8.236123365402977e-05
WA08,3p,9,C>A,766,762,1528,6798103,7189051,13987154,0.000109243095486
WA08,3p,10,C>A,844,611,1455,6798074,7189042,13987116,0.000104024303509
WA08,3p,11,C>A,873,517,1390,6798109,7189046,13987155,9.937689258466072e-05
WA08,3p,12,C>A,783,562,1345,6798091,7189018,13987109,9.615997129928708e-05
WA08,3p,13,C>A,821,651,1472,6798090,7189013,13987103,0.0001052398055551
WA08,3p,14,C>A,665,728,1393,6798067,7188981,13987048,9.959213695413073e-05
WA08,3p,15,C>A,753,633,1386,6798069,7188978,13987047,9.909168103889264e-05
WA08,3p,16,C>A,748,616,1364,6798049,7188961,13987010,9.751905518048532e-05
WA08,3p,17,C>A,831,768,1599,6798000,7188943,13986943,0.0001143209062909
WA08,3p,18,C>A,744,709,1453,6798023,7188956,13986979,0.0001038823322748
WA08,3p,19,C>A,703,624,1327,6798028,7188946,13986974,9.487398775460654e-05
WA08,3p,20,C>A,822,690,1512,6798009,7188917,13986926,0.000108100950845
WA08,3p,21,C>A,948,615,1563,6798010,7188926,13986936,0.0001117471331819
WA08,3p,22,C>A,897,731,1628,6798012,7188920,13986932,0.0001163943601069
WA08,3p,23,C>A,860,687,1547,6798009,7188864,13986873,0.0001106037067756
WA08,3p,24,C>A,816,687,1503,6798015,7188867,13986882,0.0001074578308446
WA08,3p,25,C>A,852,909,1761,6797966,7188892,13986858,0.0001259039020772
WA08,5p,1,C>A,27,31,58,6798116,7189085,13987201,4.146648067758517e-06
WA08,5p,2,C>A,86,59,145,6797941,7188997,13986938,1.0366815095627075e-05
WA08,5p,3,C>A,95,83,178,6798117,7189084,13987201,1.2725919932086483e-05
WA08,5p,4,C>A,211,165,376,6798115,7189085,13987200,2.6881720430107527e-05
WA08,5p,5,C>A,831,341,1172,6798116,7189084,13987200,8.379089453214368e-05
WA08,5p,6,C>A,913,420,1333,6798112,7189085,13987197,9.53014388801416e-05
WA08,5p,7,C>A,487,341,828,6798110,7189085,13987195,5.919700125722134e-05
WA08,5p,8,C>A,741,517,1258,6798069,7189064,13987133,8.993980396125496e-05
WA08,5p,9,C>A,895,476,1371,6798054,7189067,13987121,9.801874166956876e-05
WA08,5p,10,C>A,1461,829,2290,6798015,7189037,13987052,0.0001637228488176
WA08,5p,11,C>A,879,583,1462,6797997,7189047,13987044,0.0001045253021295
WA08,5p,12,C>A,763,508,1271,6798016,7189056,13987072,9.086962589454032e-05
WA08,5p,13,C>A,846,602,1448,6797995,7189043,13987038,0.0001035244202525
WA08,5p,14,C>A,794,572,1366,6797984,7189041,13987025,9.766194026249328e-05
WA08,5p,15,C>A,990,664,1654,6797997,7189013,13987010,0.0001182525786426
WA08,5p,16,C>A,882,841,1723,6797921,7188997,13986918,0.0001231865375917
WA08,5p,17,C>A,831,687,1518,6797959,7188875,13986834,0.0001085306367402
WA08,5p,18,C>A,1031,707,1738,6797991,7188972,13986963,0.0001242585684969
WA08,5p,19,C>A,960,691,1651,6797966,7188988,13986954,0.0001180385665099
WA08,5p,20,C>A,961,728,1689,6797883,7188971,13986854,0.000120756247259
WA08,5p,21,C>A,1260,569,1829,6797885,7188979,13986864,0.0001307655525927
WA08,5p,22,C>A,1068,504,1572,6797887,7188939,13986826,0.0001123914746633
WA08,5p,23,C>A,924,552,1476,6797851,7188919,13986770,0.0001055282956679
WA08,5p,24,C>A,998,575,1573,6797841,7188876,13986717,0.0001124638469485
WA08,5p,25,C>A,830,608,1438,6797835,7188817,13986652,0.000102812309908
WA09,3p,1,C>A,61,41,102,4741672,4881751,9623423,1.059913920441822e-05
WA09,3p,2,C>A,69,106,175,4741672,4881751,9623423,1.8184797654639104e-05
WA09,3p,3,C>A,166,158,324,4741672,4881751,9623423,3.366785394344611e-05
WA09,3p,4,C>A,228,198,426,4741672,4881748,9623420,4.4267006947634e-05
WA09,3p,5,C>A,1075,1022,2097,4741672,4881751,9623423,0.0002179058324673
WA09,3p,6,C>A,939,1087,2026,4741672,4881751,9623423,0.0002105280002759
WA09,3p,7,C>A,1062,967,2029,4741672,4881748,9623420,0.0002108398053914
WA09,3p,8,C>A,1233,1338,2571,4741663,4881718,9623381,0.000267161821817
WA09,3p,9,C>A,1243,1352,2595,4741664,4881723,9623387,0.0002696555796831
WA09,3p,10,C>A,1452,1623,3075,4741658,4881705,9623363,0.0003195348653064
WA09,3p,11,C>A,1363,1212,2575,4741648,4881712,9623360,0.0002675780600538
WA09,3p,12,C>A,1234,1380,2614,4741642,4881680,9623322,0.0002716317712324
WA09,3p,13,C>A,1407,1284,2691,4741628,4881645,9623273,0.0002796345900194
WA09,3p,14,C>A,1304,1340,2644,4741616,4881571,9623187,0.0002747530521853
WA09,3p,15,C>A,1254,1391,2645,4741598,4881557,9623155,0.0002748578818485
WA09,3p,16,C>A,1331,1368,2699,4741586,4881546,9623132,0.0002804700174537
WA09,3p,17,C>A,1387,1251,2638,4741582,4881528,9623110,0.0002741317515855
WA09,3p,18,C>A,1365,1466,2831,4741560,4881490,9623050,0.0002941894721527
WA09,3p,19,C>A,1283,1388,2671,4741552,4881442,9622994,0.000277564342241
WA09,3p,20,C>A,1279,1255,2534,4741534,4881501,9623035,0.0002633264869139
WA09,3p,21,C>A,1419,1721,3140,4741546,4881493,9623039,0.0003263002467307
WA09,3p,22,C>A,1449,1587,3036,4741524,4881498,9623022,0.0003154934073724
WA09,3p,23,C>A,1504,1512,3016,4741501,4881486,9622987,0.0003134161981097
WA09,3p,24,C>A,1474,1830,3304,4741491,4881450,9622941,0.0003433461766002
WA09,3p,25,C>A,1441,1448,2889,4741451,4881469,9622920,0.0003002207230237
WA09,5p,1,C>A,60,23,83,4741672,4881751,9623423,8.624789744771689e-06
WA09,5p,2,C>A,82,79,161,4741495,4881667,9623162,1.6730467594746923e-05
WA09,5p,3,C>A,122,95,217,4741672,4881750,9623422,2.254915143490538e-05
WA09,5p,4,C>A,253,253,506,4741672,4881751,9623423,5.258004350427078e-05
WA09,5p,5,C>A,1331,888,2219,4741671,4881751,9623422,0.0002305832582214
WA09,5p,6,C>A,1500,1158,2658,4741669,4881751,9623420,0.0002762011841943
WA09,5p,7,C>A,874,812,1686,4741667,4881751,9623418,0.0001751976272879
WA09,5p,8,C>A,1169,939,2108,4741639,4881744,9623383,0.0002190497873772
WA09,5p,9,C>A,1390,1509,2899,4741618,4881747,9623365,0.0003012459778881
WA09,5p,10,C>A,2043,1594,3637,4741622,4881737,9623359,0.0003779345652593
WA09,5p,11,C>A,1449,1291,2740,4741614,4881733,9623347,0.0002847242232873
WA09,5p,12,C>A,1616,1382,2998,4741580,4881734,9623314,0.0003115350907182
WA09,5p,13,C>A,1600,1355,2955,4741530,4881708,9623238,0.0003070692006162
WA09,5p,14,C>A,1752,1308,3060,4741498,4881705,9623203,0.0003179814454709
WA09,5p,15,C>A,1734,1235,2969,4741496,4881672,9623168,0.0003085262566339
WA09,5p,16,C>A,1588,1318,2906,4741451,4881636,9623087,0.0003019820978444
WA09,5p,17,C>A,1592,1477,3069,4741476,4881638,9623114,0.0003189196345382
WA09,5p,18,C>A,1809,1949,3758,4741455,4881610,9623065,0.0003905200681903
WA09,5p,19,C>A,1755,1674,3429,4741379,4881580,9622959,0.0003563353018546
WA09,5p,20,C>A,1748,1516,3264,4741390,4881557,9622947,0.0003391892317395
WA09,5p,21,C>A,1667,1517,3184,4741379,4881587,9622966,0.0003308751168818
WA09,5p,22,C>A,1737,1361,3098,4741354,4881580,9622934,0.0003219392339176
WA09,5p,23,C>A,1658,1404,3062,4741312,4881565,9622877,0.0003182000559707
WA09,5p,24,C>A,2161,1399,3560,4741363,4881548,9622911,0.0003699504235256
WA09,5p,25,C>A,1497,1523,3020,4741301,4881503,9622804,0.000313837837703
WA11,3p,1,C>A,86,61,147,9756642,10108269,19864911,7.399982813917465e-06
WA11,3p,2,C>A,96,118,214,9756642,10108269,19864911,1.0772764096451275e-05
WA11,3p,3,C>A,247,157,404,9756642,10108269,19864911,2.033736773348745e-05
WA11,3p,4,C>A,433,250,683,9756642,10108267,19864909,3.438223653579284e-05
WA11,3p,5,C>A,1361,1208,2569,9756642,10108269,19864911,0.0001293235091765
WA11,3p,6,C>A,1168,1235,2403,9756642,10108269,19864911,0.0001209670659989
WA11,3p,7,C>A,1345,1044,2389,9756642,10108265,19864907,0.0001202623299469
WA11,3p,8,C>A,1329,1369,2698,9756629,10108160,19864789,0.000135818205771
WA11,3p,9,C>A,1455,3150,4605,9756610,10108092,19864702,0.0002318182271246
WA11,3p,10,C>A,1554,1320,2874,9756615,10107969,19864584,0.0001446795966127
WA11,3p,11,C>A,1410,1241,2651,9756587,10107918,19864505,0.0001334541182878
WA11,3p,12,C>A,1612,1981,3593,9756581,10108019,19864600,0.0001808745205038
WA11,3p,13,C>A,1478,1661,3139,9756565,10107963,19864528,0.0001580203667562
WA11,3p,14,C>A,1468,1449,2917,9756515,10107914,19864429,0.0001468453988785
WA11,3p,15,C>A,1723,1163,2886,9756471,10107972,19864443,0.000145284718026
WA11,3p,16,C>A,1649,1485,3134,9756477,10108011,19864488,0.0001577689794974
WA11,3p,17,C>A,1566,1458,3024,9756469,10108044,19864513,0.0001522312678896
WA11,3p,18,C>A,1766,1364,3130,9756421,10108016,19864437,0.0001575680196725
WA11,3p,19,C>A,1646,1520,3166,9756438,10108000,19864438,0.0001593802955814
WA11,3p,20,C>A,1851,1337,3188,9756433,10107963,19864396,0.0001604881416983
WA11,3p,21,C>A,1732,1388,3120,9756421,10107904,19864325,0.0001570654930383
WA11,3p,22,C>A,1592,1609,3201,9756405,10107842,19864247,0.0001611437876301
WA11,3p,23,C>A,1852,1474,3326,9756375,10107816,19864191,0.0001674369723891
WA11,3p,24,C>A,1863,2081,3944,9756358,10107704,19864062,0.0001985495212409
WA11,3p,25,C>A,2382,1642,4024,9756281,10107693,19863974,0.000202577792339
WA11,5p,1,C>A,50,18,68,9756641,10108269,19864910,3.4231214739961067e-06
WA11,5p,2,C>A,119,221,340,9756471,10108196,19864667,1.7115816741352875e-05
WA11,5p,3,C>A,169,110,279,9756642,10108269,19864911,1.4044865340700496e-05
WA11,5p,4,C>A,423,289,712,9756638,10108269,19864907,3.5842100846482695e-05
WA11,5p,5,C>A,1791,1390,3181,9756638,10108267,19864905,0.0001601316492578
WA11,5p,6,C>A,1917,1225,3142,9756642,10108269,19864911,0.000158168340145
WA11,5p,7,C>A,1222,1233,2455,9756629,10108269,19864898,0.0001235848278707
WA11,5p,8,C>A,1921,1167,3088,9756500,10108261,19864761,0.0001554511529235
WA11,5p,9,C>A,2065,1229,3294,9756493,10108240,19864733,0.0001658215089022
WA11,5p,10,C>A,2512,1768,4280,9756446,10108197,19864643,0.0002154581887024
WA11,5p,11,C>A,2127,4698,6825,9756457,10108195,19864652,0.0003435751102007
WA11,5p,12,C>A,2346,1297,3643,9756411,10108221,19864632,0.000183391265441
WA11,5p,13,C>A,2270,1314,3584,9756334,10108178,19864512,0.0001804222525073
WA11,5p,14,C>A,2506,1360,3866,9756261,10108167,19864428,0.000194619246021
WA11,5p,15,C>A,3177,1385,4562,9756237,10108096,19864333,0.0002296578495739
WA11,5p,16,C>A,2156,1396,3552,9756275,10108079,19864354,0.0001788127617943
WA11,5p,17,C>A,2343,1491,3834,9756369,10108078,19864447,0.0001930081416311
WA11,5p,18,C>A,2506,1427,3933,9756327,10108075,19864402,0.0001979923684589
WA11,5p,19,C>A,2590,1290,3880,9756284,10108088,19864372,0.0001953245740665
WA11,5p,20,C>A,2321,1447,3768,9756292,10108082,19864374,0.0001896863198407
WA11,5p,21,C>A,2583,1428,4011,9756251,10108036,19864287,0.0002019201595305
WA11,5p,22,C>A,2473,1147,3620,9756136,10108029,19864165,0.0001822377129871
WA11,5p,23,C>A,2228,1098,3326,9756095,10108016,19864111,0.0001674376467187
WA11,5p,24,C>A,2461,1388,3849,9756046,10108010,19864056,0.0001937670735523
WA11,5p,25,C>A,2114,1261,3375,9756056,10107943,19863999,0.0001699053649771
WA12,3p,1,C>A,82,42,124,6632243,6940679,13572922,9.135836778550706e-06
WA12,3p,2,C>A,54,73,127,6632243,6940679,13572922,9.35686508770919e-06
WA12,3p,3,C>A,169,91,260,6632243,6940679,13572922,1.915578679373535e-05
WA12,3p,4,C>A,294,145,439,6632243,6940676,13572919,3.234381638909066e-05
WA12,3p,5,C>A,927,819,1746,6632243,6940678,13572921,0.0001286384854078
WA12,3p,6,C>A,958,918,1876,6632243,6940679,13572922,0.0001382163693271
WA12,3p,7,C>A,1040,817,1857,6632243,6940676,13572919,0.0001368165536094
WA12,3p,8,C>A,1066,811,1877,6632240,6940664,13572904,0.0001382902288264
WA12,3p,9,C>A,1154,1098,2252,6632231,6940656,13572887,0.0001659190119242
WA12,3p,10,C>A,1317,885,2202,6632228,6940644,13572872,0.0001622353765658
WA12,3p,11,C>A,1141,958,2099,6632231,6940642,13572873,0.0001546466986024
WA12,3p,12,C>A,1242,1384,2626,6632223,6940615,13572838,0.0001934746439911
WA12,3p,13,C>A,1178,1063,2241,6632204,6940591,13572795,0.0001651096918504
WA12,3p,14,C>A,1202,1008,2210,6632209,6940533,13572742,0.0001628263471006
WA12,3p,15,C>A,1172,1414,2586,6632188,6940474,13572662,0.0001905300522476
WA12,3p,16,C>A,1201,1084,2285,6632187,6940478,13572665,0.0001683530832006
WA12,3p,17,C>A,1093,1082,2175,6632168,6940473,13572641,0.0001602488417692
WA12,3p,18,C>A,1107,1031,2138,6632160,6940482,13572642,0.0001575227579125
WA12,3p,19,C>A,1216,1220,2436,6632121,6940435,13572556,0.0001794798267916
WA12,3p,20,C>A,1202,1093,2295,6632105,6940432,13572537,0.0001690914528359
WA12,3p,21,C>A,1322,1283,2605,6632096,6940454,13572550,0.0001919315088174
WA12,3p,22,C>A,1166,1481,2647,6632039,6940438,13572477,0.0001950270389111
WA12,3p,23,C>A,1191,1273,2464,6631950,6940459,13572409,0.0001815447795597
WA12,3p,24,C>A,1261,1765,3026,6631933,6940411,13572344,0.0002229533822602
WA12,3p,25,C>A,1231,1201,2432,6631986,6940428,13572414,0.0001791869891384
WA12,5p,1,C>A,80,27,107,6632243,6940679,13572922,7.883343026652626e-06
WA12,5p,2,C>A,102,72,174,6631949,6940524,13572473,1.2820066026287178e-05
WA12,5p,3,C>A,163,50,213,6632242,6940678,13572920,1.5693012262652398e-05
WA12,5p,4,C>A,280,162,442,6632242,6940679,13572921,3.25648399486006e-05
WA12,5p,5,C>A,1139,857,1996,6632242,6940677,13572919,0.0001470575341973
WA12,5p,6,C>A,1281,808,2089,6632242,6940679,13572921,0.0001539093906168
WA12,5p,7,C>A,765,1087,1852,6632238,6940679,13572917,0.0001364481931186
WA12,5p,8,C>A,1207,816,2023,6632204,6940670,13572874,0.0001490472835745
WA12,5p,9,C>A,1450,999,2449,6632209,6940675,13572884,0.0001804332815339
WA12,5p,10,C>A,1729,1551,3280,6632199,6940665,13572864,0.0002416586506724
WA12,5p,11,C>A,1196,897,2093,6632166,6940667,13572833,0.000154205094839
WA12,5p,12,C>A,1167,969,2136,6632126,6940660,13572786,0.0001573737329977
WA12,5p,13,C>A,1273,994,2267,6632065,6940658,13572723,0.0001670261744824
WA12,5p,14,C>A,1159,1046,2205,6632026,6940638,13572664,0.0001624588953207
WA12,5p,15,C>A,1280,1139,2419,6631987,6940631,13572618,0.0001782264851187
WA12,5p,16,C>A,1250,1265,2515,6631930,6940590,13572520,0.0001853008873812
WA12,5p,17,C>A,1174,993,2167,6631958,6940621,13572579,0.0001596601500716
WA12,5p,18,C>A,1288,1490,2778,6632019,6940577,13572596,0.0002046771302999
WA12,5p,19,C>A,1282,1384,2666,6631996,6940532,13572528,0.0001964261926739
WA12,5p,20,C>A,1207,1259,2466,6631973,6940532,13572505,0.0001816908522045
WA12,5p,21,C>A,1513,1069,2582,6631936,6940534,13572470,0.000190238033313
WA12,5p,22,C>A,1417,1158,2575,6631921,6940529,13572450,0.000189722562986
WA12,5p,23,C>A,1361,1115,2476,6631926,6940534,13572460,0.0001824282407168
WA12,5p,24,C>A,1556,870,2426,6631934,6940518,13572452,0.0001787444155263
WA12,5p,25,C>A,1407,975,2382,6631933,6940515,13572448,0.0001755026064568
WA13,3p,1,C>A,20,13,33,5896847,6081528,11978375,2.754964675926409e-06
WA13,3p,2,C>A,27,16,43,5896847,6081528,11978375,3.5898024565101696e-06
WA13,3p,3,C>A,59,40,99,5896847,6081528,11978375,8.264894027779228e-06
WA13,3p,4,C>A,125,37,162,5896847,6081522,11978369,1.3524378819854356e-05
WA13,3p,5,C>A,167,110,277,5896847,6081527,11978374,2.3125008452733237e-05
WA13,3p,6,C>A,343,194,537,5896847,6081528,11978375,4.483078881734793e-05
WA13,3p,7,C>A,226,81,307,5896847,6081528,11978375,2.562951986392144e-05
WA13,3p,8,C>A,199,144,343,5896845,6081521,11978366,2.8634957389012826e-05
WA13,3p,9,C>A,202,169,371,5896842,6081517,11978359,3.097252303090933e-05
WA13,3p,10,C>A,205,162,367,5896843,6081517,11978360,3.063858491479635e-05
WA13,3p,11,C>A,144,90,234,5896841,6081492,11978333,1.9535272562551063e-05
WA13,3p,12,C>A,137,63,200,5896836,6081505,11978341,1.6696803004689883e-05
WA13,3p,13,C>A,186,79,265,5896834,6081495,11978329,2.2123286144503127e-05
WA13,3p,14,C>A,202,117,319,5896832,6081501,11978333,2.663141857886235e-05
WA13,3p,15,C>A,183,144,327,5896825,6081505,11978330,2.729929798227299e-05
WA13,3p,16,C>A,137,91,228,5896830,6081509,11978339,1.9034358603475823e-05
WA13,3p,17,C>A,214,142,356,5896823,6081499,11978322,2.9720356490667058e-05
WA13,3p,18,C>A,208,138,346,5896827,6081499,11978326,2.888550537028296e-05
WA13,3p,19,C>A,165,172,337,5896822,6081480,11978302,2.813420466440068e-05
WA13,3p,20,C>A,227,166,393,5896818,6081448,11978266,3.280942333389491e-05
WA13,3p,21,C>A,205,122,327,5896824,6081466,11978290,2.7299389144861246e-05
WA13,3p,22,C>A,209,206,415,5896824,6081460,11978284,3.464603110094902e-05
WA13,3p,23,C>A,157,184,341,5896819,6081454,11978273,2.8468210734552468e-05
WA13,3p,24,C>A,157,181,338,5896803,6081440,11978243,2.8217827940207927e-05
WA13,3p,25,C>A,171,203,374,5896783,6081437,11978220,3.122333702336407e-05
WA13,5p,1,C>A,28,3,31,5896847,6081528,11978375,2.587997119809657e-06
WA13,5p,2,C>A,57,109,166,5896725,6081443,11978168,1.3858546649203785e-05
WA13,5p,3,C>A,49,26,75,5896847,6081528,11978375,6.261283354378202e-06
WA13,5p,4,C>A,81,8622,8703,5896841,6081528,11978369,0.0007265596843777
WA13,5p,5,C>A,166,8746,8912,5896841,6081528,11978369,0.0007440078027317
WA13,5p,6,C>A,208,171,379,5896841,6081528,11978369,3.164036773286914e-05
WA13,5p,7,C>A,149,139,288,5896845,6081528,11978373,2.4043332095268697e-05
WA13,5p,8,C>A,207,102,309,5896843,6081526,11978369,2.579650034157405e-05
WA13,5p,9,C>A,212,89,301,5896837,6081518,11978355,2.5128659152279255e-05
WA13,5p,10,C>A,344,164,508,5896833,6081518,11978351,4.240984422647157e-05
WA13,5p,11,C>A,194,110,304,5896827,6081513,11978340,2.537914268588135e-05
WA13,5p,12,C>A,241,85,326,5896822,6081502,11978324,2.721582752311592e-05
WA13,5p,13,C>A,161,88,249,5896809,6081508,11978317,2.0787561391137003e-05
WA13,5p,14,C>A,179,113,292,5896802,6081520,11978322,2.4377371054142643e-05
WA13,5p,15,C>A,293,131,424,5896798,6081508,11978306,3.5397325798823304e-05
WA13,5p,16,C>A,263,181,444,5896754,6081491,11978245,3.706719974420293e-05
WA13,5p,17,C>A,279,97,376,5896805,6081514,11978319,3.139004730129495e-05
WA13,5p,18,C>A,310,175,485,5896796,6081504,11978300,4.048988587696084e-05
WA13,5p,19,C>A,283,192,475,5896797,6081472,11978269,3.965514549723337e-05
WA13,5p,20,C>A,158,228,386,5896788,6081482,11978270,3.222502080851408e-05
WA13,5p,21,C>A,186,183,369,5896782,6081484,11978266,3.0805794428008194e-05
WA13,5p,22,C>A,221,336,557,5896771,6081483,11978254,4.650093410942864e-05
WA13,5p,23,C>A,214,145,359,5896768,6081501,11978269,2.9970941544224794e-05
WA13,5p,24,C>A,254,202,456,5896781,6081498,11978279,3.806890789570021e-05
WA13,5p,25,C>A,175,241,416,5896769,6081462,11978231,3.4729669180699554e-05
WA14,3p,1,C>A,84,22,106,6684341,7140972,13825313,7.66709585526201e-06
WA14,3p,2,C>A,132,121,253,6684341,7140972,13825313,1.829976652246499e-05
WA14,3p,3,C>A,213,121,334,6684341,7140972,13825313,2.415858505337275e-05
WA14,3p,4,C>A,431,198,629,6684341,7140971,13825312,4.549626077154714e-05
WA14,3p,5,C>A,973,1093,2066,6684341,7140970,13825311,0.0001494360597023
WA14,3p,6,C>A,1002,911,1913,6684341,7140971,13825312,0.0001383693908679
WA14,3p,7,C>A,1285,895,2180,6684341,7140969,13825310,0.0001576818168995
WA14,3p,8,C>A,1100,815,1915,6684326,7140932,13825258,0.0001385145940856
WA14,3p,9,C>A,1287,818,2105,6684323,7140920,13825243,0.0001522577216183
WA14,3p,10,C>A,1613,911,2524,6684256,7140912,13825168,0.0001825655934162
WA14,3p,11,C>A,1219,855,2074,6684256,7140894,13825150,0.0001500164555176
WA14,3p,12,C>A,1238,1213,2451,6684291,7140849,13825140,0.0001772857273054
WA14,3p,13,C>A,2561,1075,3636,6684289,7140794,13825083,0.0002630002293657
WA14,3p,14,C>A,1231,1197,2428,6684291,7140742,13825033,0.0001756234505914
WA14,3p,15,C>A,1373,1539,2912,6684271,7140702,13824973,0.0002106333227558
WA14,3p,16,C>A,1295,1071,2366,6684263,7140648,13824911,0.0001711403422416
WA14,3p,17,C>A,1396,1070,2466,6684212,7140653,13824865,0.0001783742553724
WA14,3p,18,C>A,1585,1435,3020,6684177,7140647,13824824,0.0002184476272536
WA14,3p,19,C>A,1734,1086,2820,6684172,7140542,13824714,0.00020398252
WA14,3p,20,C>A,1722,2085,3807,6684176,7140544,13824720,0.0002753762824852
WA14,3p,21,C>A,2049,1334,3383,6684132,7140443,13824575,0.0002447091501908
WA14,3p,22,C>A,1440,1143,2583,6684105,7140560,13824665,0.0001868399704441
WA14,3p,23,C>A,1653,1451,3104,6683638,7140562,13824200,0.0002245337885736
WA14,3p,24,C>A,1637,1068,2705,6683623,7140532,13824155,0.0001956719958652
WA14,3p,25,C>A,2068,1274,3342,6683613,7140513,13824126,0.0002417512687601
WA14,5p,1,C>A,31,9,40,6684341,7140972,13825313,2.8932437189667967e-06
WA14,5p,2,C>A,149,92,241,6684184,7140911,13825095,1.7432068278735156e-05
WA14,5p,3,C>A,94,98,192,6684338,7140972,13825310,1.3887572864550596e-05
WA14,5p,4,C>A,256,193,449,6684341,7140972,13825313,3.247666074540229e-05
WA14,5p,5,C>A,1164,613,1777,6684341,7140972,13825313,0.000128532352215
WA14,5p,6,C>A,1127,849,1976,6684340,7140972,13825312,0.0001429262500549
WA14,5p,7,C>A,829,570,1399,6684336,7140972,13825308,0.0001011912356672
WA14,5p,8,C>A,1186,808,1994,6684277,7140970,13825247,0.0001442288879178
WA14,5p,9,C>A,1142,986,2128,6684241,7140959,13825200,0.0001539218239157
WA14,5p,10,C>A,1797,2016,3813,6684210,7140628,13824838,0.0002758079335179
WA14,5p,11,C>A,1185,1201,2386,6684218,7140646,13824864,0.000172587592905
WA14,5p,12,C>A,1067,1261,2328,6684139,7140917,13825056,0.0001683899146592
WA14,5p,13,C>A,1155,942,2097,6684018,7140931,13824949,0.0001516822955368
WA14,5p,14,C>A,1326,1144,2470,6683951,7140942,13824893,0.0001786632272669
WA14,5p,15,C>A,1606,1043,2649,6684030,7140908,13824938,0.0001916102625559
WA14,5p,16,C>A,1265,1085,2350,6683910,7140868,13824778,0.000169984646408
WA14,5p,17,C>A,1429,783,2212,6683904,7140873,13824777,0.0001600025808734
WA14,5p,18,C>A,1396,1216,2612,6683891,7140646,13824537,0.0001889394198156
WA14,5p,19,C>A,1266,973,2239,6683958,7140595,13824553,0.0001619582202766
WA14,5p,20,C>A,1205,1158,2363,6683860,7140558,13824418,0.0001709294380421
WA14,5p,21,C>A,1380,1248,2628,6683480,7140494,13823974,0.0001901045242127
WA14,5p,22,C>A,1391,1607,2998,6683768,7140398,13824166,0.0002168666088066
WA14,5p,23,C>A,1482,1391,2873,6683762,7140257,13824019,0.0002078266819511
WA14,5p,24,C>A,2019,1173,3192,6683714,7140421,13824135,0.0002309005228898
WA14,5p,25,C>A,1352,1250,2602,6683731,7140511,13824242,0.0001882200846889
WA18,3p,1,C>A,110,72,182,14112928,14131239,28244167,6.443808379974528e-06
WA18,3p,2,C>A,293,408,701,14112928,14131239,28244167,2.4819283925066723e-05
WA18,3p,3,C>A,528,329,857,14112928,14131239,28244167,3.0342548250759172e-05
WA18,3p,4,C>A,1078,389,1467,14112928,14131238,28244166,5.1939929824799925e-05
WA18,3p,5,C>A,1782,1424,3206,14112928,14131239,28244167,0.000113510163001
WA18,3p,6,C>A,1806,1729,3535,14112928,14131239,28244167,0.0001251585858418
WA18,3p,7,C>A,2013,2234,4247,14112928,14131237,28244165,0.0001503673413605
WA18,3p,8,C>A,2188,1486,3674,14112927,14131187,28244114,0.0001300802000728
WA18,3p,9,C>A,2320,1796,4116,14112909,14131177,28244086,0.0001457296228314
WA18,3p,10,C>A,3305,2189,5494,14112909,14131197,28244106,0.0001945184598868
WA18,3p,11,C>A,2696,1721,4417,14112900,14131167,28244067,0.0001563868263023
WA18,3p,12,C>A,2274,1856,4130,14112895,14131136,28244031,0.0001462255865672
WA18,3p,13,C>A,2105,1477,3582,14112898,14131061,28243959,0.0001268235802211
WA18,3p,14,C>A,2718,1633,4351,14112830,14131006,28243836,0.0001540513122934
WA18,3p,15,C>A,2750,1857,4607,14112809,14130957,28243766,0.0001631156411648
WA18,3p,16,C>A,2441,2257,4698,14112765,14130927,28243692,0.0001663380269123
WA18,3p,17,C>A,2953,1616,4569,14112743,14130850,28243593,0.0001617712024104
WA18,3p,18,C>A,2424,1973,4397,14112708,14130769,28243477,0.0001556819650781
WA18,3p,19,C>A,2571,1778,4349,14112724,14130771,28243495,0.0001539823594778
WA18,3p,20,C>A,2766,1905,4671,14112697,14130797,28243494,0.0001653832206454
WA18,3p,21,C>A,2970,2259,5229,14112659,14130783,28243442,0.0001851403239024
WA18,3p,22,C>A,2733,1825,4558,14112575,14130715,28243290,0.0001613834648867
WA18,3p,23,C>A,2597,2347,4944,14112548,14130648,28243196,0.0001750510105159
WA18,3p,24,C>A,2601,2589,5190,14112551,14130690,28243241,0.0001837607801455
WA18,3p,25,C>A,2581,2312,4893,14112486,14130651,28243137,0.0001732456277785
WA18,5p,1,C>A,165,34,199,14112926,14131239,28244165,7.045703068226658e-06
WA18,5p,2,C>A,294,971,1265,14112820,14131183,28244003,4.4788268858348445e-05
WA18,5p,3,C>A,416,148,564,14112928,14131239,28244167,1.996872486981117e-05
WA18,5p,4,C>A,1228,328,1556,14112928,14131239,28244167,5.509102109472728e-05
WA18,5p,5,C>A,3050,1484,4534,14112925,14131239,28244164,0.0001605287379013
WA18,5p,6,C>A,3058,1378,4436,14112927,14131239,28244166,0.0001570589834375
WA18,5p,7,C>A,2094,1172,3266,14112921,14131239,28244160,0.0001156345240927
WA18,5p,8,C>A,2497,1431,3928,14112828,14131230,28244058,0.0001390734999906
WA18,5p,9,C>A,3066,3280,6346,14112833,14131230,28244063,0.0002246843876534
WA18,5p,10,C>A,3828,2941,6769,14112791,14131213,28244004,0.0002396614870894
WA18,5p,11,C>A,2569,2231,4800,14112776,14131211,28243987,0.0001699476777127
WA18,5p,12,C>A,2824,1571,4395,14112682,14131223,28243905,0.0001556087941805
WA18,5p,13,C>A,2573,1874,4447,14112608,14131206,28243814,0.0001574504066624
WA18,5p,14,C>A,3015,2650,5665,14112535,14131179,28243714,0.0002005756041857
WA18,5p,15,C>A,2879,2415,5294,14112545,14131148,28243693,0.0001874400773298
WA18,5p,16,C>A,3281,1680,4961,14112522,14131083,28243605,0.0001756503817412
WA18,5p,17,C>A,2821,2213,5034,14112485,14130990,28243475,0.0001782358580167
WA18,5p,18,C>A,2843,1897,4740,14112481,14130987,28243468,0.0001678264156512
WA18,5p,19,C>A,3312,1932,5244,14112359,14130867,28243226,0.0001856728406308
WA18,5p,20,C>A,3126,2004,5130,14112397,14130866,28243263,0.0001816362365779
WA18,5p,21,C>A,2965,1943,4908,14112347,14130679,28243026,0.0001737774132276
WA18,5p,22,C>A,2637,1998,4635,14112376,14129592,28241968,0.0001641174581034
WA18,5p,23,C>A,2946,2273,5219,14112288,14129275,28241563,0.0001847985538194
WA18,5p,24,C>A,3169,3040,6209,14112253,14129481,28241734,0.0002198519396861
WA18,5p,25,C>A,2818,2079,4897,14112273,14130551,28242824,0.000173389176663
WA22,3p,1,C>A,8,4,12,1513709,1653397,3167106,3.7889480175276734e-06
WA22,3p,2,C>A,13,40,53,1513709,1653396,3167105,1.6734525694601222e-05
WA22,3p,3,C>A,20,13,33,1513709,1653396,3167105,1.041961033814793e-05
WA22,3p,4,C>A,37,38,75,1513709,1653394,3167103,2.368094754101777e-05
WA22,3p,5,C>A,90,88,178,1513709,1653397,3167106,5.620272892666049e-05
WA22,3p,6,C>A,46,136,182,1513709,1653397,3167106,5.746571159916971e-05
WA22,3p,7,C>A,69,133,202,1513709,1653397,3167106,6.378062496171584e-05
WA22,3p,8,C>A,96,247,343,1513709,1653395,3167104,0.0001083008325587
WA22,3p,9,C>A,130,275,405,1513709,1653397,3167106,0.0001278769955915
WA22,3p,10,C>A,155,272,427,1513706,1653396,3167102,0.0001348235705701
WA22,3p,11,C>A,163,177,340,1513685,1653390,3167075,0.0001073545779623
WA22,3p,12,C>A,113,254,367,1513662,1653379,3167041,0.0001158810384835
WA22,3p,13,C>A,89,230,319,1513689,1653380,3167069,0.0001007240448503
WA22,3p,14,C>A,114,207,321,1513686,1653352,3167038,0.0001013565356651
WA22,3p,15,C>A,83,282,365,1513677,1653343,3167020,0.0001152502983877
WA22,3p,16,C>A,137,228,365,1513637,1653341,3166978,0.0001152518268203
WA22,3p,17,C>A,112,311,423,1513671,1653319,3166990,0.0001335653096473
WA22,3p,18,C>A,153,366,519,1513665,1653288,3166953,0.0001638799186473
WA22,3p,19,C>A,164,221,385,1513662,1653275,3166937,0.0001215685692516
WA22,3p,20,C>A,102,297,399,1513684,1653304,3166988,0.000125987215613
WA22,3p,21,C>A,211,341,552,1513677,1653327,3167004,0.0001742972222327
WA22,3p,22,C>A,181,308,489,1513684,1653356,3167040,0.0001544028493482
WA22,3p,23,C>A,190,214,404,1513676,1653329,3167005,0.0001275653180212
WA22,3p,24,C>A,120,214,334,1513672,1653285,3166957,0.0001054640148255
WA22,3p,25,C>A,148,223,371,1513669,1653296,3166965,0.0001171468582696
WA22,5p,1,C>A,4,1,5,1513709,1653397,3167106,1.5787283406365306e-06
WA22,5p,2,C>A,49,8,57,1513674,1653378,3167052,1.7997809950704945e-05
WA22,5p,3,C>A,13,10,23,1513709,1653397,3167106,7.262150366928041e-06
WA22,5p,4,C>A,14,15,29,1513709,1653397,3167106,9.156624375691876e-06
WA22,5p,5,C>A,104,78,182,1513708,1653396,3167104,5.746574788829164e-05
WA22,5p,6,C>A,116,87,203,1513704,1653397,3167101,6.409647182075974e-05
WA22,5p,7,C>A,48,52,100,1513707,1653397,3167104,3.157458675180859e-05
WA22,5p,8,C>A,135,111,246,1513692,1653397,3167089,7.767385128741251e-05
WA22,5p,9,C>A,89,71,160,1513700,1653389,3167089,5.051957807311383e-05
WA22,5p,10,C>A,136,241,377,1513705,1653389,3167094,0.0001190365679073
WA22,5p,11,C>A,178,174,352,1513699,1653381,3167080,0.0001111433875999
WA22,5p,12,C>A,61,75,136,1513692,1653345,3167037,4.294234642664421e-05
WA22,5p,13,C>A,128,87,215,1513697,1653377,3167074,6.788600455815052e-05
WA22,5p,14,C>A,277,123,400,1513677,1653376,3167053,0.0001263003808272
WA22,5p,15,C>A,107,181,288,1513695,1653381,3167076,9.09356137964482e-05
WA22,5p,16,C>A,118,217,335,1513668,1653368,3167036,0.0001057771367297
WA22,5p,17,C>A,99,173,272,1513675,1653395,3167070,8.588379795836531e-05
WA22,5p,18,C>A,106,197,303,1513651,1653392,3167043,9.56728405645266e-05
WA22,5p,19,C>A,115,190,305,1513674,1653350,3167024,9.63049222235133e-05
WA22,5p,20,C>A,117,239,356,1513678,1653356,3167034,0.000112408013302
WA22,5p,21,C>A,127,231,358,1513690,1653371,3167061,0.0001130385553041
WA22,5p,22,C>A,115,279,394,1513691,1653380,3167071,0.0001244051680559
WA22,5p,23,C>A,141,214,355,1513634,1653393,3167027,0.0001120925082103
WA22,5p,24,C>A,305,206,511,1513632,1653375,3167007,0.0001613510800576
WA22,5p,25,C>A,161,207,368,1513644,1653364,3167008,0.0001161980013943
WA25,3p,1,C>A,223,21,244,3375244,3569089,6944333,3.513656387157701e-05
WA25,3p,2,C>A,34,41,75,3375244,3569089,6944333,1.0800173321181458e-05
WA25,3p,3,C>A,71,90,161,3375244,3569089,6944333,2.3184372062802863e-05
WA25,3p,4,C>A,190,158,348,3375244,3569087,6944331,5.011281864300535e-05
WA25,3p,5,C>A,332,278,610,3375244,3569089,6944333,8.784140967894253e-05
WA25,3p,6,C>A,352,448,800,3375244,3569089,6944333,0.0001152018487592
WA25,3p,7,C>A,303,210,513,3375244,3569089,6944333,7.387318551688117e-05
WA25,3p,8,C>A,316,354,670,3375239,3569076,6944315,9.648179842072256e-05
WA25,3p,9,C>A,415,615,1030,3375240,3569076,6944316,0.0001483227433774
WA25,3p,10,C>A,539,615,1154,3375240,3569075,6944315,0.0001661790975783
WA25,3p,11,C>A,396,299,695,3375233,3569054,6944287,0.0001000822690652
WA25,3p,12,C>A,541,338,879,3375226,3569069,6944295,0.0001265787239741
WA25,3p,13,C>A,555,325,880,3375230,3569053,6944283,0.000126722946055
WA25,3p,14,C>A,369,385,754,3375223,3569037,6944260,0.0001085788838551
WA25,3p,15,C>A,392,470,862,3375218,3569039,6944257,0.0001241313505534
WA25,3p,16,C>A,645,685,1330,3375196,3569030,6944226,0.0001915260246426
WA25,3p,17,C>A,461,684,1145,3375198,3569022,6944220,0.0001648853290938
WA25,3p,18,C>A,444,524,968,3375213,3569006,6944219,0.0001393965253687
WA25,3p,19,C>A,579,438,1017,3375204,3569005,6944209,0.0001464529653413
WA25,3p,20,C>A,455,670,1125,3375190,3568979,6944169,0.0001620064258228
WA25,3p,21,C>A,679,526,1205,3375199,3568998,6944197,0.0001735261830849
WA25,3p,22,C>A,650,459,1109,3375179,3568994,6944173,0.0001597022424412
WA25,3p,23,C>A,512,395,907,3375175,3568972,6944147,0.0001306135944414
WA25,3p,24,C>A,544,755,1299,3375177,3568962,6944139,0.0001870642278329
WA25,3p,25,C>A,555,441,996,3375156,3568970,6944126,0.0001434305771525
WA25,5p,1,C>A,12,4,16,3375244,3569089,6944333,2.3040369751853777e-06
WA25,5p,2,C>A,45,56,101,3375147,3569045,6944192,1.4544528722708127e-05
WA25,5p,3,C>A,49,17,66,3375243,3569089,6944332,9.504153891259808e-06
WA25,5p,4,C>A,98,144,242,3375243,3569089,6944332,3.4848564267952624e-05
WA25,5p,5,C>A,382,180,562,3375244,3569088,6944332,8.092931040739412e-05
WA25,5p,6,C>A,431,457,888,3375244,3569089,6944333,0.0001278740521227
WA25,5p,7,C>A,336,150,486,3375242,3569089,6944331,6.998514327730058e-05
WA25,5p,8,C>A,440,513,953,3375221,3569088,6944309,0.0001372346766251
WA25,5p,9,C>A,336,358,694,3375227,3569087,6944314,9.993787723308597e-05
WA25,5p,10,C>A,586,433,1019,3375217,3569085,6944302,0.0001467390099105
WA25,5p,11,C>A,499,289,788,3375193,3569088,6944281,0.0001134746707398
WA25,5p,12,C>A,980,715,1695,3375142,3569084,6944226,0.0002440876780219
WA25,5p,13,C>A,735,405,1140,3375133,3569081,6944214,0.0001641654476662
WA25,5p,14,C>A,560,323,883,3375151,3569071,6944222,0.0001271560730633
WA25,5p,15,C>A,491,336,827,3375137,3569055,6944192,0.0001190923292443
WA25,5p,16,C>A,509,288,797,3375081,3569035,6944116,0.000114773428324
WA25,5p,17,C>A,464,425,889,3375076,3568871,6943947,0.000128025170699
WA25,5p,18,C>A,662,407,1069,3375102,3568996,6944098,0.0001539436799423
WA25,5p,19,C>A,1077,515,1592,3375134,3569021,6944155,0.0002292575554549
WA25,5p,20,C>A,699,580,1279,3375145,3569019,6944164,0.0001841834380639
WA25,5p,21,C>A,458,367,825,3375130,3569013,6944143,0.0001188051570942
WA25,5p,22,C>A,469,436,905,3375139,3569001,6944140,0.0001303257134792
WA25,5p,23,C>A,482,715,1197,3375144,3569002,6944146,0.0001723754080055
WA25,5p,24,C>A,511,589,1100,3375124,3568967,6944091,0.0001584080623367
WA25,5p,25,C>A,450,407,857,3375125,3568950,6944075,0.0001234145656548
WA26,3p,1,C>A,16,37,53,2709623,2900126,5609749,9.44783804052552e-06
WA26,3p,2,C>A,14,44,58,2709623,2900126,5609749,1.0339143516046797e-05
WA26,3p,3,C>A,61,39,100,2709623,2900126,5609749,1.782610951042551e-05
WA26,3p,4,C>A,114,70,184,2709623,2900126,5609749,3.280004149918294e-05
WA26,3p,5,C>A,190,447,637,2709623,2900126,5609749,0.0001135523175814
WA26,3p,6,C>A,225,250,475,2709623,2900126,5609749,8.467402017452118e-05
WA26,3p,7,C>A,292,196,488,2709623,2900126,5609749,8.69914144108765e-05
WA26,3p,8,C>A,253,235,488,2709619,2900114,5609733,8.699166252654092e-05
WA26,3p,9,C>A,377,323,700,2709613,2900111,5609724,0.0001247833226732
WA26,3p,10,C>A,329,366,695,2709609,2900074,5609683,0.0001238929187264
WA26,3p,11,C>A,318,373,691,2709594,2900076,5609670,0.0001231801514171
WA26,3p,12,C>A,258,277,535,2709607,2900081,5609688,9.537072293503668e-05
WA26,3p,13,C>A,352,415,767,2709604,2900084,5609688,0.0001367277467124
WA26,3p,14,C>A,626,320,946,2709584,2900069,5609653,0.0001686378818796
WA26,3p,15,C>A,310,267,577,2709593,2900082,5609675,0.0001028580087081
WA26,3p,16,C>A,420,710,1130,2709580,2900075,5609655,0.0002014384128792
WA26,3p,17,C>A,299,658,957,2709570,2900078,5609648,0.0001705989395413
WA26,3p,18,C>A,290,454,744,2709582,2900059,5609641,0.0001326288081536
WA26,3p,19,C>A,315,482,797,2709567,2900016,5609583,0.0001420782970855
WA26,3p,20,C>A,425,413,838,2709563,2899983,5609546,0.0001493882036086
WA26,3p,21,C>A,281,426,707,2709562,2900021,5609583,0.0001260343237634
WA26,3p,22,C>A,269,453,722,2709522,2900007,5609529,0.0001287095583247
WA26,3p,23,C>A,366,478,844,2709541,2899974,5609515,0.0001504586403637
WA26,3p,24,C>A,671,518,1189,2709558,2899951,5609509,0.0002119615103567
WA26,3p,25,C>A,313,358,671,2709500,2900002,5609502,0.0001196184616744
WA26,5p,1,C>A,3,7,10,2709622,2900126,5609748,1.782611268812788e-06
WA26,5p,2,C>A,24,49,73,2709554,2900092,5609646,1.3013298878396249e-05
WA26,5p,3,C>A,25,14,39,2709623,2900126,5609749,6.952182709065949e-06
WA26,5p,4,C>A,161,153,314,2709623,2900126,5609749,5.597398386273611e-05
WA26,5p,5,C>A,308,583,891,2709623,2900125,5609748,0.0001588306640512
WA26,5p,6,C>A,296,478,774,2709621,2900126,5609747,0.0001379741368015
WA26,5p,7,C>A,174,328,502,2709622,2900126,5609748,8.948708569440197e-05
WA26,5p,8,C>A,247,282,529,2709609,2900124,5609733,9.430038827159869e-05
WA26,5p,9,C>A,323,233,556,2709594,2900123,5609717,9.911373425789572e-05
WA26,5p,10,C>A,357,333,690,2709601,2900123,5609724,0.0001230007037779
WA26,5p,11,C>A,377,345,722,2709605,2900103,5609708,0.0001287054513354
WA26,5p,12,C>A,248,325,573,2709595,2900107,5609702,0.0001021444632887
WA26,5p,13,C>A,382,248,630,2709592,2900104,5609696,0.0001123055509603
WA26,5p,14,C>A,340,551,891,2709563,2900089,5609652,0.0001588333821777
WA26,5p,15,C>A,331,344,675,2709545,2900085,5609630,0.0001203287917384
WA26,5p,16,C>A,481,485,966,2709540,2900076,5609616,0.0001722043006152
WA26,5p,17,C>A,325,356,681,2709554,2900055,5609609,0.0001213988354625
WA26,5p,18,C>A,349,503,852,2709554,2900082,5609636,0.0001518815124546
WA26,5p,19,C>A,492,504,996,2709570,2900086,5609656,0.0001775509942142
WA26,5p,20,C>A,368,494,862,2709563,2900082,5609645,0.0001536639127787
WA26,5p,21,C>A,450,605,1055,2709545,2900061,5609606,0.000188070249497
WA26,5p,22,C>A,381,429,810,2709542,2900059,5609601,0.0001443952965638
WA26,5p,23,C>A,398,286,684,2709528,2900065,5609593,0.0001219339798805
WA26,5p,24,C>A,360,497,857,2709495,2900057,5609552,0.0001527751235749
WA26,5p,25,C>A,444,325,769,2709506,2900041,5609547,0.0001370877184913
