Sample,End,Position,Substitution,Pos_Count,Neg_Count,Combined_Count,Pos_Total,Neg_Total,Combined_Total,Frequency
DAL192,3p,1,->A,0,0,0,6350003,6167708,12517711,0.0
DAL192,3p,2,->A,0,0,0,6350003,6167706,12517709,0.0
DAL192,3p,3,->A,0,0,0,6350003,6167708,12517711,0.0
DAL192,3p,4,->A,0,0,0,6350003,6167708,12517711,0.0
DAL192,3p,5,->A,0,0,0,6350003,6167708,12517711,0.0
DAL192,3p,6,->A,0,0,0,6350003,6167708,12517711,0.0
DAL192,3p,7,->A,0,0,0,6350003,6167708,12517711,0.0
DAL192,3p,8,->A,0,23,23,6350003,6167618,12517621,1.8374098400966129e-06
DAL192,3p,9,->A,0,19,19,6350003,6167637,12517640,1.5178579987921046e-06
DAL192,3p,10,->A,0,19,19,6350003,6167645,12517648,1.5178570287325542e-06
DAL192,3p,11,->A,2,18,20,6349987,6167644,12517631,1.5977464106427167e-06
DAL192,3p,12,->A,1,17,18,6349997,6167646,12517643,1.4379703910712265e-06
DAL192,3p,13,->A,3,17,20,6349992,6167621,12517613,1.5977487081602538e-06
DAL192,3p,14,->A,18,16,34,6349967,6167610,12517577,2.7161806154657568e-06
DAL192,3p,15,->A,19,13,32,6349968,6167615,12517583,2.556404059793332e-06
DAL192,3p,16,->A,31,25,56,6349943,6167587,12517530,4.473726046592259e-06
DAL192,3p,17,->A,47,25,72,6349922,6167606,12517528,5.751934407496432e-06
DAL192,3p,18,->A,55,37,92,6349922,6167564,12517486,7.349718625609008e-06
DAL192,3p,19,->A,50,44,94,6349921,6167519,12517440,7.509522713909554e-06
DAL192,3p,20,->A,44,63,107,6349910,6167516,12517426,8.548083288049795e-06
DAL192,3p,21,->A,59,47,106,6349882,6167507,12517389,8.468219690224535e-06
DAL192,3p,22,->A,47,44,91,6349894,6167488,12517382,7.269890780676023e-06
DAL192,3p,23,->A,42,46,88,6349902,6167465,12517367,7.030232476206857e-06
DAL192,3p,24,->A,46,47,93,6349899,6167465,12517364,7.429679283913131e-06
DAL192,3p,25,->A,74,170,244,6349856,6167384,12517240,1.9493115095660065e-05
DAL192,5p,1,->A,0,0,0,6350003,6167708,12517711,0.0
DAL192,5p,2,->A,0,0,0,6349992,6167694,12517686,0.0
DAL192,5p,3,->A,0,0,0,6350003,6167707,12517710,0.0
DAL192,5p,4,->A,0,0,0,6350003,6167708,12517711,0.0
DAL192,5p,5,->A,0,0,0,6350003,6167707,12517710,0.0
DAL192,5p,6,->A,0,0,0,6350002,6167707,12517709,0.0
DAL192,5p,7,->A,0,0,0,6350002,6167708,12517710,0.0
DAL192,5p,8,->A,65,0,65,6349926,6167708,12517634,5.192674590102251e-06
DAL192,5p,9,->A,60,0,60,6349914,6167708,12517622,4.793242678201978e-06
DAL192,5p,10,->A,79,0,79,6349896,6167708,12517604,6.311111934839926e-06
DAL192,5p,11,->A,29,0,29,6349942,6167706,12517648,2.316729149118109e-06
DAL192,5p,12,->A,47,3,50,6349906,6167700,12517606,3.994374004102701e-06
DAL192,5p,13,->A,62,1,63,6349906,6167705,12517611,5.032909234837223e-06
DAL192,5p,14,->A,58,15,73,6349889,6167679,12517568,5.831803749737968e-06
DAL192,5p,15,->A,60,20,80,6349890,6167649,12517539,6.3910326143181975e-06
DAL192,5p,16,->A,44,21,65,6349904,6167639,12517543,5.19271233979384e-06
DAL192,5p,17,->A,154,13,167,6349778,6167623,12517401,1.3341427665375584e-05
DAL192,5p,18,->A,61,16,77,6349859,6167631,12517490,6.15139297095504e-06
DAL192,5p,19,->A,82,10,92,6349822,6167638,12517460,7.349733891700073e-06
DAL192,5p,20,->A,80,18,98,6349836,6167621,12517457,7.829066239252909e-06
DAL192,5p,21,->A,129,31,160,6349784,6167624,12517408,1.2782198998386888e-05
DAL192,5p,22,->A,102,30,132,6349783,6167584,12517367,1.0545348714310286e-05
DAL192,5p,23,->A,103,24,127,6349801,6167567,12517368,1.0145902876706987e-05
DAL192,5p,24,->A,95,24,119,6349759,6167564,12517323,9.506825061556692e-06
DAL192,5p,25,->A,81,27,108,6349777,6167551,12517328,8.628039466569862e-06
DAL193,3p,1,->A,0,0,0,6484405,6362696,12847101,0.0
DAL193,3p,2,->A,0,0,0,6484402,6362696,12847098,0.0
DAL193,3p,3,->A,0,0,0,6484405,6362696,12847101,0.0
DAL193,3p,4,->A,0,0,0,6484405,6362696,12847101,0.0
DAL193,3p,5,->A,0,0,0,6484405,6362696,12847101,0.0
DAL193,3p,6,->A,0,0,0,6484405,6362696,12847101,0.0
DAL193,3p,7,->A,0,0,0,6484405,6362696,12847101,0.0
DAL193,3p,8,->A,0,21,21,6484400,6362644,12847044,1.6346172707122354e-06
DAL193,3p,9,->A,0,13,13,6484400,6362631,12847031,1.011906953443173e-06
DAL193,3p,10,->A,7,12,19,6484393,6362640,12847033,1.4789407017168866e-06
DAL193,3p,11,->A,1,15,16,6484398,6362639,12847037,1.2454233610442629e-06
DAL193,3p,12,->A,7,27,34,6484368,6362594,12846962,2.646540092513701e-06
DAL193,3p,13,->A,2,26,28,6484385,6362543,12846928,2.179509373758458e-06
DAL193,3p,14,->A,27,31,58,6484363,6362486,12846849,4.51472575103825e-06
DAL193,3p,15,->A,43,51,94,6484332,6362438,12846770,7.317014315660668e-06
DAL193,3p,16,->A,28,53,81,6484341,6362460,12846801,6.305071589417475e-06
DAL193,3p,17,->A,56,57,113,6484294,6362445,12846739,8.796006519631169e-06
DAL193,3p,18,->A,78,72,150,6484244,6362380,12846624,1.1676219370941346e-05
DAL193,3p,19,->A,58,72,130,6484265,6362400,12846665,1.011935782555239e-05
DAL193,3p,20,->A,49,84,133,6484261,6362382,12846643,1.0352899197089857e-05
DAL193,3p,21,->A,65,71,136,6484248,6362443,12846691,1.0586383684327738e-05
DAL193,3p,22,->A,91,62,153,6484224,6362407,12846631,1.1909737268860606e-05
DAL193,3p,23,->A,82,37,119,6484218,6362399,12846617,9.263139081674187e-06
DAL193,3p,24,->A,121,73,194,6484164,6362319,12846483,1.5101409467478377e-05
DAL193,3p,25,->A,76,79,155,6484128,6362355,12846483,1.2065559110614166e-05
DAL193,5p,1,->A,0,0,0,6484405,6362696,12847101,0.0
DAL193,5p,2,->A,0,0,0,6484386,6362681,12847067,0.0
DAL193,5p,3,->A,1,0,1,6484400,6362696,12847096,7.783860259158958e-08
DAL193,5p,4,->A,1,0,1,6484403,6362696,12847099,7.783858441504965e-08
DAL193,5p,5,->A,1,0,1,6484403,6362696,12847099,7.783858441504965e-08
DAL193,5p,6,->A,0,0,0,6484404,6362696,12847100,0.0
DAL193,5p,7,->A,0,0,0,6484404,6362696,12847100,0.0
DAL193,5p,8,->A,77,0,77,6484314,6362693,12847007,5.9936139211257536e-06
DAL193,5p,9,->A,83,0,83,6484295,6362695,12846990,6.460657321286932e-06
DAL193,5p,10,->A,101,1,102,6484284,6362694,12846978,7.93961038930712e-06
DAL193,5p,11,->A,48,13,61,6484315,6362677,12846992,4.748193195730176e-06
DAL193,5p,12,->A,51,22,73,6484218,6362670,12846888,5.682309988224386e-06
DAL193,5p,13,->A,118,31,149,6484143,6362652,12846795,1.1598223525789896e-05
DAL193,5p,14,->A,75,38,113,6484145,6362627,12846772,8.795983924989095e-06
DAL193,5p,15,->A,79,117,196,6484166,6362534,12846700,1.525683638599796e-05
DAL193,5p,16,->A,82,109,191,6484111,6362519,12846630,1.4867712388385124e-05
DAL193,5p,17,->A,105,20,125,6484043,6362598,12846641,9.730169933136608e-06
DAL193,5p,18,->A,189,24,213,6483967,6362571,12846538,1.6580342501614053e-05
DAL193,5p,19,->A,103,23,126,6483980,6362593,12846573,9.808063208763923e-06
DAL193,5p,20,->A,182,43,225,6483952,6362554,12846506,1.751448993212629e-05
DAL193,5p,21,->A,127,34,161,6484003,6362532,12846535,1.2532562282358628e-05
DAL193,5p,22,->A,123,37,160,6484010,6362499,12846509,1.245474548766517e-05
DAL193,5p,23,->A,144,46,190,6483966,6362463,12846429,1.4790102370082769e-05
DAL193,5p,24,->A,161,42,203,6483905,6362426,12846331,1.580217729093233e-05
DAL193,5p,25,->A,178,43,221,6483942,6362403,12846345,1.7203336824598748e-05
DAL195,3p,1,->A,0,0,0,2363278,2267461,4630739,0.0
DAL195,3p,2,->A,0,0,0,2363278,2267460,4630738,0.0
DAL195,3p,3,->A,0,0,0,2363278,2267461,4630739,0.0
DAL195,3p,4,->A,0,0,0,2363278,2267461,4630739,0.0
DAL195,3p,5,->A,0,0,0,2363278,2267461,4630739,0.0
DAL195,3p,6,->A,0,0,0,2363278,2267461,4630739,0.0
DAL195,3p,7,->A,0,0,0,2363278,2267461,4630739,0.0
DAL195,3p,8,->A,0,15,15,2363278,2267413,4630691,3.239257380809905e-06
DAL195,3p,9,->A,0,5,5,2363276,2267438,4630714,1.0797470973158784e-06
DAL195,3p,10,->A,0,5,5,2363274,2267432,4630706,1.0797489626851717e-06
DAL195,3p,11,->A,1,17,18,2363274,2267431,4630705,3.887097105084431e-06
DAL195,3p,12,->A,4,15,19,2363273,2267414,4630687,4.103062893259683e-06
DAL195,3p,13,->A,0,7,7,2363269,2267412,4630681,1.5116567088080565e-06
DAL195,3p,14,->A,11,12,23,2363250,2267410,4630660,4.966894567944959e-06
DAL195,3p,15,->A,13,16,29,2363254,2267411,4630665,6.262599432262969e-06
DAL195,3p,16,->A,10,15,25,2363259,2267394,4630653,5.398806604597667e-06
DAL195,3p,17,->A,21,9,30,2363234,2267398,4630632,6.478597305940096e-06
DAL195,3p,18,->A,18,9,27,2363236,2267374,4630610,5.830765277144912e-06
DAL195,3p,19,->A,30,18,48,2363215,2267369,4630584,1.036586313950897e-05
DAL195,3p,20,->A,21,15,36,2363222,2267380,4630602,7.774367134122086e-06
DAL195,3p,21,->A,14,25,39,2363235,2267382,4630617,8.422203779755484e-06
DAL195,3p,22,->A,12,21,33,2363231,2267383,4630614,7.126484738309002e-06
DAL195,3p,23,->A,32,33,65,2363219,2267370,4630589,1.4037091177817767e-05
DAL195,3p,24,->A,39,19,58,2363198,2267373,4630571,1.2525453124463484e-05
DAL195,3p,25,->A,44,19,63,2363180,2267377,4630557,1.360527470021425e-05
DAL195,5p,1,->A,0,0,0,2363278,2267461,4630739,0.0
DAL195,5p,2,->A,0,0,0,2363264,2267447,4630711,0.0
DAL195,5p,3,->A,0,0,0,2363278,2267459,4630737,0.0
DAL195,5p,4,->A,0,0,0,2363278,2267461,4630739,0.0
DAL195,5p,5,->A,0,0,0,2363277,2267461,4630738,0.0
DAL195,5p,6,->A,0,0,0,2363277,2267461,4630738,0.0
DAL195,5p,7,->A,0,0,0,2363277,2267461,4630738,0.0
DAL195,5p,8,->A,36,0,36,2363212,2267460,4630672,7.774249612151324e-06
DAL195,5p,9,->A,28,0,28,2363181,2267461,4630642,6.046677760880673e-06
DAL195,5p,10,->A,45,3,48,2363146,2267458,4630604,1.0365818368402912e-05
DAL195,5p,11,->A,18,2,20,2362948,2267450,4630398,4.319283137216283e-06
DAL195,5p,12,->A,15,1,16,2362864,2267454,4630318,3.455486210666308e-06
DAL195,5p,13,->A,23,3,26,2363073,2267445,4630518,5.61492256373909e-06
DAL195,5p,14,->A,26,5,31,2363094,2267434,4630528,6.694700906678461e-06
DAL195,5p,15,->A,38,8,46,2363178,2267432,4630610,9.933896398098738e-06
DAL195,5p,16,->A,29,8,37,2363170,2267429,4630599,7.990326953381193e-06
DAL195,5p,17,->A,32,10,42,2363159,2267431,4630590,9.070118494619476e-06
DAL195,5p,18,->A,44,8,52,2363182,2267420,4630602,1.1229641415954123e-05
DAL195,5p,19,->A,39,11,50,2363138,2267420,4630558,1.0797834731796905e-05
DAL195,5p,20,->A,60,18,78,2363110,2267401,4630511,1.6844793155658197e-05
DAL195,5p,21,->A,66,13,79,2363086,2267400,4630486,1.70608441532919e-05
DAL195,5p,22,->A,62,14,76,2363094,2267388,4630482,1.6412978173762473e-05
DAL195,5p,23,->A,80,20,100,2363068,2267398,4630466,2.1596098535223026e-05
DAL195,5p,24,->A,57,16,73,2363067,2267402,4630469,1.5765141716746186e-05
DAL195,5p,25,->A,55,25,80,2363135,2267374,4630509,1.727671839100194e-05
DAL212,3p,1,->A,0,0,0,4131322,4008153,8139475,0.0
DAL212,3p,2,->A,0,0,0,4131322,4008153,8139475,0.0
DAL212,3p,3,->A,0,0,0,4131322,4008153,8139475,0.0
DAL212,3p,4,->A,0,0,0,4131322,4008153,8139475,0.0
DAL212,3p,5,->A,0,0,0,4131322,4008151,8139473,0.0
DAL212,3p,6,->A,0,0,0,4131322,4008151,8139473,0.0
DAL212,3p,7,->A,0,0,0,4131322,4008153,8139475,0.0
DAL212,3p,8,->A,3,22,25,4131319,4008093,8139412,3.071474941924552e-06
DAL212,3p,9,->A,0,12,12,4131316,4008115,8139431,1.4743045306238236e-06
DAL212,3p,10,->A,3,19,22,4131317,4008102,8139419,2.702895624368275e-06
DAL212,3p,11,->A,1,21,22,4131313,4008105,8139418,2.7028959564430776e-06
DAL212,3p,12,->A,3,23,26,4131314,4008034,8139348,3.1943590567696577e-06
DAL212,3p,13,->A,5,45,50,4131307,4007923,8139230,6.143087245353676e-06
DAL212,3p,14,->A,22,28,50,4131271,4007904,8139175,6.14312875690718e-06
DAL212,3p,15,->A,29,54,83,4131254,4007935,8139189,1.0197576195859318e-05
DAL212,3p,16,->A,48,52,100,4131236,4007982,8139218,1.2286192604744091e-05
DAL212,3p,17,->A,46,38,84,4131249,4007981,8139230,1.0320386572194177e-05
DAL212,3p,18,->A,32,32,64,4131222,4007954,8139176,7.863203842747717e-06
DAL212,3p,19,->A,45,35,80,4131233,4007956,8139189,9.828989104442717e-06
DAL212,3p,20,->A,39,38,77,4131221,4007928,8139149,9.46044850634876e-06
DAL212,3p,21,->A,46,42,88,4131228,4007917,8139145,1.0811946463664182e-05
DAL212,3p,22,->A,56,34,90,4131183,4007898,8139081,1.1057759469404467e-05
DAL212,3p,23,->A,52,39,91,4131172,4007904,8139076,1.118063033199346e-05
DAL212,3p,24,->A,67,50,117,4131124,4007904,8139028,1.437518091840942e-05
DAL212,3p,25,->A,63,53,116,4131071,4007924,8138995,1.4252373911029556e-05
DAL212,5p,1,->A,0,0,0,4131322,4008153,8139475,0.0
DAL212,5p,2,->A,0,0,0,4131307,4008143,8139450,0.0
DAL212,5p,3,->A,0,0,0,4131321,4008153,8139474,0.0
DAL212,5p,4,->A,0,0,0,4131322,4008153,8139475,0.0
DAL212,5p,5,->A,0,0,0,4131322,4008153,8139475,0.0
DAL212,5p,6,->A,0,0,0,4131322,4008153,8139475,0.0
DAL212,5p,7,->A,0,0,0,4131322,4008153,8139475,0.0
DAL212,5p,8,->A,57,0,57,4131248,4008153,8139401,7.002972331747754e-06
DAL212,5p,9,->A,59,0,59,4131243,4008153,8139396,7.248695112020597e-06
DAL212,5p,10,->A,90,1,91,4131179,4008148,8139327,1.1180285544492808e-05
DAL212,5p,11,->A,32,5,37,4131234,4008143,8139377,4.545802461294028e-06
DAL212,5p,12,->A,37,8,45,4131187,4008141,8139328,5.528711952632945e-06
DAL212,5p,13,->A,69,3,72,4131181,4008142,8139323,8.8459445582882e-06
DAL212,5p,14,->A,113,19,132,4131134,4008108,8139242,1.621772641727571e-05
DAL212,5p,15,->A,73,25,98,4131156,4008091,8139247,1.20404258526618e-05
DAL212,5p,16,->A,74,35,109,4131154,4008081,8139235,1.339192196809651e-05
DAL212,5p,17,->A,68,10,78,4131159,4008081,8139240,9.58320432865968e-06
DAL212,5p,18,->A,90,22,112,4131113,4008066,8139179,1.3760601652820266e-05
DAL212,5p,19,->A,124,37,161,4131040,4008052,8139092,1.978107631662107e-05
DAL212,5p,20,->A,115,39,154,4131020,4008040,8139060,1.892110391126248e-05
DAL212,5p,21,->A,128,24,152,4130973,4008040,8139013,1.8675483132905678e-05
DAL212,5p,22,->A,108,51,159,4131015,4007967,8138982,1.953561268473133e-05
DAL212,5p,23,->A,102,100,202,4131005,4007962,8138967,2.4818874434556623e-05
DAL212,5p,24,->A,97,101,198,4131060,4007918,8138978,2.432737869545783e-05
DAL212,5p,25,->A,110,156,266,4131016,4007614,8138630,3.2683633486225565e-05
DAL218,3p,1,->A,0,0,0,6952891,6658031,13610922,0.0
DAL218,3p,2,->A,0,0,0,6952891,6658031,13610922,0.0
DAL218,3p,3,->A,0,0,0,6952891,6658030,13610921,0.0
DAL218,3p,4,->A,0,0,0,6952891,6658031,13610922,0.0
DAL218,3p,5,->A,0,0,0,6952891,6658031,13610922,0.0
DAL218,3p,6,->A,0,1,1,6952891,6658030,13610921,7.34704139418633e-08
DAL218,3p,7,->A,0,3,3,6952891,6658026,13610917,2.2041130660042965e-07
DAL218,3p,8,->A,3,38,41,6952887,6657945,13610832,3.0123066686885857e-06
DAL218,3p,9,->A,1,44,45,6952882,6657945,13610827,3.306191460665836e-06
DAL218,3p,10,->A,10,29,39,6952881,6657960,13610841,2.8653629852850385e-06
DAL218,3p,11,->A,8,40,48,6952866,6657905,13610771,3.5266187345301747e-06
DAL218,3p,12,->A,7,34,41,6952858,6657882,13610740,3.012327029977797e-06
DAL218,3p,13,->A,10,36,46,6952870,6657811,13610681,3.3796986352115662e-06
DAL218,3p,14,->A,41,78,119,6952816,6657779,13610595,8.743188670296928e-06
DAL218,3p,15,->A,48,64,112,6952788,6657738,13610526,8.228925171591459e-06
DAL218,3p,16,->A,46,81,127,6952760,6657689,13610449,9.331066153658854e-06
DAL218,3p,17,->A,54,66,120,6952737,6657651,13610388,8.816794936338331e-06
DAL218,3p,18,->A,75,76,151,6952711,6657672,13610383,1.1094471037295571e-05
DAL218,3p,19,->A,78,77,155,6952716,6657697,13610413,1.1388339207634624e-05
DAL218,3p,20,->A,83,63,146,6952697,6657752,13610449,1.0727052428615691e-05
DAL218,3p,21,->A,65,92,157,6952660,6657692,13610352,1.153533721978682e-05
DAL218,3p,22,->A,102,121,223,6952654,6657637,13610291,1.6384660695351776e-05
DAL218,3p,23,->A,73,125,198,6952651,6657632,13610283,1.4547823876990656e-05
DAL218,3p,24,->A,92,95,187,6952669,6657588,13610257,1.3739637686488947e-05
DAL218,3p,25,->A,108,93,201,6952605,6657566,13610171,1.476836698084102e-05
DAL218,5p,1,->A,0,0,0,6952891,6658031,13610922,0.0
DAL218,5p,2,->A,0,0,0,6952874,6658014,13610888,0.0
DAL218,5p,3,->A,0,0,0,6952891,6658031,13610922,0.0
DAL218,5p,4,->A,0,0,0,6952891,6658031,13610922,0.0
DAL218,5p,5,->A,0,0,0,6952891,6658031,13610922,0.0
DAL218,5p,6,->A,0,0,0,6952891,6658031,13610922,0.0
DAL218,5p,7,->A,0,0,0,6952888,6658031,13610919,0.0
DAL218,5p,8,->A,101,2,103,6952719,6658029,13610748,7.56754882244532e-06
DAL218,5p,9,->A,108,0,108,6952736,6658029,13610765,7.93489565061185e-06
DAL218,5p,10,->A,118,1,119,6952716,6658028,13610744,8.743092956564315e-06
DAL218,5p,11,->A,65,5,70,6952715,6658016,13610731,5.143000769025558e-06
DAL218,5p,12,->A,81,1,82,6952625,6658005,13610630,6.024702750717638e-06
DAL218,5p,13,->A,84,9,93,6952475,6658005,13610480,6.832969887909905e-06
DAL218,5p,14,->A,122,28,150,6952554,6657955,13610509,1.102089569170411e-05
DAL218,5p,15,->A,113,30,143,6952449,6657923,13610372,1.0506692983850846e-05
DAL218,5p,16,->A,270,32,302,6952253,6657920,13610173,2.218928444186565e-05
DAL218,5p,17,->A,271,29,300,6952350,6657874,13610224,2.204225294161213e-05
DAL218,5p,18,->A,110,47,157,6952457,6657843,13610300,1.1535381292109652e-05
DAL218,5p,19,->A,199,55,254,6952296,6657770,13610066,1.866265747719372e-05
DAL218,5p,20,->A,190,46,236,6952289,6657772,13610061,1.7340113317640532e-05
DAL218,5p,21,->A,202,56,258,6952371,6657729,13610100,1.895651023871977e-05
DAL218,5p,22,->A,228,52,280,6952322,6657786,13610108,2.0572944755471448e-05
DAL218,5p,23,->A,142,73,215,6952288,6657745,13610033,1.579716963213829e-05
DAL218,5p,24,->A,185,55,240,6952375,6657772,13610147,1.763390211729528e-05
DAL218,5p,25,->A,200,78,278,6952272,6657720,13609992,2.042616924389081e-05
DAL224,3p,1,->A,0,0,0,4609472,4586477,9195949,0.0
DAL224,3p,2,->A,0,0,0,4609471,4586476,9195947,0.0
DAL224,3p,3,->A,0,0,0,4609472,4586477,9195949,0.0
DAL224,3p,4,->A,0,0,0,4609472,4586477,9195949,0.0
DAL224,3p,5,->A,0,0,0,4609472,4586477,9195949,0.0
DAL224,3p,6,->A,0,0,0,4609472,4586477,9195949,0.0
DAL224,3p,7,->A,0,0,0,4609472,4586476,9195948,0.0
DAL224,3p,8,->A,0,14,14,4609469,4586423,9195892,1.5224189235802247e-06
DAL224,3p,9,->A,2,19,21,4609466,4586431,9195897,2.283627143714202e-06
DAL224,3p,10,->A,3,67,70,4609461,4586371,9195832,7.612144284497586e-06
DAL224,3p,11,->A,5,46,51,4609461,4586382,9195843,5.5459842017746494e-06
DAL224,3p,12,->A,4,44,48,4609458,4586384,9195842,5.219750404585028e-06
DAL224,3p,13,->A,3,30,33,4609454,4586364,9195818,3.5885877689184365e-06
DAL224,3p,14,->A,33,81,114,4609412,4586293,9195705,1.239709190323091e-05
DAL224,3p,15,->A,29,67,96,4609400,4586272,9195672,1.0439693803780736e-05
DAL224,3p,16,->A,41,99,140,4609379,4586240,9195619,1.522464121229903e-05
DAL224,3p,17,->A,53,124,177,4609381,4586216,9195597,1.9248342440409253e-05
DAL224,3p,18,->A,61,90,151,4609363,4586282,9195645,1.6420816593072047e-05
DAL224,3p,19,->A,48,124,172,4609353,4586195,9195548,1.870470362397108e-05
DAL224,3p,20,->A,58,63,121,4609344,4586225,9195569,1.3158511452635502e-05
DAL224,3p,21,->A,69,35,104,4609343,4586223,9195566,1.1309798657309404e-05
DAL224,3p,22,->A,62,106,168,4609324,4586172,9195496,1.8269813830597067e-05
DAL224,3p,23,->A,56,196,252,4609323,4586083,9195406,2.740498896949194e-05
DAL224,3p,24,->A,64,76,140,4609325,4586202,9195527,1.5224793532768704e-05
DAL224,3p,25,->A,113,85,198,4609265,4586173,9195438,2.153241640039333e-05
DAL224,5p,1,->A,0,0,0,4609472,4586477,9195949,0.0
DAL224,5p,2,->A,0,0,0,4609461,4586469,9195930,0.0
DAL224,5p,3,->A,0,0,0,4609468,4586477,9195945,0.0
DAL224,5p,4,->A,0,0,0,4609471,4586477,9195948,0.0
DAL224,5p,5,->A,0,0,0,4609471,4586477,9195948,0.0
DAL224,5p,6,->A,0,0,0,4609472,4586477,9195949,0.0
DAL224,5p,7,->A,1,0,1,4609471,4586477,9195948,1.0874354661422618e-07
DAL224,5p,8,->A,53,0,53,4609397,4586477,9195874,5.763454349200522e-06
DAL224,5p,9,->A,67,2,69,4609357,4586473,9195830,7.503400998061077e-06
DAL224,5p,10,->A,76,4,80,4609338,4586470,9195808,8.69961617293445e-06
DAL224,5p,11,->A,27,3,30,4609388,4586469,9195857,3.262338681430127e-06
DAL224,5p,12,->A,35,0,35,4609357,4586464,9195821,3.8060766950552864e-06
DAL224,5p,13,->A,74,7,81,4609320,4586461,9195781,8.808387237582104e-06
DAL224,5p,14,->A,68,4,72,4609270,4586428,9195698,7.829748214871781e-06
DAL224,5p,15,->A,56,10,66,4609299,4586416,9195715,7.177255928440584e-06
DAL224,5p,16,->A,77,25,102,4609292,4586373,9195665,1.1092183110193773e-05
DAL224,5p,17,->A,79,20,99,4609285,4586385,9195670,1.0765936576671413e-05
DAL224,5p,18,->A,94,24,118,4609226,4586351,9195577,1.283225620317246e-05
DAL224,5p,19,->A,102,31,133,4609203,4586337,9195540,1.4463533408587206e-05
DAL224,5p,20,->A,100,42,142,4609148,4586313,9195461,1.5442401419569936e-05
DAL224,5p,21,->A,118,31,149,4609195,4586347,9195542,1.6203503828268087e-05
DAL224,5p,22,->A,80,27,107,4609138,4586312,9195450,1.1636189637266256e-05
DAL224,5p,23,->A,141,40,181,4609100,4586313,9195413,1.9683727093062595e-05
DAL224,5p,24,->A,131,28,159,4609109,4586316,9195425,1.7291207312331948e-05
DAL224,5p,25,->A,140,69,209,4609125,4586257,9195382,2.2728800173826385e-05
DAL227,3p,1,->A,0,0,0,3765386,3771243,7536629,0.0
DAL227,3p,2,->A,0,0,0,3765386,3771243,7536629,0.0
DAL227,3p,3,->A,0,0,0,3765386,3771243,7536629,0.0
DAL227,3p,4,->A,0,0,0,3765386,3771243,7536629,0.0
DAL227,3p,5,->A,0,0,0,3765386,3771243,7536629,0.0
DAL227,3p,6,->A,0,0,0,3765386,3771243,7536629,0.0
DAL227,3p,7,->A,0,0,0,3765386,3771243,7536629,0.0
DAL227,3p,8,->A,0,9,9,3765386,3771207,7536593,1.1941735476494483e-06
DAL227,3p,9,->A,0,9,9,3765384,3771218,7536602,1.1941721216006896e-06
DAL227,3p,10,->A,1,10,11,3765382,3771209,7536591,1.4595458344495545e-06
DAL227,3p,11,->A,5,10,15,3765378,3771214,7536592,1.990289510165868e-06
DAL227,3p,12,->A,3,12,15,3765377,3771173,7536550,1.990300601734215e-06
DAL227,3p,13,->A,6,30,36,3765373,3771183,7536556,4.776717641320518e-06
DAL227,3p,14,->A,27,34,61,3765341,3771166,7536507,8.093935293896761e-06
DAL227,3p,15,->A,21,20,41,3765341,3771186,7536527,5.440171580357903e-06
DAL227,3p,16,->A,25,12,37,3765340,3771079,7536419,4.9094934875568885e-06
DAL227,3p,17,->A,32,125,157,3765328,3771049,7536377,2.0832291165901068e-05
DAL227,3p,18,->A,39,138,177,3765321,3771036,7536357,2.3486148546306923e-05
DAL227,3p,19,->A,38,59,97,3765313,3771111,7536424,1.287082573910385e-05
DAL227,3p,20,->A,32,61,93,3765308,3771082,7536390,1.2340125710054812e-05
DAL227,3p,21,->A,42,35,77,3765307,3771104,7536411,1.0217064860183448e-05
DAL227,3p,22,->A,40,23,63,3765309,3771137,7536446,8.35937788182918e-06
DAL227,3p,23,->A,33,26,59,3765319,3771112,7536431,7.828639312162481e-06
DAL227,3p,24,->A,32,51,83,3765312,3771081,7536393,1.1013226088395338e-05
DAL227,3p,25,->A,72,27,99,3765249,3771100,7536349,1.3136334317850726e-05
DAL227,5p,1,->A,0,0,0,3765386,3771243,7536629,0.0
DAL227,5p,2,->A,0,0,0,3765373,3771238,7536611,0.0
DAL227,5p,3,->A,0,0,0,3765386,3771243,7536629,0.0
DAL227,5p,4,->A,0,0,0,3765385,3771243,7536628,0.0
DAL227,5p,5,->A,0,0,0,3765386,3771242,7536628,0.0
DAL227,5p,6,->A,0,0,0,3765386,3771243,7536629,0.0
DAL227,5p,7,->A,0,0,0,3765386,3771243,7536629,0.0
DAL227,5p,8,->A,34,0,34,3765342,3771242,7536584,4.511327678428317e-06
DAL227,5p,9,->A,52,0,52,3765324,3771243,7536567,6.899693189219973e-06
DAL227,5p,10,->A,49,4,53,3765318,3771238,7536556,7.032389860832986e-06
DAL227,5p,11,->A,12,1,13,3765365,3771237,7536602,1.7249152867565516e-06
DAL227,5p,12,->A,30,4,34,3765326,3771232,7536558,4.511343241835331e-06
DAL227,5p,13,->A,35,1,36,3765325,3771231,7536556,4.776717641320518e-06
DAL227,5p,14,->A,60,6,66,3765297,3771226,7536523,8.757354021211107e-06
DAL227,5p,15,->A,39,19,58,3765318,3771201,7536519,7.695860648662863e-06
DAL227,5p,16,->A,39,19,58,3765316,3771188,7536504,7.695875965832434e-06
DAL227,5p,17,->A,20,2,22,3765326,3771175,7536501,2.919126528345183e-06
DAL227,5p,18,->A,53,15,68,3765280,3771169,7536449,9.022816979190068e-06
DAL227,5p,19,->A,49,19,68,3765279,3771164,7536443,9.022824162539277e-06
DAL227,5p,20,->A,80,19,99,3765254,3771167,7536421,1.3136208818482938e-05
DAL227,5p,21,->A,57,10,67,3765270,3771169,7536439,8.890140290394442e-06
DAL227,5p,22,->A,85,13,98,3765253,3771158,7536411,1.3003537094778934e-05
DAL227,5p,23,->A,71,18,89,3765254,3771157,7536411,1.1809334708523726e-05
DAL227,5p,24,->A,59,6,65,3765270,3771180,7536450,8.624750379820738e-06
DAL227,5p,25,->A,55,18,73,3765247,3771148,7536395,9.686328808402426e-06
WA02,3p,1,->A,0,0,0,6552698,6754258,13306956,0.0
WA02,3p,2,->A,0,0,0,6552698,6754258,13306956,0.0
WA02,3p,3,->A,0,0,0,6552698,6754258,13306956,0.0
WA02,3p,4,->A,0,0,0,6552698,6754256,13306954,0.0
WA02,3p,5,->A,0,0,0,6552698,6754256,13306954,0.0
WA02,3p,6,->A,0,0,0,6552698,6754257,13306955,0.0
WA02,3p,7,->A,0,0,0,6552698,6754257,13306955,0.0
WA02,3p,8,->A,1,20,21,6552692,6754207,13306899,1.5781287586236283e-06
WA02,3p,9,->A,3,13,16,6552688,6754191,13306879,1.2023856232554609e-06
WA02,3p,10,->A,6,11,17,6552680,6754207,13306887,1.2775339566646955e-06
WA02,3p,11,->A,11,14,25,6552667,6754202,13306869,1.8787289481845804e-06
WA02,3p,12,->A,7,22,29,6552670,6754189,13306859,2.179327217640166e-06
WA02,3p,13,->A,10,13,23,6552675,6754177,13306852,1.7284328404644463e-06
WA02,3p,14,->A,14,24,38,6552653,6754155,13306808,2.855681091964354e-06
WA02,3p,15,->A,23,28,51,6552632,6754146,13306778,3.832633264040326e-06
WA02,3p,16,->A,12,49,61,6552629,6754119,13306748,4.584140317378821e-06
WA02,3p,17,->A,37,38,75,6552608,6754116,13306724,5.636248260653787e-06
WA02,3p,18,->A,26,53,79,6552611,6754085,13306696,5.936860660227001e-06
WA02,3p,19,->A,44,51,95,6552605,6754056,13306661,7.139281597389458e-06
WA02,3p,20,->A,22,65,87,6552618,6754033,13306651,6.5380838499484206e-06
WA02,3p,21,->A,41,38,79,6552597,6754089,13306686,5.936865121789152e-06
WA02,3p,22,->A,36,46,82,6552593,6754062,13306655,6.162330052143082e-06
WA02,3p,23,->A,30,59,89,6552585,6754052,13306637,6.688391665001458e-06
WA02,3p,24,->A,39,49,88,6552556,6754026,13306582,6.6132685313178095e-06
WA02,3p,25,->A,57,49,106,6552517,6754038,13306555,7.965998712664547e-06
WA02,5p,1,->A,0,0,0,6552698,6754258,13306956,0.0
WA02,5p,2,->A,0,0,0,6552562,6754179,13306741,0.0
WA02,5p,3,->A,0,0,0,6552698,6754258,13306956,0.0
WA02,5p,4,->A,0,0,0,6552698,6754258,13306956,0.0
WA02,5p,5,->A,0,0,0,6552698,6754258,13306956,0.0
WA02,5p,6,->A,0,0,0,6552697,6754258,13306955,0.0
WA02,5p,7,->A,0,0,0,6552685,6754258,13306943,0.0
WA02,5p,8,->A,25,0,25,6552655,6754257,13306912,1.8787228772535657e-06
WA02,5p,9,->A,16,7,23,6552662,6754226,13306888,1.7284281644213133e-06
WA02,5p,10,->A,31,10,41,6552618,6754222,13306840,3.0811221897911147e-06
WA02,5p,11,->A,20,9,29,6552625,6754225,13306850,2.1793286916137178e-06
WA02,5p,12,->A,14,6,20,6552628,6754236,13306864,1.5029837232874705e-06
WA02,5p,13,->A,33,8,41,6552614,6754205,13306819,3.081127052227884e-06
WA02,5p,14,->A,29,26,55,6552607,6754183,13306790,4.133228224087102e-06
WA02,5p,15,->A,43,27,70,6552586,6754168,13306754,5.260486516847009e-06
WA02,5p,16,->A,47,15,62,6552525,6754178,13306703,4.659305915221824e-06
WA02,5p,17,->A,40,34,74,6552567,6754148,13306715,5.561102045095277e-06
WA02,5p,18,->A,62,47,109,6552548,6754087,13306635,8.191402259098562e-06
WA02,5p,19,->A,78,38,116,6552516,6754124,13306640,8.717452339583846e-06
WA02,5p,20,->A,80,40,120,6552507,6754132,13306639,9.018054822107971e-06
WA02,5p,21,->A,77,32,109,6552521,6754152,13306673,8.191378866828696e-06
WA02,5p,22,->A,54,49,103,6552516,6754117,13306633,7.74050054585559e-06
WA02,5p,23,->A,102,31,133,6552465,6754131,13306596,9.995043059847912e-06
WA02,5p,24,->A,89,24,113,6552457,6754135,13306592,8.492031618614293e-06
WA02,5p,25,->A,87,57,144,6552470,6754083,13306553,1.0821735726750571e-05
WA03,3p,1,->A,0,0,0,5399458,5543742,10943200,0.0
WA03,3p,2,->A,0,0,0,5399458,5543742,10943200,0.0
WA03,3p,3,->A,0,0,0,5399458,5543742,10943200,0.0
WA03,3p,4,->A,0,2,2,5399458,5543736,10943194,1.8276199800533562e-07
WA03,3p,5,->A,0,0,0,5399458,5543740,10943198,0.0
WA03,3p,6,->A,0,0,0,5399458,5543741,10943199,0.0
WA03,3p,7,->A,0,0,0,5399458,5543739,10943197,0.0
WA03,3p,8,->A,3,19,22,5399449,5543673,10943122,2.0103952053170933e-06
WA03,3p,9,->A,5,15,20,5399436,5543670,10943106,1.827634677028624e-06
WA03,3p,10,->A,8,31,39,5399438,5543654,10943092,3.5638921796508703e-06
WA03,3p,11,->A,25,44,69,5399404,5543644,10943048,6.3053730551122505e-06
WA03,3p,12,->A,26,53,79,5399397,5543595,10942992,7.219232180741794e-06
WA03,3p,13,->A,23,63,86,5399378,5543551,10942929,7.858956226436268e-06
WA03,3p,14,->A,47,70,117,5399356,5543493,10942849,1.06919139613459e-05
WA03,3p,15,->A,32,59,91,5399349,5543505,10942854,8.315929281337391e-06
WA03,3p,16,->A,33,71,104,5399342,5543495,10942837,9.503933943272664e-06
WA03,3p,17,->A,41,101,142,5399346,5543438,10942784,1.297658804194618e-05
WA03,3p,18,->A,30,93,123,5399325,5543443,10942768,1.1240300443178544e-05
WA03,3p,19,->A,42,79,121,5399297,5543425,10942722,1.1057577812906148e-05
WA03,3p,20,->A,72,90,162,5399252,5543409,10942661,1.4804442904701153e-05
WA03,3p,21,->A,59,130,189,5399248,5543303,10942551,1.7272023680766942e-05
WA03,3p,22,->A,62,136,198,5399256,5543263,10942519,1.8094553913957108e-05
WA03,3p,23,->A,61,141,202,5399255,5543267,10942522,1.846009539665536e-05
WA03,3p,24,->A,73,106,179,5399198,5543130,10942328,1.635849336631108e-05
WA03,3p,25,->A,96,126,222,5399050,5543142,10942192,2.0288439464414443e-05
WA03,5p,1,->A,0,0,0,5399457,5543742,10943199,0.0
WA03,5p,2,->A,0,0,0,5399258,5543638,10942896,0.0
WA03,5p,3,->A,0,0,0,5399457,5543742,10943199,0.0
WA03,5p,4,->A,0,0,0,5399458,5543742,10943200,0.0
WA03,5p,5,->A,0,0,0,5399456,5543740,10943196,0.0
WA03,5p,6,->A,0,0,0,5399452,5543742,10943194,0.0
WA03,5p,7,->A,0,0,0,5399453,5543742,10943195,0.0
WA03,5p,8,->A,20,0,20,5399403,5543732,10943135,1.827629833681116e-06
WA03,5p,9,->A,35,2,37,5399319,5543732,10943051,3.3811411461026728e-06
WA03,5p,10,->A,43,11,54,5399344,5543717,10943061,4.934633920070445e-06
WA03,5p,11,->A,29,11,40,5399321,5543705,10943026,3.655296076240704e-06
WA03,5p,12,->A,63,12,75,5399213,5543665,10942878,6.853772837456472e-06
WA03,5p,13,->A,84,14,98,5399156,5543662,10942818,8.955645611578297e-06
WA03,5p,14,->A,77,19,96,5399124,5543629,10942753,8.772929444720173e-06
WA03,5p,15,->A,95,31,126,5399092,5543505,10942597,1.1514634048937375e-05
WA03,5p,16,->A,98,40,138,5399083,5543501,10942584,1.2611280845547998e-05
WA03,5p,17,->A,91,35,126,5399113,5543491,10942604,1.1514626683008908e-05
WA03,5p,18,->A,107,28,135,5399074,5543600,10942674,1.23370210974027e-05
WA03,5p,19,->A,104,46,150,5399071,5543546,10942617,1.3707872623157695e-05
WA03,5p,20,->A,112,54,166,5399050,5543533,10942583,1.5170092838226588e-05
WA03,5p,21,->A,106,49,155,5399034,5543509,10942543,1.4164897501430885e-05
WA03,5p,22,->A,134,64,198,5398989,5543454,10942443,1.809467958846119e-05
WA03,5p,23,->A,142,62,204,5398935,5543457,10942392,1.864309010315112e-05
WA03,5p,24,->A,114,82,196,5398952,5543428,10942380,1.7912008173724546e-05
WA03,5p,25,->A,152,64,216,5398991,5543444,10942435,1.973966489177226e-05
WA07,3p,1,->A,0,0,0,5691729,6013979,11705708,0.0
WA07,3p,2,->A,0,0,0,5691729,6013979,11705708,0.0
WA07,3p,3,->A,0,0,0,5691729,6013979,11705708,0.0
WA07,3p,4,->A,0,0,0,5691729,6013979,11705708,0.0
WA07,3p,5,->A,0,0,0,5691729,6013979,11705708,0.0
WA07,3p,6,->A,0,0,0,5691729,6013979,11705708,0.0
WA07,3p,7,->A,0,0,0,5691729,6013979,11705708,0.0
WA07,3p,8,->A,1,22,23,5691713,6013800,11705513,1.964886118190634e-06
WA07,3p,9,->A,3,7,10,5691720,6013901,11705621,8.542904302129721e-07
WA07,3p,10,->A,0,18,18,5691718,6013892,11705610,1.537724219412743e-06
WA07,3p,11,->A,6,14,20,5691711,6013883,11705594,1.7085848014205858e-06
WA07,3p,12,->A,9,8,17,5691705,6013884,11705589,1.452297701550943e-06
WA07,3p,13,->A,4,8,12,5691711,6013848,11705559,1.0251539460866417e-06
WA07,3p,14,->A,17,11,28,5691695,6013877,11705572,2.3920232176607856e-06
WA07,3p,15,->A,18,30,48,5691211,6013856,11705067,4.100788145851707e-06
WA07,3p,16,->A,40,17,57,5691636,6013850,11705486,4.869511611905734e-06
WA07,3p,17,->A,31,40,71,5691662,6013813,11705475,6.065537707782042e-06
WA07,3p,18,->A,35,43,78,5691639,6013769,11705408,6.663586608856351e-06
WA07,3p,19,->A,53,42,95,5691628,6013742,11705370,8.115933114459432e-06
WA07,3p,20,->A,55,50,105,5691604,6013772,11705376,8.970237265338594e-06
WA07,3p,21,->A,34,39,73,5691611,6013735,11705346,6.236466653783664e-06
WA07,3p,22,->A,66,85,151,5691577,6013736,11705313,1.2900124926176686e-05
WA07,3p,23,->A,56,80,136,5691568,6013670,11705238,1.161873000788194e-05
WA07,3p,24,->A,68,104,172,5691554,6013661,11705215,1.4694305059753282e-05
WA07,3p,25,->A,101,57,158,5691455,6013662,11705117,1.3498369986391422e-05
WA07,5p,1,->A,0,0,0,5691729,6013979,11705708,0.0
WA07,5p,2,->A,0,0,0,5691636,6013923,11705559,0.0
WA07,5p,3,->A,0,0,0,5691729,6013979,11705708,0.0
WA07,5p,4,->A,1,0,1,5691728,6013979,11705707,8.54284153874687e-08
WA07,5p,5,->A,0,0,0,5691729,6013978,11705707,0.0
WA07,5p,6,->A,0,0,0,5691728,6013979,11705707,0.0
WA07,5p,7,->A,0,0,0,5691728,6013979,11705707,0.0
WA07,5p,8,->A,28,0,28,5691579,6013975,11705554,2.392026895950418e-06
WA07,5p,9,->A,34,4,38,5691672,6013971,11705643,3.2462975335912773e-06
WA07,5p,10,->A,47,10,57,5691582,6013961,11705543,4.8694878998778615e-06
WA07,5p,11,->A,18,26,44,5691326,6013942,11705268,3.758991250777e-06
WA07,5p,12,->A,49,16,65,5691520,6013938,11705458,5.552965121057203e-06
WA07,5p,13,->A,56,11,67,5691511,6013949,11705460,5.7238246083451656e-06
WA07,5p,14,->A,56,10,66,5691556,6013950,11705506,5.63837223269118e-06
WA07,5p,15,->A,67,327,394,5691563,6013633,11705196,3.3660265065189856e-05
WA07,5p,16,->A,81,18,99,5691534,6013925,11705459,8.4575923079992e-06
WA07,5p,17,->A,58,21,79,5691561,6013916,11705477,6.7489774231327775e-06
WA07,5p,18,->A,85,8,93,5691474,6013905,11705379,7.945065255896455e-06
WA07,5p,19,->A,100,31,131,5691482,6013884,11705366,1.1191448434846036e-05
WA07,5p,20,->A,120,28,148,5691421,6013876,11705297,1.2643848336355754e-05
WA07,5p,21,->A,136,30,166,5691379,6013853,11705232,1.4181692426087752e-05
WA07,5p,22,->A,110,21,131,5691396,6013861,11705257,1.1191552650232284e-05
WA07,5p,23,->A,139,57,196,5691314,6013795,11705109,1.6744824845287644e-05
WA07,5p,24,->A,168,40,208,5691332,6013785,11705117,1.7770006058034277e-05
WA07,5p,25,->A,124,70,194,5691334,6013719,11705053,1.6574038579748423e-05
WA08,3p,1,->A,0,0,0,6798117,7189085,13987202,0.0
WA08,3p,2,->A,0,0,0,6798117,7189085,13987202,0.0
WA08,3p,3,->A,0,0,0,6798117,7189085,13987202,0.0
WA08,3p,4,->A,0,0,0,6798117,7189081,13987198,0.0
WA08,3p,5,->A,0,0,0,6798117,7189085,13987202,0.0
WA08,3p,6,->A,0,0,0,6798117,7189085,13987202,0.0
WA08,3p,7,->A,0,0,0,6798117,7189084,13987201,0.0
WA08,3p,8,->A,0,2,2,6798110,7189053,13987163,1.4298825287157948e-07
WA08,3p,9,->A,7,2,9,6798103,7189051,13987154,6.434475519465933e-07
WA08,3p,10,->A,20,6,26,6798074,7189042,13987116,1.8588535334946816e-06
WA08,3p,11,->A,4,7,11,6798109,7189046,13987155,7.864358405980344e-07
WA08,3p,12,->A,8,15,23,6798091,7189018,13987109,1.6443712564190357e-06
WA08,3p,13,->A,9,26,35,6798090,7189013,13987103,2.502305159259927e-06
WA08,3p,14,->A,14,30,44,6798067,7188981,13987048,3.145767427122578e-06
WA08,3p,15,->A,12,17,29,6798069,7188978,13987047,2.0733468615641317e-06
WA08,3p,16,->A,24,49,73,6798049,7188961,13987010,5.219128319776707e-06
WA08,3p,17,->A,27,75,102,6798000,7188943,13986943,7.292515598297641e-06
WA08,3p,18,->A,21,64,85,6798023,7188956,13986979,6.077080690547973e-06
WA08,3p,19,->A,44,35,79,6798028,7188946,13986974,5.648112307923072e-06
WA08,3p,20,->A,28,52,80,6798009,7188917,13986926,5.719627028841076e-06
WA08,3p,21,->A,40,18,58,6798010,7188926,13986936,4.146726631193565e-06
WA08,3p,22,->A,28,35,63,6798012,7188920,13986932,4.504204353034676e-06
WA08,3p,23,->A,26,51,77,6798009,7188864,13986873,5.505161875710175e-06
WA08,3p,24,->A,35,58,93,6798015,7188867,13986882,6.649087337692561e-06
WA08,3p,25,->A,52,47,99,6797966,7188892,13986858,7.078072859537146e-06
WA08,5p,1,->A,0,0,0,6798116,7189085,13987201,0.0
WA08,5p,2,->A,0,0,0,6797941,7188997,13986938,0.0
WA08,5p,3,->A,0,0,0,6798117,7189084,13987201,0.0
WA08,5p,4,->A,1,0,1,6798115,7189085,13987200,7.149393731411576e-08
WA08,5p,5,->A,0,0,0,6798116,7189084,13987200,0.0
WA08,5p,6,->A,4,0,4,6798112,7189085,13987197,2.8597581059307306e-07
WA08,5p,7,->A,2,0,2,6798110,7189085,13987195,1.429879257420805e-07
WA08,5p,8,->A,22,3,25,6798069,7189064,13987133,1.7873569944605518e-06
WA08,5p,9,->A,21,8,29,6798054,7189067,13987121,2.0733358923541164e-06
WA08,5p,10,->A,40,13,53,6798015,7189037,13987052,3.789218771761197e-06
WA08,5p,11,->A,9,21,30,6797997,7189047,13987044,2.1448420409630517e-06
WA08,5p,12,->A,21,13,34,6798016,7189056,13987072,2.4308161136226365e-06
WA08,5p,13,->A,48,18,66,6797995,7189043,13987038,4.718654514272429e-06
WA08,5p,14,->A,45,14,59,6797984,7189041,13987025,4.218195077223355e-06
WA08,5p,15,->A,46,19,65,6797997,7189013,13987010,4.647169051855972e-06
WA08,5p,16,->A,27,15,42,6797921,7188997,13986918,3.002805907634548e-06
WA08,5p,17,->A,50,42,92,6797959,7188875,13986834,6.577614347893168e-06
WA08,5p,18,->A,54,23,77,6797991,7188972,13986963,5.505126452397136e-06
WA08,5p,19,->A,56,23,79,6797966,7188988,13986954,5.648120384180859e-06
WA08,5p,20,->A,57,26,83,6797883,7188971,13986854,5.934143589401877e-06
WA08,5p,21,->A,84,34,118,6797885,7188979,13986864,8.43648726405004e-06
WA08,5p,22,->A,62,19,81,6797887,7188939,13986826,5.79116377082263e-06
WA08,5p,23,->A,87,53,140,6797851,7188919,13986770,1.0009458938697069e-05
WA08,5p,24,->A,76,50,126,6797841,7188876,13986717,9.00854718087168e-06
WA08,5p,25,->A,71,90,161,6797835,7188817,13986652,1.151097489234736e-05
WA09,3p,1,->A,0,0,0,4741672,4881751,9623423,0.0
WA09,3p,2,->A,0,0,0,4741672,4881751,9623423,0.0
WA09,3p,3,->A,0,0,0,4741672,4881751,9623423,0.0
WA09,3p,4,->A,0,0,0,4741672,4881748,9623420,0.0
WA09,3p,5,->A,0,0,0,4741672,4881751,9623423,0.0
WA09,3p,6,->A,0,0,0,4741672,4881751,9623423,0.0
WA09,3p,7,->A,0,0,0,4741672,4881748,9623420,0.0
WA09,3p,8,->A,0,13,13,4741663,4881718,9623381,1.350876578616185e-06
WA09,3p,9,->A,0,13,13,4741664,4881723,9623387,1.3508757363701571e-06
WA09,3p,10,->A,8,13,21,4741658,4881705,9623363,2.182189324043996e-06
WA09,3p,11,->A,4,13,17,4741648,4881712,9623360,1.7665347654041831e-06
WA09,3p,12,->A,13,28,41,4741642,4881680,9623322,4.260483022390812e-06
WA09,3p,13,->A,13,16,29,4741628,4881645,9623273,3.013527725961843e-06
WA09,3p,14,->A,26,45,71,4741616,4881571,9623187,7.37801312600493e-06
WA09,3p,15,->A,23,19,42,4741598,4881557,9623155,4.364472982093711e-06
WA09,3p,16,->A,32,56,88,4741586,4881546,9623132,9.144631914017182e-06
WA09,3p,17,->A,38,32,70,4741582,4881528,9623110,7.27415565238265e-06
WA09,3p,18,->A,42,39,81,4741560,4881490,9623050,8.417289736621965e-06
WA09,3p,19,->A,38,89,127,4741552,4881442,9622994,1.3197555771104086e-05
WA09,3p,20,->A,38,49,87,4741534,4881501,9623035,9.040806772499528e-06
WA09,3p,21,->A,56,48,104,4741546,4881493,9623039,1.0807396707007008e-05
WA09,3p,22,->A,53,43,96,4741524,4881498,9623022,9.976076122448852e-06
WA09,3p,23,->A,55,51,106,4741501,4881486,9622987,1.1015290782373498e-05
WA09,3p,24,->A,54,68,122,4741491,4881450,9622941,1.2678036787298186e-05
WA09,3p,25,->A,70,64,134,4741451,4881469,9622920,1.3925087187672764e-05
WA09,5p,1,->A,0,0,0,4741672,4881751,9623423,0.0
WA09,5p,2,->A,0,0,0,4741495,4881667,9623162,0.0
WA09,5p,3,->A,0,0,0,4741672,4881750,9623422,0.0
WA09,5p,4,->A,0,0,0,4741672,4881751,9623423,0.0
WA09,5p,5,->A,1,0,1,4741671,4881751,9623422,1.0391314025302019e-07
WA09,5p,6,->A,1,0,1,4741669,4881751,9623420,1.0391316184890613e-07
WA09,5p,7,->A,2,0,2,4741667,4881751,9623418,2.0782636688960202e-07
WA09,5p,8,->A,19,0,19,4741639,4881744,9623383,1.974357666113881e-06
WA09,5p,9,->A,24,2,26,4741618,4881747,9623365,2.701757649221452e-06
WA09,5p,10,->A,26,5,31,4741622,4881737,9623359,3.221328436359903e-06
WA09,5p,11,->A,12,12,24,4741614,4881733,9623347,2.493934802517253e-06
WA09,5p,12,->A,25,5,30,4741580,4881734,9623314,3.117429193311161e-06
WA09,5p,13,->A,62,16,78,4741530,4881708,9623238,8.105379914743873e-06
WA09,5p,14,->A,65,16,81,4741498,4881705,9623203,8.417155909524095e-06
WA09,5p,15,->A,76,26,102,4741496,4881672,9623168,1.059942006624014e-05
WA09,5p,16,->A,60,22,82,4741451,4881636,9623087,8.521174130505107e-06
WA09,5p,17,->A,81,24,105,4741476,4881638,9623114,1.0911228943146678e-05
WA09,5p,18,->A,81,31,112,4741455,4881610,9623065,1.1638703469216928e-05
WA09,5p,19,->A,110,46,156,4741379,4881580,9622959,1.6211229830658117e-05
WA09,5p,20,->A,119,52,171,4741390,4881557,9622947,1.777002408929406e-05
WA09,5p,21,->A,107,51,158,4741379,4881587,9622966,1.6419054166875368e-05
WA09,5p,22,->A,108,40,148,4741354,4881580,9622934,1.5379924667466283e-05
WA09,5p,23,->A,119,46,165,4741312,4881565,9622877,1.714663920156103e-05
WA09,5p,24,->A,129,47,176,4741363,4881548,9622911,1.828968385969693e-05
WA09,5p,25,->A,142,50,192,4741301,4881503,9622804,1.9952604251318016e-05
WA11,3p,1,->A,0,0,0,9756642,10108269,19864911,0.0
WA11,3p,2,->A,0,0,0,9756642,10108269,19864911,0.0
WA11,3p,3,->A,0,0,0,9756642,10108269,19864911,0.0
WA11,3p,4,->A,0,0,0,9756642,10108267,19864909,0.0
WA11,3p,5,->A,0,0,0,9756642,10108269,19864911,0.0
WA11,3p,6,->A,0,0,0,9756642,10108269,19864911,0.0
WA11,3p,7,->A,0,0,0,9756642,10108265,19864907,0.0
WA11,3p,8,->A,8,41,49,9756629,10108160,19864789,2.466676087020104e-06
WA11,3p,9,->A,12,28,40,9756610,10108092,19864702,2.0136219511372483e-06
WA11,3p,10,->A,14,62,76,9756615,10107969,19864584,3.825904433739967e-06
WA11,3p,11,->A,22,31,53,9756587,10107918,19864505,2.668075544797114e-06
WA11,3p,12,->A,26,60,86,9756581,10108019,19864600,4.329309424805936e-06
WA11,3p,13,->A,21,54,75,9756565,10107963,19864528,3.7755742296016296e-06
WA11,3p,14,->A,36,48,84,9756515,10107914,19864429,4.228664211792849e-06
WA11,3p,15,->A,72,57,129,9756471,10107972,19864443,6.494015462703887e-06
WA11,3p,16,->A,68,77,145,9756477,10108011,19864488,7.299458209041179e-06
WA11,3p,17,->A,52,43,95,9756469,10108044,19864513,4.782397635421518e-06
WA11,3p,18,->A,75,72,147,9756421,10108016,19864437,7.400159390371849e-06
WA11,3p,19,->A,68,73,141,9756438,10108000,19864438,7.09811171098825e-06
WA11,3p,20,->A,92,90,182,9756433,10107963,19864396,9.162121012891608e-06
WA11,3p,21,->A,76,63,139,9756421,10107904,19864325,6.9974690808774025e-06
WA11,3p,22,->A,89,96,185,9756405,10107842,19864247,9.313214842727236e-06
WA11,3p,23,->A,99,132,231,9756375,10107816,19864191,1.162896591157425e-05
WA11,3p,24,->A,100,143,243,9756358,10107704,19864062,1.2233147480107544e-05
WA11,3p,25,->A,128,163,291,9756281,10107693,19863974,1.464963657322548e-05
WA11,5p,1,->A,0,0,0,9756641,10108269,19864910,0.0
WA11,5p,2,->A,0,0,0,9756471,10108196,19864667,0.0
WA11,5p,3,->A,0,0,0,9756642,10108269,19864911,0.0
WA11,5p,4,->A,4,0,4,9756638,10108269,19864907,2.013601171150713e-07
WA11,5p,5,->A,2,0,2,9756638,10108267,19864905,1.006800686940109e-07
WA11,5p,6,->A,0,0,0,9756642,10108269,19864911,0.0
WA11,5p,7,->A,5,0,5,9756629,10108269,19864898,2.517002604292255e-07
WA11,5p,8,->A,56,1,57,9756500,10108261,19864761,2.869402757979318e-06
WA11,5p,9,->A,78,2,80,9756493,10108240,19864733,4.027237617540593e-06
WA11,5p,10,->A,93,11,104,9756446,10108197,19864643,5.235432622675374e-06
WA11,5p,11,->A,46,9,55,9756457,10108195,19864652,2.768737151801099e-06
WA11,5p,12,->A,61,26,87,9756411,10108221,19864632,4.379643176878384e-06
WA11,5p,13,->A,105,20,125,9756334,10108178,19864512,6.292628784437292e-06
WA11,5p,14,->A,116,27,143,9756261,10108167,19864428,7.1987977705675694e-06
WA11,5p,15,->A,175,51,226,9756237,10108096,19864333,1.1377175362495182e-05
WA11,5p,16,->A,117,38,155,9756275,10108079,19864354,7.80292175622726e-06
WA11,5p,17,->A,80,43,123,9756369,10108078,19864447,6.19196698503613e-06
WA11,5p,18,->A,111,47,158,9756327,10108075,19864402,7.953926828504579e-06
WA11,5p,19,->A,132,36,168,9756284,10108088,19864372,8.457352691542426e-06
WA11,5p,20,->A,130,47,177,9756292,10108082,19864374,8.910424260034572e-06
WA11,5p,21,->A,147,61,208,9756251,10108036,19864287,1.0471052900111644e-05
WA11,5p,22,->A,148,61,209,9756136,10108029,19864165,1.0521459119978113e-05
WA11,5p,23,->A,140,67,207,9756095,10108016,19864111,1.0420803629218544e-05
WA11,5p,24,->A,171,65,236,9756046,10108010,19864056,1.1880755873825568e-05
WA11,5p,25,->A,181,76,257,9756056,10107943,19863999,1.2937978903442352e-05
WA12,3p,1,->A,0,0,0,6632243,6940679,13572922,0.0
WA12,3p,2,->A,0,0,0,6632243,6940679,13572922,0.0
WA12,3p,3,->A,0,0,0,6632243,6940679,13572922,0.0
WA12,3p,4,->A,0,0,0,6632243,6940676,13572919,0.0
WA12,3p,5,->A,0,0,0,6632243,6940678,13572921,0.0
WA12,3p,6,->A,0,0,0,6632243,6940679,13572922,0.0
WA12,3p,7,->A,0,1,1,6632243,6940676,13572919,7.367611933733636e-08
WA12,3p,8,->A,2,4,6,6632240,6940664,13572904,4.420572045599085e-07
WA12,3p,9,->A,4,3,7,6632231,6940656,13572887,5.157340512744268e-07
WA12,3p,10,->A,4,4,8,6632228,6940644,13572872,5.894109956978892e-07
WA12,3p,11,->A,6,12,18,6632231,6940642,13572873,1.326174642612511e-06
WA12,3p,12,->A,4,17,21,6632223,6940615,13572838,1.5472077394572896e-06
WA12,3p,13,->A,13,16,29,6632204,6940591,13572795,2.1366269806624205e-06
WA12,3p,14,->A,7,32,39,6632209,6940533,13572742,2.8734061253061465e-06
WA12,3p,15,->A,17,35,52,6632188,6940474,13572662,3.831230748986455e-06
WA12,3p,16,->A,16,26,42,6632187,6940478,13572665,3.0944549209753573e-06
WA12,3p,17,->A,20,51,71,6632168,6940473,13572641,5.231111616375914e-06
WA12,3p,18,->A,33,41,74,6632160,6940482,13572642,5.452144099873849e-06
WA12,3p,19,->A,35,34,69,6632121,6940435,13572556,5.083788197300494e-06
WA12,3p,20,->A,45,32,77,6632105,6940432,13572537,5.673220857677529e-06
WA12,3p,21,->A,51,45,96,6632096,6940454,13572550,7.0730997491259935e-06
WA12,3p,22,->A,43,36,79,6632039,6940438,13572477,5.820602974681777e-06
WA12,3p,23,->A,101,36,137,6631950,6940459,13572409,1.0094007629743547e-05
WA12,3p,24,->A,54,39,93,6631933,6940411,13572344,6.852169382090522e-06
WA12,3p,25,->A,57,42,99,6631986,6940428,13572414,7.294207205880988e-06
WA12,5p,1,->A,0,0,0,6632243,6940679,13572922,0.0
WA12,5p,2,->A,0,0,0,6631949,6940524,13572473,0.0
WA12,5p,3,->A,0,0,0,6632242,6940678,13572920,0.0
WA12,5p,4,->A,0,0,0,6632242,6940679,13572921,0.0
WA12,5p,5,->A,1,0,1,6632242,6940677,13572919,7.367611933733636e-08
WA12,5p,6,->A,0,0,0,6632242,6940679,13572921,0.0
WA12,5p,7,->A,1,0,1,6632238,6940679,13572917,7.367613019367907e-08
WA12,5p,8,->A,14,2,16,6632204,6940670,13572874,1.178821817693143e-06
WA12,5p,9,->A,16,1,17,6632209,6940675,13572884,1.25249725850453e-06
WA12,5p,10,->A,15,8,23,6632199,6940665,13572864,1.6945576114223204e-06
WA12,5p,11,->A,14,6,20,6632166,6940667,13572833,1.4735317232592488e-06
WA12,5p,12,->A,36,6,42,6632126,6940660,13572786,3.0944273342260018e-06
WA12,5p,13,->A,68,4,72,6632065,6940658,13572723,5.304757195737362e-06
WA12,5p,14,->A,90,13,103,6632026,6940638,13572664,7.588782865324007e-06
WA12,5p,15,->A,83,17,100,6631987,6940631,13572618,7.367775325290964e-06
WA12,5p,16,->A,82,12,94,6631930,6940590,13572520,6.925758812659698e-06
WA12,5p,17,->A,66,11,77,6631958,6940621,13572579,5.673203302040091e-06
WA12,5p,18,->A,72,23,95,6632019,6940577,13572596,6.999397904424474e-06
WA12,5p,19,->A,65,31,96,6631996,6940532,13572528,7.073111214064174e-06
WA12,5p,20,->A,76,35,111,6631973,6940532,13572505,8.178298700203095e-06
WA12,5p,21,->A,116,35,151,6631936,6940534,13572470,1.1125462056648494e-05
WA12,5p,22,->A,93,30,123,6631921,6940529,13572450,9.062475824187967e-06
WA12,5p,23,->A,87,26,113,6631926,6940534,13572460,8.325683037562829e-06
WA12,5p,24,->A,92,35,127,6631934,6940518,13572452,9.357189106286764e-06
WA12,5p,25,->A,89,15,104,6631933,6940515,13572448,7.662582313816933e-06
WA13,3p,1,->A,0,0,0,5896847,6081528,11978375,0.0
WA13,3p,2,->A,0,0,0,5896847,6081528,11978375,0.0
WA13,3p,3,->A,0,0,0,5896847,6081528,11978375,0.0
WA13,3p,4,->A,0,0,0,5896847,6081522,11978369,0.0
WA13,3p,5,->A,0,0,0,5896847,6081527,11978374,0.0
WA13,3p,6,->A,0,0,0,5896847,6081528,11978375,0.0
WA13,3p,7,->A,0,0,0,5896847,6081528,11978375,0.0
WA13,3p,8,->A,0,0,0,5896845,6081521,11978366,0.0
WA13,3p,9,->A,1,2,3,5896842,6081517,11978359,2.504516687135525e-07
WA13,3p,10,->A,2,4,6,5896843,6081517,11978360,5.009032956097496e-07
WA13,3p,11,->A,3,2,5,5896841,6081492,11978333,4.174203539006638e-07
WA13,3p,12,->A,0,3,3,5896836,6081505,11978341,2.504520450703483e-07
WA13,3p,13,->A,9,0,9,5896834,6081495,11978329,7.513568879265213e-07
WA13,3p,14,->A,4,4,8,5896832,6081501,11978333,6.678725662410621e-07
WA13,3p,15,->A,5,7,12,5896825,6081505,11978330,1.0018091002668989e-06
WA13,3p,16,->A,10,4,14,5896830,6081509,11978339,1.1687764054765856e-06
WA13,3p,17,->A,10,12,22,5896823,6081499,11978322,1.836651243805268e-06
WA13,3p,18,->A,10,4,14,5896827,6081499,11978326,1.168777673942085e-06
WA13,3p,19,->A,11,5,16,5896822,6081480,11978302,1.3357485894077474e-06
WA13,3p,20,->A,8,18,26,5896818,6081448,11978266,2.1705979813772712e-06
WA13,3p,21,->A,11,10,21,5896824,6081466,11978290,1.7531717799452176e-06
WA13,3p,22,->A,7,18,25,5896824,6081460,11978284,2.087110307286085e-06
WA13,3p,23,->A,13,5,18,5896819,6081454,11978273,1.5027208012373738e-06
WA13,3p,24,->A,14,21,35,5896803,6081440,11978243,2.9219644316783357e-06
WA13,3p,25,->A,31,16,47,5896783,6081437,11978220,3.92378834250832e-06
WA13,5p,1,->A,0,0,0,5896847,6081528,11978375,0.0
WA13,5p,2,->A,0,0,0,5896725,6081443,11978168,0.0
WA13,5p,3,->A,0,0,0,5896847,6081528,11978375,0.0
WA13,5p,4,->A,0,0,0,5896841,6081528,11978369,0.0
WA13,5p,5,->A,6,0,6,5896841,6081528,11978369,5.00902919253865e-07
WA13,5p,6,->A,6,0,6,5896841,6081528,11978369,5.00902919253865e-07
WA13,5p,7,->A,0,0,0,5896845,6081528,11978373,0.0
WA13,5p,8,->A,4,0,4,5896843,6081526,11978369,3.339352795025767e-07
WA13,5p,9,->A,3,6,9,5896837,6081518,11978355,7.513552570448947e-07
WA13,5p,10,->A,10,2,12,5896833,6081518,11978351,1.0018073439323994e-06
WA13,5p,11,->A,2,8,10,5896827,6081513,11978340,8.348402199303075e-07
WA13,5p,12,->A,8,12,20,5896822,6081502,11978324,1.669682670129811e-06
WA13,5p,13,->A,17,0,17,5896809,6081508,11978317,1.4192310989932891e-06
WA13,5p,14,->A,20,1,21,5896802,6081520,11978322,1.7531670963595736e-06
WA13,5p,15,->A,23,2,25,5896798,6081508,11978306,2.0871064739872232e-06
WA13,5p,16,->A,16,2,18,5896754,6081491,11978245,1.502724313954173e-06
WA13,5p,17,->A,10,0,10,5896805,6081514,11978319,8.348416835450785e-07
WA13,5p,18,->A,18,2,20,5896796,6081504,11978300,1.6696860155447767e-06
WA13,5p,19,->A,22,13,35,5896797,6081472,11978269,2.921958089269827e-06
WA13,5p,20,->A,16,22,38,5896788,6081482,11978270,3.1724113749314384e-06
WA13,5p,21,->A,28,8,36,5896782,6081484,11978266,3.005443358830068e-06
WA13,5p,22,->A,34,19,53,5896771,6081483,11978254,4.424684933213138e-06
WA13,5p,23,->A,20,8,28,5896768,6081501,11978269,2.3375664714158613e-06
WA13,5p,24,->A,17,1,18,5896781,6081498,11978279,1.502720048514482e-06
WA13,5p,25,->A,27,17,44,5896769,6081462,11978231,3.673330394112453e-06
WA14,3p,1,->A,0,0,0,6684341,7140972,13825313,0.0
WA14,3p,2,->A,0,0,0,6684341,7140972,13825313,0.0
WA14,3p,3,->A,0,0,0,6684341,7140972,13825313,0.0
WA14,3p,4,->A,0,0,0,6684341,7140971,13825312,0.0
WA14,3p,5,->A,0,0,0,6684341,7140970,13825311,0.0
WA14,3p,6,->A,0,0,0,6684341,7140971,13825312,0.0
WA14,3p,7,->A,0,1,1,6684341,7140969,13825310,7.233110866953437e-08
WA14,3p,8,->A,5,12,17,6684326,7140932,13825258,1.229633472301204e-06
WA14,3p,9,->A,5,10,15,6684323,7140920,13825243,1.084971888016724e-06
WA14,3p,10,->A,10,8,18,6684256,7140912,13825168,1.3019733286423716e-06
WA14,3p,11,->A,7,27,34,6684256,7140894,13825150,2.45928615602724e-06
WA14,3p,12,->A,10,21,31,6684291,7140849,13825140,2.242291940624109e-06
WA14,3p,13,->A,22,40,62,6684289,7140794,13825083,4.484602370922475e-06
WA14,3p,14,->A,20,26,46,6684291,7140742,13825033,3.3272976635932805e-06
WA14,3p,15,->A,20,45,65,6684271,7140702,13824973,4.701636668657508e-06
WA14,3p,16,->A,22,34,56,6684263,7140648,13824911,4.050658987967445e-06
WA14,3p,17,->A,61,45,106,6684212,7140653,13824865,7.667344310414604e-06
WA14,3p,18,->A,44,42,86,6684177,7140647,13824824,6.220694021131842e-06
WA14,3p,19,->A,44,31,75,6684172,7140542,13824714,5.425067021277981e-06
WA14,3p,20,->A,47,46,93,6684176,7140544,13824720,6.727080186795827e-06
WA14,3p,21,->A,65,39,104,6684132,7140443,13824575,7.522835240866356e-06
WA14,3p,22,->A,83,46,129,6684105,7140560,13824665,9.331148349706848e-06
WA14,3p,23,->A,513,57,570,6683638,7140562,13824200,4.1232042360498255e-05
WA14,3p,24,->A,93,99,192,6683623,7140532,13824155,1.388873316307579e-05
WA14,3p,25,->A,92,73,165,6683613,7140513,13824126,1.193565510036584e-05
WA14,5p,1,->A,0,0,0,6684341,7140972,13825313,0.0
WA14,5p,2,->A,0,0,0,6684184,7140911,13825095,0.0
WA14,5p,3,->A,0,0,0,6684338,7140972,13825310,0.0
WA14,5p,4,->A,0,0,0,6684341,7140972,13825313,0.0
WA14,5p,5,->A,0,0,0,6684341,7140972,13825313,0.0
WA14,5p,6,->A,0,0,0,6684340,7140972,13825312,0.0
WA14,5p,7,->A,0,0,0,6684336,7140972,13825308,0.0
WA14,5p,8,->A,28,2,30,6684277,7140970,13825247,2.169943148212831e-06
WA14,5p,9,->A,66,11,77,6684241,7140959,13825200,5.569539681161936e-06
WA14,5p,10,->A,79,332,411,6684210,7140628,13824838,2.9729100623095908e-05
WA14,5p,11,->A,50,315,365,6684218,7140646,13824864,2.6401706374833053e-05
WA14,5p,12,->A,71,42,113,6684139,7140917,13825056,8.173565445232193e-06
WA14,5p,13,->A,98,22,120,6684018,7140931,13824949,8.679959687373892e-06
WA14,5p,14,->A,140,7,147,6683951,7140942,13824893,1.063299368754608e-05
WA14,5p,15,->A,102,20,122,6684030,7140908,13824938,8.824632703596935e-06
WA14,5p,16,->A,207,17,224,6683910,7140868,13824778,1.6202791827832606e-05
WA14,5p,17,->A,136,24,160,6683904,7140873,13824777,1.157342357131692e-05
WA14,5p,18,->A,209,44,253,6683891,7140646,13824537,1.8300793726401107e-05
WA14,5p,19,->A,126,43,169,6683958,7140595,13824553,1.2224626720299745e-05
WA14,5p,20,->A,130,58,188,6683860,7140558,13824418,1.3599125836617498e-05
WA14,5p,21,->A,495,73,568,6683480,7140494,13823974,4.108804024081643e-05
WA14,5p,22,->A,176,73,249,6683768,7140398,13824166,1.8011936488609873e-05
WA14,5p,23,->A,155,32,187,6683762,7140257,13824019,1.352718048202914e-05
WA14,5p,24,->A,176,41,217,6683714,7140421,13824135,1.569718467014392e-05
WA14,5p,25,->A,156,63,219,6683731,7140511,13824242,1.5841736566822254e-05
WA18,3p,1,->A,0,0,0,14112928,14131239,28244167,0.0
WA18,3p,2,->A,0,0,0,14112928,14131239,28244167,0.0
WA18,3p,3,->A,0,0,0,14112928,14131239,28244167,0.0
WA18,3p,4,->A,0,0,0,14112928,14131238,28244166,0.0
WA18,3p,5,->A,0,0,0,14112928,14131239,28244167,0.0
WA18,3p,6,->A,0,0,0,14112928,14131239,28244167,0.0
WA18,3p,7,->A,0,0,0,14112928,14131237,28244165,0.0
WA18,3p,8,->A,1,11,12,14112927,14131187,28244114,4.24867283852487e-07
WA18,3p,9,->A,10,21,31,14112909,14131177,28244086,1.0975749047074846e-06
WA18,3p,10,->A,7,11,18,14112909,14131197,28244106,6.373011062909905e-07
WA18,3p,11,->A,9,19,28,14112900,14131167,28244067,9.91358645339568e-07
WA18,3p,12,->A,8,23,31,14112895,14131136,28244031,1.0975770420305798e-06
WA18,3p,13,->A,4,32,36,14112898,14131061,28243959,1.2746088464439422e-06
WA18,3p,14,->A,40,63,103,14112830,14131006,28243836,3.646813414438464e-06
WA18,3p,15,->A,48,64,112,14112809,14130957,28243766,3.965476841863086e-06
WA18,3p,16,->A,52,47,99,14112765,14130927,28243692,3.505207463670118e-06
WA18,3p,17,->A,54,49,103,14112743,14130850,28243593,3.646844790604368e-06
WA18,3p,18,->A,90,86,176,14112708,14130769,28243477,6.231527371789246e-06
WA18,3p,19,->A,55,82,137,14112724,14130771,28243495,4.850674465040534e-06
WA18,3p,20,->A,58,74,132,14112697,14130797,28243494,4.673642715734817e-06
WA18,3p,21,->A,97,110,207,14112659,14130783,28243442,7.329135025398108e-06
WA18,3p,22,->A,168,68,236,14112575,14130715,28243290,8.355967027920614e-06
WA18,3p,23,->A,109,74,183,14112548,14130648,28243196,6.479436675651014e-06
WA18,3p,24,->A,163,75,238,14112551,14130690,28243241,8.426794927678448e-06
WA18,3p,25,->A,171,114,285,14112486,14130651,28243137,1.0090947050251536e-05
WA18,5p,1,->A,0,0,0,14112926,14131239,28244165,0.0
WA18,5p,2,->A,0,0,0,14112820,14131183,28244003,0.0
WA18,5p,3,->A,0,0,0,14112928,14131239,28244167,0.0
WA18,5p,4,->A,0,0,0,14112928,14131239,28244167,0.0
WA18,5p,5,->A,0,0,0,14112925,14131239,28244164,0.0
WA18,5p,6,->A,0,0,0,14112927,14131239,28244166,0.0
WA18,5p,7,->A,0,0,0,14112921,14131239,28244160,0.0
WA18,5p,8,->A,61,1,62,14112828,14131230,28244058,2.195151985596404e-06
WA18,5p,9,->A,61,2,63,14112833,14131230,28244063,2.23055726791149e-06
WA18,5p,10,->A,99,4,103,14112791,14131213,28244004,3.646791722590041e-06
WA18,5p,11,->A,93,20,113,14112776,14131211,28243987,4.000851579488406e-06
WA18,5p,12,->A,77,7,84,14112682,14131223,28243905,2.97409299457706e-06
WA18,5p,13,->A,152,15,167,14112608,14131206,28243814,5.912799170820201e-06
WA18,5p,14,->A,154,14,168,14112535,14131179,28243714,5.948226214158662e-06
WA18,5p,15,->A,125,25,150,14112545,14131148,28243693,5.310920211461016e-06
WA18,5p,16,->A,164,33,197,14112522,14131083,28243605,6.975030276765306e-06
WA18,5p,17,->A,203,115,318,14112485,14130990,28243475,1.1259237753144753e-05
WA18,5p,18,->A,133,53,186,14112481,14130987,28243468,6.585593525554298e-06
WA18,5p,19,->A,227,64,291,14112359,14130867,28243226,1.030335557276637e-05
WA18,5p,20,->A,244,71,315,14112397,14130866,28243263,1.115310224601173e-05
WA18,5p,21,->A,214,164,378,14112347,14130679,28243026,1.338383500408207e-05
WA18,5p,22,->A,221,77,298,14112376,14129592,28241968,1.055167260298574e-05
WA18,5p,23,->A,271,285,556,14112288,14129275,28241563,1.968729563586831e-05
WA18,5p,24,->A,220,1207,1427,14112253,14129481,28241734,5.052805893575798e-05
WA18,5p,25,->A,202,396,598,14112273,14130551,28242824,2.117352004176353e-05
WA22,3p,1,->A,0,0,0,1513709,1653397,3167106,0.0
WA22,3p,2,->A,0,0,0,1513709,1653396,3167105,0.0
WA22,3p,3,->A,0,0,0,1513709,1653396,3167105,0.0
WA22,3p,4,->A,0,0,0,1513709,1653394,3167103,0.0
WA22,3p,5,->A,0,0,0,1513709,1653397,3167106,0.0
WA22,3p,6,->A,0,0,0,1513709,1653397,3167106,0.0
WA22,3p,7,->A,0,0,0,1513709,1653397,3167106,0.0
WA22,3p,8,->A,0,0,0,1513709,1653395,3167104,0.0
WA22,3p,9,->A,0,0,0,1513709,1653397,3167106,0.0
WA22,3p,10,->A,0,0,0,1513706,1653396,3167102,0.0
WA22,3p,11,->A,0,1,1,1513685,1653390,3167075,3.157487587126923e-07
WA22,3p,12,->A,11,1,12,1513662,1653379,3167041,3.7890257814786734e-06
WA22,3p,13,->A,9,0,9,1513689,1653380,3167069,2.841744212077476e-06
WA22,3p,14,->A,6,8,14,1513686,1653352,3167038,4.420534265771361e-06
WA22,3p,15,->A,8,0,8,1513677,1653343,3167020,2.526033937265947e-06
WA22,3p,16,->A,38,26,64,1513637,1653341,3166978,2.0208539497274688e-05
WA22,3p,17,->A,15,14,29,1513671,1653319,3166990,9.156959763055772e-06
WA22,3p,18,->A,26,21,47,1513665,1653288,3166953,1.484076334571432e-05
WA22,3p,19,->A,16,59,75,1513662,1653275,3166937,2.3682188815249563e-05
WA22,3p,20,->A,0,19,19,1513684,1653304,3166988,5.99939121966992e-06
WA22,3p,21,->A,9,8,17,1513677,1653327,3167004,5.367849235428815e-06
WA22,3p,22,->A,0,0,0,1513684,1653356,3167040,0.0
WA22,3p,23,->A,11,3,14,1513676,1653329,3167005,4.420580327470275e-06
WA22,3p,24,->A,10,21,31,1513672,1653285,3166957,9.788576226327038e-06
WA22,3p,25,->A,0,39,39,1513669,1653296,3166965,1.231462930597591e-05
WA22,5p,1,->A,0,0,0,1513709,1653397,3167106,0.0
WA22,5p,2,->A,0,0,0,1513674,1653378,3167052,0.0
WA22,5p,3,->A,0,0,0,1513709,1653397,3167106,0.0
WA22,5p,4,->A,0,0,0,1513709,1653397,3167106,0.0
WA22,5p,5,->A,1,0,1,1513708,1653396,3167104,3.15745867518086e-07
WA22,5p,6,->A,0,0,0,1513704,1653397,3167101,0.0
WA22,5p,7,->A,0,0,0,1513707,1653397,3167104,0.0
WA22,5p,8,->A,0,0,0,1513692,1653397,3167089,0.0
WA22,5p,9,->A,9,0,9,1513700,1653389,3167089,2.8417262666126526e-06
WA22,5p,10,->A,2,0,2,1513705,1653389,3167094,6.314937289515246e-07
WA22,5p,11,->A,0,0,0,1513699,1653381,3167080,0.0
WA22,5p,12,->A,3,29,32,1513692,1653345,3167037,1.0104081512151578e-05
WA22,5p,13,->A,5,11,16,1513697,1653377,3167074,5.051981734560039e-06
WA22,5p,14,->A,23,0,23,1513677,1653376,3167053,7.262271897565339e-06
WA22,5p,15,->A,1,0,1,1513695,1653381,3167076,3.157486590154452e-07
WA22,5p,16,->A,9,8,17,1513668,1653368,3167036,5.36779499822547e-06
WA22,5p,17,->A,9,1,10,1513675,1653395,3167070,3.1574925719987244e-06
WA22,5p,18,->A,8,0,8,1513651,1653392,3167043,2.5260155924627483e-06
WA22,5p,19,->A,16,10,26,1513674,1653350,3167024,8.209599927250314e-06
WA22,5p,20,->A,17,5,22,1513678,1653356,3167034,6.9465626197887365e-06
WA22,5p,21,->A,11,10,21,1513690,1653371,3167061,6.630753244096025e-06
WA22,5p,22,->A,15,4,19,1513691,1653380,3167071,5.999233992543899e-06
WA22,5p,23,->A,34,0,34,1513634,1653393,3167027,1.073562050465626e-05
WA22,5p,24,->A,17,1,18,1513632,1653375,3167007,5.683599688917644e-06
WA22,5p,25,->A,45,7,52,1513644,1653364,3167008,1.6419282805727045e-05
WA25,3p,1,->A,0,0,0,3375244,3569089,6944333,0.0
WA25,3p,2,->A,0,0,0,3375244,3569089,6944333,0.0
WA25,3p,3,->A,0,0,0,3375244,3569089,6944333,0.0
WA25,3p,4,->A,0,0,0,3375244,3569087,6944331,0.0
WA25,3p,5,->A,0,0,0,3375244,3569089,6944333,0.0
WA25,3p,6,->A,0,0,0,3375244,3569089,6944333,0.0
WA25,3p,7,->A,0,0,0,3375244,3569089,6944333,0.0
WA25,3p,8,->A,3,5,8,3375239,3569076,6944315,1.1520214736802691e-06
WA25,3p,9,->A,0,2,2,3375240,3569076,6944316,2.880053269465272e-07
WA25,3p,10,->A,2,3,5,3375240,3569075,6944315,7.200134210501684e-07
WA25,3p,11,->A,1,13,14,3375233,3569054,6944287,2.016045707788287e-06
WA25,3p,12,->A,12,6,18,3375226,3569069,6944295,2.592055781040408e-06
WA25,3p,13,->A,2,2,4,3375230,3569053,6944283,5.760133911593176e-07
WA25,3p,14,->A,5,8,13,3375223,3569037,6944260,1.8720497216406069e-06
WA25,3p,15,->A,10,11,21,3375218,3569039,6944257,3.024081626011249e-06
WA25,3p,16,->A,10,12,22,3375196,3569030,6944226,3.168099655742771e-06
WA25,3p,17,->A,9,21,30,3375198,3569022,6944220,4.320139626912741e-06
WA25,3p,18,->A,16,19,35,3375213,3569006,6944219,5.040163623871885e-06
WA25,3p,19,->A,13,18,31,3375204,3569005,6944209,4.464151352587458e-06
WA25,3p,20,->A,25,33,58,3375190,3568979,6944169,8.352331286868163e-06
WA25,3p,21,->A,9,42,51,3375199,3568998,6944197,7.344261690732564e-06
WA25,3p,22,->A,12,22,34,3375179,3568994,6944173,4.896191382328752e-06
WA25,3p,23,->A,18,26,44,3375175,3568972,6944147,6.336271395176398e-06
WA25,3p,24,->A,25,32,57,3375177,3568962,6944139,8.208361036551832e-06
WA25,3p,25,->A,32,32,64,3375156,3568970,6944126,9.216422628276042e-06
WA25,5p,1,->A,0,0,0,3375244,3569089,6944333,0.0
WA25,5p,2,->A,0,0,0,3375147,3569045,6944192,0.0
WA25,5p,3,->A,0,0,0,3375243,3569089,6944332,0.0
WA25,5p,4,->A,1,0,1,3375243,3569089,6944332,1.4400233168575465e-07
WA25,5p,5,->A,0,0,0,3375244,3569088,6944332,0.0
WA25,5p,6,->A,0,0,0,3375244,3569089,6944333,0.0
WA25,5p,7,->A,0,0,0,3375242,3569089,6944331,0.0
WA25,5p,8,->A,6,1,7,3375221,3569088,6944309,1.0080196604154568e-06
WA25,5p,9,->A,7,0,7,3375227,3569087,6944314,1.008018934627668e-06
WA25,5p,10,->A,11,0,11,3375217,3569085,6944302,1.5840324916744693e-06
WA25,5p,11,->A,8,1,9,3375193,3569088,6944281,1.296030503373927e-06
WA25,5p,12,->A,20,0,20,3375142,3569084,6944226,2.880090596129792e-06
WA25,5p,13,->A,18,2,20,3375133,3569081,6944214,2.880095573091497e-06
WA25,5p,14,->A,32,4,36,3375151,3569071,6944222,5.184166059207209e-06
WA25,5p,15,->A,35,4,39,3375137,3569055,6944192,5.616204160253633e-06
WA25,5p,16,->A,42,9,51,3375081,3569035,6944116,7.344347358252656e-06
WA25,5p,17,->A,51,7,58,3375076,3568871,6943947,8.35259831332238e-06
WA25,5p,18,->A,48,10,58,3375102,3568996,6944098,8.3524166853636e-06
WA25,5p,19,->A,30,20,50,3375134,3569021,6944155,7.2003001085085225e-06
WA25,5p,20,->A,30,26,56,3375145,3569019,6944164,8.064325669727847e-06
WA25,5p,21,->A,43,18,61,3375130,3569013,6944143,8.78438131242401e-06
WA25,5p,22,->A,32,14,46,3375139,3569001,6944140,6.624290408891526e-06
WA25,5p,23,->A,30,11,41,3375144,3569002,6944146,5.904253741208782e-06
WA25,5p,24,->A,45,16,61,3375124,3568967,6944091,8.784447093219256e-06
WA25,5p,25,->A,53,51,104,3375125,3568950,6944075,1.4976796765587928e-05
WA26,3p,1,->A,0,0,0,2709623,2900126,5609749,0.0
WA26,3p,2,->A,0,0,0,2709623,2900126,5609749,0.0
WA26,3p,3,->A,0,0,0,2709623,2900126,5609749,0.0
WA26,3p,4,->A,0,0,0,2709623,2900126,5609749,0.0
WA26,3p,5,->A,0,0,0,2709623,2900126,5609749,0.0
WA26,3p,6,->A,0,0,0,2709623,2900126,5609749,0.0
WA26,3p,7,->A,0,0,0,2709623,2900126,5609749,0.0
WA26,3p,8,->A,0,5,5,2709619,2900114,5609733,8.913080176899685e-07
WA26,3p,9,->A,0,3,3,2709613,2900111,5609724,5.347856685997386e-07
WA26,3p,10,->A,4,12,16,2709609,2900074,5609683,2.852211078593924e-06
WA26,3p,11,->A,8,11,19,2709594,2900076,5609670,3.3870085049566194e-06
WA26,3p,12,->A,5,12,17,2709607,2900081,5609688,3.0304715698983616e-06
WA26,3p,13,->A,10,18,28,2709604,2900084,5609688,4.991364938656125e-06
WA26,3p,14,->A,16,14,30,2709584,2900069,5609653,5.347924372505751e-06
WA26,3p,15,->A,7,16,23,2709593,2900082,5609675,4.100059272596006e-06
WA26,3p,16,->A,8,9,17,2709580,2900075,5609655,3.0304893972980514e-06
WA26,3p,17,->A,23,7,30,2709570,2900078,5609648,5.347929139225848e-06
WA26,3p,18,->A,12,24,36,2709582,2900059,5609641,6.4175229751779125e-06
WA26,3p,19,->A,17,12,29,2709567,2900016,5609583,5.169724737115041e-06
WA26,3p,20,->A,18,21,39,2709563,2899983,5609546,6.952434296821882e-06
WA26,3p,21,->A,26,18,44,2709562,2900021,5609583,7.843720290795234e-06
WA26,3p,22,->A,18,14,32,2709522,2900007,5609529,5.704578762316765e-06
WA26,3p,23,->A,32,30,62,2709541,2899974,5609515,1.1052648936672778e-05
WA26,3p,24,->A,16,76,92,2709558,2899951,5609509,1.6400722416168687e-05
WA26,3p,25,->A,48,14,62,2709500,2900002,5609502,1.105267455114554e-05
WA26,5p,1,->A,0,0,0,2709622,2900126,5609748,0.0
WA26,5p,2,->A,0,0,0,2709554,2900092,5609646,0.0
WA26,5p,3,->A,0,0,0,2709623,2900126,5609749,0.0
WA26,5p,4,->A,0,0,0,2709623,2900126,5609749,0.0
WA26,5p,5,->A,0,0,0,2709623,2900125,5609748,0.0
WA26,5p,6,->A,0,0,0,2709621,2900126,5609747,0.0
WA26,5p,7,->A,0,0,0,2709622,2900126,5609748,0.0
WA26,5p,8,->A,7,0,7,2709609,2900124,5609733,1.247831224765956e-06
WA26,5p,9,->A,11,0,11,2709594,2900123,5609717,1.9608832317209584e-06
WA26,5p,10,->A,11,0,11,2709601,2900123,5609724,1.960880784865708e-06
WA26,5p,11,->A,5,7,12,2709605,2900103,5609708,2.1391487756581984e-06
WA26,5p,12,->A,7,4,11,2709595,2900107,5609702,1.960888475002772e-06
WA26,5p,13,->A,9,4,13,2709592,2900104,5609696,2.317416130927594e-06
WA26,5p,14,->A,20,11,31,2709563,2900089,5609652,5.526189503377393e-06
WA26,5p,15,->A,33,9,42,2709545,2900085,5609630,7.487124819283981e-06
WA26,5p,16,->A,12,7,19,2709540,2900076,5609616,3.3870411094092718e-06
WA26,5p,17,->A,32,8,40,2709554,2900055,5609609,7.130621759912322e-06
WA26,5p,18,->A,20,12,32,2709554,2900082,5609636,5.704469951348002e-06
WA26,5p,19,->A,17,13,30,2709570,2900086,5609656,5.347921512477771e-06
WA26,5p,20,->A,24,6,30,2709563,2900082,5609645,5.347931999261985e-06
WA26,5p,21,->A,33,26,59,2709545,2900061,5609606,1.0517672720686622e-05
WA26,5p,22,->A,27,24,51,2709542,2900059,5609601,9.091555709577206e-06
WA26,5p,23,->A,39,38,77,2709528,2900065,5609593,1.3726486039183234e-05
WA26,5p,24,->A,45,23,68,2709495,2900057,5609552,1.2122180166972336e-05
WA26,5p,25,->A,68,34,102,2709506,2900041,5609547,1.818328645789045e-05
