Sample,End,Position,Substitution,Pos_Count,Neg_Count,Combined_Count,Pos_Total,Neg_Total,Combined_Total,Frequency
DAL192,3p,1,->C,0,0,0,6350003,6167708,12517711,0.0
DAL192,3p,2,->C,0,0,0,6350003,6167706,12517709,0.0
DAL192,3p,3,->C,0,0,0,6350003,6167708,12517711,0.0
DAL192,3p,4,->C,0,0,0,6350003,6167708,12517711,0.0
DAL192,3p,5,->C,0,0,0,6350003,6167708,12517711,0.0
DAL192,3p,6,->C,0,0,0,6350003,6167708,12517711,0.0
DAL192,3p,7,->C,0,0,0,6350003,6167708,12517711,0.0
DAL192,3p,8,->C,0,0,0,6350003,6167618,12517621,0.0
DAL192,3p,9,->C,0,1,1,6350003,6167637,12517640,7.98872630943213e-08
DAL192,3p,10,->C,0,4,4,6350003,6167645,12517648,3.19548848154222e-07
DAL192,3p,11,->C,3,3,6,6349987,6167644,12517631,4.79323923192815e-07
DAL192,3p,12,->C,0,9,9,6349997,6167646,12517643,7.189851955356132e-07
DAL192,3p,13,->C,0,8,8,6349992,6167621,12517613,6.390994832641016e-07
DAL192,3p,14,->C,4,11,15,6349967,6167610,12517577,1.1983149774113633e-06
DAL192,3p,15,->C,3,12,15,6349968,6167615,12517583,1.1983144030281243e-06
DAL192,3p,16,->C,2,34,36,6349943,6167587,12517530,2.875966744237881e-06
DAL192,3p,17,->C,5,19,24,6349922,6167606,12517528,1.917311469165477e-06
DAL192,3p,18,->C,4,37,41,6349922,6167564,12517486,3.2754180831518405e-06
DAL192,3p,19,->C,4,51,55,6349921,6167519,12517440,4.3938696730321855e-06
DAL192,3p,20,->C,6,37,43,6349910,6167516,12517426,3.435211040991974e-06
DAL192,3p,21,->C,12,32,44,6349882,6167507,12517389,3.515110060093203e-06
DAL192,3p,22,->C,12,35,47,6349894,6167488,12517382,3.754778754854649e-06
DAL192,3p,23,->C,11,53,64,6349902,6167465,12517367,5.11289634633226e-06
DAL192,3p,24,->C,10,55,65,6349899,6167465,12517364,5.192786596283371e-06
DAL192,3p,25,->C,16,53,69,6349856,6167384,12517240,5.512397301641576e-06
DAL192,5p,1,->C,0,0,0,6350003,6167708,12517711,0.0
DAL192,5p,2,->C,0,0,0,6349992,6167694,12517686,0.0
DAL192,5p,3,->C,0,0,0,6350003,6167707,12517710,0.0
DAL192,5p,4,->C,0,0,0,6350003,6167708,12517711,0.0
DAL192,5p,5,->C,0,0,0,6350003,6167707,12517710,0.0
DAL192,5p,6,->C,0,0,0,6350002,6167707,12517709,0.0
DAL192,5p,7,->C,0,0,0,6350002,6167708,12517710,0.0
DAL192,5p,8,->C,3,0,3,6349926,6167708,12517634,2.396619041585654e-07
DAL192,5p,9,->C,2,0,2,6349914,6167708,12517622,1.5977475594006596e-07
DAL192,5p,10,->C,1,0,1,6349896,6167708,12517604,7.988749284607502e-08
DAL192,5p,11,->C,3,1,4,6349942,6167706,12517648,3.19548848154222e-07
DAL192,5p,12,->C,13,0,13,6349906,6167700,12517606,1.0385372410667023e-06
DAL192,5p,13,->C,11,2,13,6349906,6167705,12517611,1.0385368262362524e-06
DAL192,5p,14,->C,6,1,7,6349889,6167679,12517568,5.592140581940518e-07
DAL192,5p,15,->C,5,5,10,6349890,6167649,12517539,7.988790767897747e-07
DAL192,5p,16,->C,17,18,35,6349904,6167639,12517543,2.796075875273606e-06
DAL192,5p,17,->C,22,14,36,6349778,6167623,12517401,2.875996382955216e-06
DAL192,5p,18,->C,14,8,22,6349859,6167631,12517490,1.757540848844297e-06
DAL192,5p,19,->C,22,8,30,6349822,6167638,12517460,2.3966523559891544e-06
DAL192,5p,20,->C,13,11,24,6349836,6167621,12517457,1.9173223443068347e-06
DAL192,5p,21,->C,25,19,44,6349784,6167624,12517408,3.5151047245563937e-06
DAL192,5p,22,->C,40,41,81,6349783,6167584,12517367,6.471009438326766e-06
DAL192,5p,23,->C,21,30,51,6349801,6167567,12517368,4.074338950488633e-06
DAL192,5p,24,->C,30,24,54,6349759,6167564,12517323,4.314021456504718e-06
DAL192,5p,25,->C,39,33,72,6349777,6167551,12517328,5.752026311046575e-06
DAL193,3p,1,->C,0,0,0,6484405,6362696,12847101,0.0
DAL193,3p,2,->C,0,0,0,6484402,6362696,12847098,0.0
DAL193,3p,3,->C,0,0,0,6484405,6362696,12847101,0.0
DAL193,3p,4,->C,0,0,0,6484405,6362696,12847101,0.0
DAL193,3p,5,->C,0,0,0,6484405,6362696,12847101,0.0
DAL193,3p,6,->C,0,0,0,6484405,6362696,12847101,0.0
DAL193,3p,7,->C,0,0,0,6484405,6362696,12847101,0.0
DAL193,3p,8,->C,3,1,4,6484400,6362644,12847044,3.113556706118544e-07
DAL193,3p,9,->C,0,2,2,6484400,6362631,12847031,1.5567799283741126e-07
DAL193,3p,10,->C,2,0,2,6484393,6362640,12847033,1.5567796860177756e-07
DAL193,3p,11,->C,1,7,8,6484398,6362639,12847037,6.227116805221313e-07
DAL193,3p,12,->C,3,20,23,6484368,6362594,12846962,1.790306533171033e-06
DAL193,3p,13,->C,5,38,43,6484385,6362543,12846928,3.3471036811290605e-06
DAL193,3p,14,->C,3,50,53,6484363,6362486,12846849,4.125525255259091e-06
DAL193,3p,15,->C,1,52,53,6484332,6362438,12846770,4.125550624787398e-06
DAL193,3p,16,->C,5,68,73,6484341,6362460,12846801,5.682348469475008e-06
DAL193,3p,17,->C,8,52,60,6484294,6362445,12846739,4.6704459396271695e-06
DAL193,3p,18,->C,9,80,89,6484244,6362380,12846624,6.927890160091865e-06
DAL193,3p,19,->C,17,85,102,6484265,6362400,12846665,7.939803832356492e-06
DAL193,3p,20,->C,36,67,103,6484261,6362382,12846643,8.017658776693647e-06
DAL193,3p,21,->C,23,48,71,6484248,6362443,12846691,5.526715011671099e-06
DAL193,3p,22,->C,20,89,109,6484224,6362407,12846631,8.484714786312459e-06
DAL193,3p,23,->C,27,103,130,6484218,6362399,12846617,1.0119395635442389e-05
DAL193,3p,24,->C,37,110,147,6484164,6362319,12846483,1.144282057587279e-05
DAL193,3p,25,->C,37,90,127,6484128,6362355,12846483,9.885974239019347e-06
DAL193,5p,1,->C,0,0,0,6484405,6362696,12847101,0.0
DAL193,5p,2,->C,0,0,0,6484386,6362681,12847067,0.0
DAL193,5p,3,->C,0,0,0,6484400,6362696,12847096,0.0
DAL193,5p,4,->C,0,0,0,6484403,6362696,12847099,0.0
DAL193,5p,5,->C,0,0,0,6484403,6362696,12847099,0.0
DAL193,5p,6,->C,0,0,0,6484404,6362696,12847100,0.0
DAL193,5p,7,->C,0,0,0,6484404,6362696,12847100,0.0
DAL193,5p,8,->C,3,1,4,6484314,6362693,12847007,3.11356567331208e-07
DAL193,5p,9,->C,1,0,1,6484295,6362695,12846990,7.783924483478232e-08
DAL193,5p,10,->C,5,1,6,6484284,6362694,12846978,4.6703590525336e-07
DAL193,5p,11,->C,9,1,10,6484315,6362677,12846992,7.783923271688813e-07
DAL193,5p,12,->C,20,1,21,6484218,6362670,12846888,1.6346371199001657e-06
DAL193,5p,13,->C,43,2,45,6484143,6362652,12846795,3.5028191856412435e-06
DAL193,5p,14,->C,83,8,91,6484145,6362627,12846772,7.083491479415997e-06
DAL193,5p,15,->C,56,12,68,6484166,6362534,12846700,5.29318813391766e-06
DAL193,5p,16,->C,84,6,90,6484111,6362519,12846630,7.0057283505479645e-06
DAL193,5p,17,->C,127,30,157,6484043,6362598,12846641,1.222109343601958e-05
DAL193,5p,18,->C,124,39,163,6483967,6362571,12846538,1.2688243322831411e-05
DAL193,5p,19,->C,148,23,171,6483980,6362593,12846573,1.3310942926179612e-05
DAL193,5p,20,->C,70,28,98,6483952,6362554,12846506,7.6285333926594515e-06
DAL193,5p,21,->C,115,30,145,6484003,6362532,12846535,1.1287090254298144e-05
DAL193,5p,22,->C,107,54,161,6484010,6362499,12846509,1.2532587646963078e-05
DAL193,5p,23,->C,110,65,175,6483966,6362463,12846429,1.362246270928676e-05
DAL193,5p,24,->C,110,106,216,6483905,6362426,12846331,1.681413938345509e-05
DAL193,5p,25,->C,76,126,202,6483942,6362403,12846345,1.572431691660157e-05
DAL195,3p,1,->C,0,0,0,2363278,2267461,4630739,0.0
DAL195,3p,2,->C,0,0,0,2363278,2267460,4630738,0.0
DAL195,3p,3,->C,0,0,0,2363278,2267461,4630739,0.0
DAL195,3p,4,->C,0,0,0,2363278,2267461,4630739,0.0
DAL195,3p,5,->C,0,0,0,2363278,2267461,4630739,0.0
DAL195,3p,6,->C,0,0,0,2363278,2267461,4630739,0.0
DAL195,3p,7,->C,0,0,0,2363278,2267461,4630739,0.0
DAL195,3p,8,->C,0,1,1,2363278,2267413,4630691,2.159504920539937e-07
DAL195,3p,9,->C,1,0,1,2363276,2267438,4630714,2.1594941946317565e-07
DAL195,3p,10,->C,2,2,4,2363274,2267432,4630706,8.637991701481372e-07
DAL195,3p,11,->C,2,0,2,2363274,2267431,4630705,4.318996783427146e-07
DAL195,3p,12,->C,0,13,13,2363273,2267414,4630687,2.807358821703993e-06
DAL195,3p,13,->C,2,4,6,2363269,2267412,4630681,1.2957057504069056e-06
DAL195,3p,14,->C,0,9,9,2363250,2267410,4630660,1.943567439630636e-06
DAL195,3p,15,->C,3,15,18,2363254,2267411,4630665,3.887130682094257e-06
DAL195,3p,16,->C,3,13,16,2363259,2267394,4630653,3.455236226942507e-06
DAL195,3p,17,->C,3,21,24,2363234,2267398,4630632,5.182877844752077e-06
DAL195,3p,18,->C,9,25,34,2363236,2267374,4630610,7.342445163812111e-06
DAL195,3p,19,->C,5,18,23,2363215,2267369,4630584,4.966976087681381e-06
DAL195,3p,20,->C,11,24,35,2363222,2267380,4630602,7.558412491507584e-06
DAL195,3p,21,->C,9,13,22,2363235,2267382,4630617,4.750986747554376e-06
DAL195,3p,22,->C,9,11,20,2363231,2267383,4630614,4.319081659581213e-06
DAL195,3p,23,->C,6,15,21,2363219,2267370,4630589,4.535060226679587e-06
DAL195,3p,24,->C,13,14,27,2363198,2267373,4630571,5.830814385526105e-06
DAL195,3p,25,->C,12,19,31,2363180,2267377,4630557,6.694658979470504e-06
DAL195,5p,1,->C,0,0,0,2363278,2267461,4630739,0.0
DAL195,5p,2,->C,0,0,0,2363264,2267447,4630711,0.0
DAL195,5p,3,->C,0,0,0,2363278,2267459,4630737,0.0
DAL195,5p,4,->C,0,0,0,2363278,2267461,4630739,0.0
DAL195,5p,5,->C,0,0,0,2363277,2267461,4630738,0.0
DAL195,5p,6,->C,1,0,1,2363277,2267461,4630738,2.1594830024933394e-07
DAL195,5p,7,->C,0,0,0,2363277,2267461,4630738,0.0
DAL195,5p,8,->C,6,0,6,2363212,2267460,4630672,1.2957082686918875e-06
DAL195,5p,9,->C,3,0,3,2363181,2267461,4630642,6.478583315229292e-07
DAL195,5p,10,->C,12,0,12,2363146,2267458,4630604,2.591454592100728e-06
DAL195,5p,11,->C,4,8,12,2362948,2267450,4630398,2.591569882329769e-06
DAL195,5p,12,->C,10,3,13,2362864,2267454,4630318,2.8075825461663755e-06
DAL195,5p,13,->C,11,4,15,2363073,2267445,4630518,3.239378402157167e-06
DAL195,5p,14,->C,9,1,10,2363094,2267434,4630528,2.1595809376382133e-06
DAL195,5p,15,->C,20,4,24,2363178,2267432,4630610,5.182902468573255e-06
DAL195,5p,16,->C,25,5,30,2363170,2267429,4630599,6.478643475714481e-06
DAL195,5p,17,->C,18,8,26,2363159,2267431,4630590,5.614835258573961e-06
DAL195,5p,18,->C,20,4,24,2363182,2267420,4630602,5.182911422748057e-06
DAL195,5p,19,->C,49,7,56,2363138,2267420,4630558,1.209357489961253e-05
DAL195,5p,20,->C,64,10,74,2363110,2267401,4630511,1.5980957609214187e-05
DAL195,5p,21,->C,70,19,89,2363086,2267400,4630486,1.9220444679025053e-05
DAL195,5p,22,->C,56,15,71,2363094,2267388,4630482,1.5333176978120205e-05
DAL195,5p,23,->C,66,12,78,2363068,2267398,4630466,1.6844956857473955e-05
DAL195,5p,24,->C,47,9,56,2363067,2267402,4630469,1.209380734435324e-05
DAL195,5p,25,->C,26,11,37,2363135,2267374,4630509,7.990482255838397e-06
DAL212,3p,1,->C,0,0,0,4131322,4008153,8139475,0.0
DAL212,3p,2,->C,0,0,0,4131322,4008153,8139475,0.0
DAL212,3p,3,->C,0,0,0,4131322,4008153,8139475,0.0
DAL212,3p,4,->C,0,0,0,4131322,4008153,8139475,0.0
DAL212,3p,5,->C,0,0,0,4131322,4008151,8139473,0.0
DAL212,3p,6,->C,0,0,0,4131322,4008151,8139473,0.0
DAL212,3p,7,->C,0,0,0,4131322,4008153,8139475,0.0
DAL212,3p,8,->C,0,1,1,4131319,4008093,8139412,1.228589976769821e-07
DAL212,3p,9,->C,1,1,2,4131316,4008115,8139431,2.457174217706373e-07
DAL212,3p,10,->C,2,1,3,4131317,4008102,8139419,3.685766760502193e-07
DAL212,3p,11,->C,0,2,2,4131313,4008105,8139418,2.45717814222098e-07
DAL212,3p,12,->C,0,16,16,4131314,4008034,8139348,1.9657594195505585e-06
DAL212,3p,13,->C,1,76,77,4131307,4007923,8139230,9.460354357844662e-06
DAL212,3p,14,->C,8,66,74,4131271,4007904,8139175,9.091830560222626e-06
DAL212,3p,15,->C,5,16,21,4131254,4007935,8139189,2.5801096399162127e-06
DAL212,3p,16,->C,15,26,41,4131236,4007982,8139218,5.0373389679450775e-06
DAL212,3p,17,->C,14,11,25,4131249,4007981,8139230,3.071543622676838e-06
DAL212,3p,18,->C,21,46,67,4131222,4007954,8139176,8.231791522876517e-06
DAL212,3p,19,->C,15,56,71,4131233,4007956,8139189,8.72322783019291e-06
DAL212,3p,20,->C,13,54,67,4131221,4007928,8139149,8.23181883019957e-06
DAL212,3p,21,->C,11,63,74,4131228,4007917,8139145,9.091864071717609e-06
DAL212,3p,22,->C,30,38,68,4131183,4007898,8139081,8.3547515991056e-06
DAL212,3p,23,->C,19,55,74,4131172,4007904,8139076,9.091941149093585e-06
DAL212,3p,24,->C,49,60,109,4131124,4007904,8139028,1.3392262565013903e-05
DAL212,3p,25,->C,74,48,122,4131071,4007924,8138995,1.4989565665048326e-05
DAL212,5p,1,->C,0,0,0,4131322,4008153,8139475,0.0
DAL212,5p,2,->C,0,0,0,4131307,4008143,8139450,0.0
DAL212,5p,3,->C,0,0,0,4131321,4008153,8139474,0.0
DAL212,5p,4,->C,0,0,0,4131322,4008153,8139475,0.0
DAL212,5p,5,->C,0,0,0,4131322,4008153,8139475,0.0
DAL212,5p,6,->C,0,0,0,4131322,4008153,8139475,0.0
DAL212,5p,7,->C,0,0,0,4131322,4008153,8139475,0.0
DAL212,5p,8,->C,2,0,2,4131248,4008153,8139401,2.4571832742974574e-07
DAL212,5p,9,->C,4,0,4,4131243,4008153,8139396,4.914369567471592e-07
DAL212,5p,10,->C,7,0,7,4131179,4008148,8139327,8.600219649609851e-07
DAL212,5p,11,->C,7,1,8,4131234,4008143,8139377,9.828762078473573e-07
DAL212,5p,12,->C,23,3,26,4131187,4008141,8139328,3.1943669059657014e-06
DAL212,5p,13,->C,17,3,20,4131181,4008142,8139323,2.4572068217467227e-06
DAL212,5p,14,->C,25,2,27,4131134,4008108,8139242,3.3172622217154867e-06
DAL212,5p,15,->C,19,10,29,4131156,4008091,8139247,3.562983160481553e-06
DAL212,5p,16,->C,28,10,38,4131154,4008081,8139235,4.668743438418967e-06
DAL212,5p,17,->C,40,9,49,4131159,4008081,8139240,6.0202181039015926e-06
DAL212,5p,18,->C,40,11,51,4131113,4008066,8139179,6.265988252623514e-06
DAL212,5p,19,->C,29,16,45,4131040,4008052,8139092,5.528872262409615e-06
DAL212,5p,20,->C,43,13,56,4131020,4008040,8139060,6.880401422277266e-06
DAL212,5p,21,->C,32,23,55,4130973,4008040,8139013,6.757576133617185e-06
DAL212,5p,22,->C,60,21,81,4131015,4007967,8138982,9.952104575240491e-06
DAL212,5p,23,->C,56,32,88,4131005,4007962,8138967,1.0812182921985064e-05
DAL212,5p,24,->C,49,21,70,4131060,4007918,8138978,8.600588427687112e-06
DAL212,5p,25,->C,47,48,95,4131016,4007614,8138630,1.167272624508056e-05
DAL218,3p,1,->C,0,0,0,6952891,6658031,13610922,0.0
DAL218,3p,2,->C,0,0,0,6952891,6658031,13610922,0.0
DAL218,3p,3,->C,0,0,0,6952891,6658030,13610921,0.0
DAL218,3p,4,->C,0,0,0,6952891,6658031,13610922,0.0
DAL218,3p,5,->C,0,0,0,6952891,6658031,13610922,0.0
DAL218,3p,6,->C,0,0,0,6952891,6658030,13610921,0.0
DAL218,3p,7,->C,0,0,0,6952891,6658026,13610917,0.0
DAL218,3p,8,->C,1,1,2,6952887,6657945,13610832,1.469417887165164e-07
DAL218,3p,9,->C,3,5,8,6952882,6657945,13610827,5.877673707850376e-07
DAL218,3p,10,->C,0,12,12,6952881,6657960,13610841,8.816501493184735e-07
DAL218,3p,11,->C,12,7,19,6952866,6657905,13610771,1.3959532490848608e-06
DAL218,3p,12,->C,9,24,33,6952858,6657882,13610740,2.4245559021772518e-06
DAL218,3p,13,->C,3,33,36,6952870,6657811,13610681,2.644981540600356e-06
DAL218,3p,14,->C,16,37,53,6952816,6657779,13610595,3.894025206098632e-06
DAL218,3p,15,->C,9,83,92,6952788,6657738,13610526,6.759474248092983e-06
DAL218,3p,16,->C,5,86,91,6952760,6657689,13610449,6.686039527424848e-06
DAL218,3p,17,->C,6,92,98,6952737,6657651,13610388,7.200382531342971e-06
DAL218,3p,18,->C,26,81,107,6952711,6657672,13610383,7.86164503967302e-06
DAL218,3p,19,->C,22,95,117,6952716,6657697,13610413,8.596359272859684e-06
DAL218,3p,20,->C,34,88,122,6952697,6657752,13610449,8.963701344459687e-06
DAL218,3p,21,->C,27,70,97,6952660,6657692,13610352,7.12692809120587e-06
DAL218,3p,22,->C,37,80,117,6952654,6657637,13610291,8.596436328951379e-06
DAL218,3p,23,->C,52,69,121,6952651,6657632,13610283,8.890336813716511e-06
DAL218,3p,24,->C,32,100,132,6952669,6657588,13610257,9.69856777869808e-06
DAL218,3p,25,->C,50,126,176,6952605,6657566,13610171,1.29315054160598e-05
DAL218,5p,1,->C,0,0,0,6952891,6658031,13610922,0.0
DAL218,5p,2,->C,0,0,0,6952874,6658014,13610888,0.0
DAL218,5p,3,->C,0,0,0,6952891,6658031,13610922,0.0
DAL218,5p,4,->C,0,0,0,6952891,6658031,13610922,0.0
DAL218,5p,5,->C,0,0,0,6952891,6658031,13610922,0.0
DAL218,5p,6,->C,0,0,0,6952891,6658031,13610922,0.0
DAL218,5p,7,->C,0,0,0,6952888,6658031,13610919,0.0
DAL218,5p,8,->C,14,0,14,6952719,6658029,13610748,1.0285988690702377e-06
DAL218,5p,9,->C,7,1,8,6952736,6658029,13610765,5.877700481934704e-07
DAL218,5p,10,->C,11,1,12,6952716,6658028,13610744,8.816564325947208e-07
DAL218,5p,11,->C,21,3,24,6952715,6658016,13610731,1.7633145493801912e-06
DAL218,5p,12,->C,57,5,62,6952625,6658005,13610630,4.555263055420653e-06
DAL218,5p,13,->C,74,2,76,6952475,6658005,13610480,5.583932381517771e-06
DAL218,5p,14,->C,49,3,52,6952554,6657955,13610509,3.820577173124091e-06
DAL218,5p,15,->C,159,25,184,6952449,6657923,13610372,1.3519101461738153e-05
DAL218,5p,16,->C,199,19,218,6952253,6657920,13610173,1.6017430491148055e-05
DAL218,5p,17,->C,81,26,107,6952350,6657874,13610224,7.861736882508327e-06
DAL218,5p,18,->C,116,31,147,6952457,6657843,13610300,1.080064363019184e-05
DAL218,5p,19,->C,94,57,151,6952296,6657770,13610066,1.1094729445103352e-05
DAL218,5p,20,->C,84,56,140,6952289,6657772,13610061,1.028650790029523e-05
DAL218,5p,21,->C,99,62,161,6952371,6657729,13610100,1.1829450187728231e-05
DAL218,5p,22,->C,91,76,167,6952322,6657786,13610108,1.2270292050584757e-05
DAL218,5p,23,->C,77,94,171,6952288,6657745,13610033,1.2564260498119292e-05
DAL218,5p,24,->C,85,57,142,6952375,6657772,13610147,1.0433392086066376e-05
DAL218,5p,25,->C,147,69,216,6952272,6657720,13609992,1.587069264992955e-05
DAL224,3p,1,->C,0,0,0,4609472,4586477,9195949,0.0
DAL224,3p,2,->C,0,0,0,4609471,4586476,9195947,0.0
DAL224,3p,3,->C,0,0,0,4609472,4586477,9195949,0.0
DAL224,3p,4,->C,0,0,0,4609472,4586477,9195949,0.0
DAL224,3p,5,->C,0,0,0,4609472,4586477,9195949,0.0
DAL224,3p,6,->C,0,0,0,4609472,4586477,9195949,0.0
DAL224,3p,7,->C,0,1,1,4609472,4586476,9195948,1.0874354661422618e-07
DAL224,3p,8,->C,0,0,0,4609469,4586423,9195892,0.0
DAL224,3p,9,->C,1,1,2,4609466,4586431,9195897,2.1748829940135258e-07
DAL224,3p,10,->C,2,2,4,4609461,4586371,9195832,4.349796733998621e-07
DAL224,3p,11,->C,3,1,4,4609461,4586382,9195843,4.349791530803647e-07
DAL224,3p,12,->C,1,3,4,4609458,4586384,9195842,4.349792003820857e-07
DAL224,3p,13,->C,3,9,12,4609454,4586364,9195818,1.3049410068794314e-06
DAL224,3p,14,->C,10,16,26,4609412,4586293,9195705,2.827406925298278e-06
DAL224,3p,15,->C,3,27,30,4609400,4586272,9195672,3.26240431368148e-06
DAL224,3p,16,->C,12,46,58,4609379,4586240,9195619,6.307351359381027e-06
DAL224,3p,17,->C,9,35,44,4609381,4586216,9195597,4.784898685751453e-06
DAL224,3p,18,->C,6,38,44,4609363,4586282,9195645,4.784873709239537e-06
DAL224,3p,19,->C,7,18,25,4609353,4586195,9195548,2.71870692208882e-06
DAL224,3p,20,->C,25,43,68,4609344,4586225,9195569,7.394865940324084e-06
DAL224,3p,21,->C,18,52,70,4609343,4586223,9195566,7.612364480881329e-06
DAL224,3p,22,->C,20,35,55,4609324,4586172,9195496,5.981189051683563e-06
DAL224,3p,23,->C,12,53,65,4609323,4586083,9195406,7.06874715482927e-06
DAL224,3p,24,->C,15,54,69,4609325,4586202,9195527,7.5036482411502895e-06
DAL224,3p,25,->C,23,53,76,4609265,4586173,9195438,8.264967911262085e-06
DAL224,5p,1,->C,0,0,0,4609472,4586477,9195949,0.0
DAL224,5p,2,->C,0,0,0,4609461,4586469,9195930,0.0
DAL224,5p,3,->C,3,0,3,4609468,4586477,9195945,3.2623074626914364e-07
DAL224,5p,4,->C,0,0,0,4609471,4586477,9195948,0.0
DAL224,5p,5,->C,1,0,1,4609471,4586477,9195948,1.0874354661422618e-07
DAL224,5p,6,->C,0,0,0,4609472,4586477,9195949,0.0
DAL224,5p,7,->C,0,0,0,4609471,4586477,9195948,0.0
DAL224,5p,8,->C,0,0,0,4609397,4586477,9195874,0.0
DAL224,5p,9,->C,5,0,5,4609357,4586473,9195830,5.437247100044259e-07
DAL224,5p,10,->C,6,1,7,4609338,4586470,9195808,7.612164151317644e-07
DAL224,5p,11,->C,9,1,10,4609388,4586469,9195857,1.0874462271433756e-06
DAL224,5p,12,->C,17,7,24,4609357,4586464,9195821,2.609881162323625e-06
DAL224,5p,13,->C,14,3,17,4609320,4586461,9195781,1.8486738646777253e-06
DAL224,5p,14,->C,30,4,34,4609270,4586428,9195698,3.6973811014672296e-06
DAL224,5p,15,->C,33,9,42,4609299,4586416,9195715,4.567344681734916e-06
DAL224,5p,16,->C,20,13,33,4609292,4586373,9195665,3.5886474768273963e-06
DAL224,5p,17,->C,31,21,52,4609285,4586385,9195670,5.654835373605186e-06
DAL224,5p,18,->C,55,27,82,4609226,4586351,9195577,8.917330581865608e-06
DAL224,5p,19,->C,40,24,64,4609203,4586337,9195540,6.959895775560761e-06
DAL224,5p,20,->C,42,28,70,4609148,4586313,9195461,7.61245140401335e-06
DAL224,5p,21,->C,49,27,76,4609195,4586347,9195542,8.264874435895133e-06
DAL224,5p,22,->C,75,36,111,4609138,4586312,9195450,1.2071187380715462e-05
DAL224,5p,23,->C,89,33,122,4609100,4586313,9195413,1.3267484559964844e-05
DAL224,5p,24,->C,54,41,95,4609109,4586316,9195425,1.0331224494789528e-05
DAL224,5p,25,->C,77,16,93,4609125,4586257,9195382,1.011377232615241e-05
DAL227,3p,1,->C,0,0,0,3765386,3771243,7536629,0.0
DAL227,3p,2,->C,0,0,0,3765386,3771243,7536629,0.0
DAL227,3p,3,->C,0,0,0,3765386,3771243,7536629,0.0
DAL227,3p,4,->C,0,0,0,3765386,3771243,7536629,0.0
DAL227,3p,5,->C,0,0,0,3765386,3771243,7536629,0.0
DAL227,3p,6,->C,0,0,0,3765386,3771243,7536629,0.0
DAL227,3p,7,->C,0,0,0,3765386,3771243,7536629,0.0
DAL227,3p,8,->C,0,0,0,3765386,3771207,7536593,0.0
DAL227,3p,9,->C,0,0,0,3765384,3771218,7536602,0.0
DAL227,3p,10,->C,1,1,2,3765382,3771209,7536591,2.6537196989991893e-07
DAL227,3p,11,->C,0,0,0,3765378,3771214,7536592,0.0
DAL227,3p,12,->C,0,5,5,3765377,3771173,7536550,6.634335339114051e-07
DAL227,3p,13,->C,0,5,5,3765373,3771183,7536556,6.634330057389609e-07
DAL227,3p,14,->C,10,9,19,3765341,3771166,7536507,2.521061812853089e-06
DAL227,3p,15,->C,3,4,7,3765341,3771186,7536527,9.288097820123248e-07
DAL227,3p,16,->C,9,6,15,3765340,3771079,7536419,1.9903351976581983e-06
DAL227,3p,17,->C,9,16,25,3765328,3771049,7536377,3.3172438162262847e-06
DAL227,3p,18,->C,5,13,18,3765321,3771036,7536357,2.388421886065111e-06
DAL227,3p,19,->C,12,9,21,3765313,3771111,7536424,2.786467428053411e-06
DAL227,3p,20,->C,16,16,32,3765308,3771082,7536390,4.246064760448968e-06
DAL227,3p,21,->C,11,26,37,3765307,3771104,7536411,4.9094986990491895e-06
DAL227,3p,22,->C,4,15,19,3765309,3771137,7536446,2.5210822183294352e-06
DAL227,3p,23,->C,12,24,36,3765319,3771112,7536431,4.776796868438124e-06
DAL227,3p,24,->C,15,22,37,3765312,3771081,7536393,4.909510424947319e-06
DAL227,3p,25,->C,18,35,53,3765249,3771100,7536349,7.032583018647358e-06
DAL227,5p,1,->C,0,0,0,3765386,3771243,7536629,0.0
DAL227,5p,2,->C,0,0,0,3765373,3771238,7536611,0.0
DAL227,5p,3,->C,0,0,0,3765386,3771243,7536629,0.0
DAL227,5p,4,->C,0,0,0,3765385,3771243,7536628,0.0
DAL227,5p,5,->C,0,0,0,3765386,3771242,7536628,0.0
DAL227,5p,6,->C,0,0,0,3765386,3771243,7536629,0.0
DAL227,5p,7,->C,0,0,0,3765386,3771243,7536629,0.0
DAL227,5p,8,->C,2,1,3,3765342,3771242,7536584,3.980583245672045e-07
DAL227,5p,9,->C,2,0,2,3765324,3771243,7536567,2.6537281496999893e-07
DAL227,5p,10,->C,5,0,5,3765318,3771238,7536556,6.634330057389609e-07
DAL227,5p,11,->C,3,1,4,3765365,3771237,7536602,5.30743165155862e-07
DAL227,5p,12,->C,7,3,10,3765326,3771232,7536558,1.3268656593633329e-06
DAL227,5p,13,->C,6,2,8,3765325,3771231,7536556,1.0614928091823374e-06
DAL227,5p,14,->C,11,1,12,3765297,3771226,7536523,1.5922461856747468e-06
DAL227,5p,15,->C,11,3,14,3765318,3771201,7536519,1.85762153588414e-06
DAL227,5p,16,->C,9,2,11,3765316,3771188,7536504,1.4595626831751169e-06
DAL227,5p,17,->C,6,10,16,3765326,3771175,7536501,2.1230011115237693e-06
DAL227,5p,18,->C,12,6,18,3765280,3771169,7536449,2.3883927297856058e-06
DAL227,5p,19,->C,19,22,41,3765279,3771164,7536443,5.440232215648682e-06
DAL227,5p,20,->C,8,12,20,3765254,3771167,7536421,2.6537795592894824e-06
DAL227,5p,21,->C,9,27,36,3765270,3771169,7536439,4.77679179782388e-06
DAL227,5p,22,->C,4,6,10,3765253,3771158,7536411,1.3268915402835648e-06
DAL227,5p,23,->C,21,15,36,3765254,3771157,7536411,4.776809545020833e-06
DAL227,5p,24,->C,14,4,18,3765270,3771180,7536450,2.3883924128734357e-06
DAL227,5p,25,->C,12,13,25,3765247,3771148,7536395,3.317235893288502e-06
WA02,3p,1,->C,0,0,0,6552698,6754258,13306956,0.0
WA02,3p,2,->C,0,0,0,6552698,6754258,13306956,0.0
WA02,3p,3,->C,0,0,0,6552698,6754258,13306956,0.0
WA02,3p,4,->C,0,0,0,6552698,6754256,13306954,0.0
WA02,3p,5,->C,0,0,0,6552698,6754256,13306954,0.0
WA02,3p,6,->C,0,1,1,6552698,6754257,13306955,7.514867225447144e-08
WA02,3p,7,->C,0,0,0,6552698,6754257,13306955,0.0
WA02,3p,8,->C,0,9,9,6552692,6754207,13306899,6.763408965529836e-07
WA02,3p,9,->C,0,9,9,6552688,6754191,13306879,6.763419130811966e-07
WA02,3p,10,->C,1,1,2,6552680,6754207,13306887,1.5029811254878772e-07
WA02,3p,11,->C,9,5,14,6552667,6754202,13306869,1.052088210983365e-06
WA02,3p,12,->C,5,9,14,6552670,6754189,13306859,1.0520890016193904e-06
WA02,3p,13,->C,4,28,32,6552675,6754177,13306852,2.4047761258635776e-06
WA02,3p,14,->C,9,16,25,6552653,6754155,13306808,1.8787375605028644e-06
WA02,3p,15,->C,21,21,42,6552632,6754146,13306778,3.1562862174449744e-06
WA02,3p,16,->C,20,33,53,6552629,6754119,13306748,3.98294158723078e-06
WA02,3p,17,->C,22,25,47,6552608,6754116,13306724,3.5320489100097066e-06
WA02,3p,18,->C,20,26,46,6552611,6754085,13306696,3.4569062072207856e-06
WA02,3p,19,->C,13,22,35,6552605,6754056,13306661,2.6302616411434845e-06
WA02,3p,20,->C,18,35,53,6552618,6754033,13306651,3.982970621232946e-06
WA02,3p,21,->C,15,20,35,6552597,6754089,13306686,2.6302566995268394e-06
WA02,3p,22,->C,25,61,86,6552593,6754062,13306655,6.462931518101281e-06
WA02,3p,23,->C,14,28,42,6552585,6754052,13306637,3.1563196621355195e-06
WA02,3p,24,->C,38,62,100,6552556,6754026,13306582,7.515077876497511e-06
WA02,3p,25,->C,36,59,95,6552517,6754038,13306555,7.139338468897472e-06
WA02,5p,1,->C,0,0,0,6552698,6754258,13306956,0.0
WA02,5p,2,->C,0,0,0,6552562,6754179,13306741,0.0
WA02,5p,3,->C,0,0,0,6552698,6754258,13306956,0.0
WA02,5p,4,->C,0,0,0,6552698,6754258,13306956,0.0
WA02,5p,5,->C,0,0,0,6552698,6754258,13306956,0.0
WA02,5p,6,->C,0,0,0,6552697,6754258,13306955,0.0
WA02,5p,7,->C,1,0,1,6552685,6754258,13306943,7.514874002240786e-08
WA02,5p,8,->C,5,0,5,6552655,6754257,13306912,3.7574457545071314e-07
WA02,5p,9,->C,11,20,31,6552662,6754226,13306888,2.3296205694374223e-06
WA02,5p,10,->C,15,4,19,6552618,6754222,13306840,1.427837112342224e-06
WA02,5p,11,->C,8,12,20,6552625,6754225,13306850,1.5029853045611846e-06
WA02,5p,12,->C,16,6,22,6552628,6754236,13306864,1.6532820956162174e-06
WA02,5p,13,->C,12,6,18,6552614,6754205,13306819,1.3526899253683394e-06
WA02,5p,14,->C,17,7,24,6552607,6754183,13306790,1.8035904977834624e-06
WA02,5p,15,->C,27,7,34,6552586,6754168,13306754,2.555093451039976e-06
WA02,5p,16,->C,22,12,34,6552525,6754178,13306703,2.5551032438313238e-06
WA02,5p,17,->C,19,21,40,6552567,6754148,13306715,3.0060011054569067e-06
WA02,5p,18,->C,28,36,64,6552548,6754087,13306635,4.809630684241357e-06
WA02,5p,19,->C,36,26,62,6552516,6754124,13306640,4.65932797460516e-06
WA02,5p,20,->C,32,11,43,6552507,6754132,13306639,3.23146964458869e-06
WA02,5p,21,->C,23,31,54,6552521,6754152,13306673,4.058114300997702e-06
WA02,5p,22,->C,28,14,42,6552516,6754117,13306633,3.156320610931405e-06
WA02,5p,23,->C,35,16,51,6552465,6754131,13306596,3.832685684603335e-06
WA02,5p,24,->C,32,23,55,6552457,6754135,13306592,4.133289725874213e-06
WA02,5p,25,->C,27,22,49,6552470,6754083,13306553,3.6823961847970697e-06
WA03,3p,1,->C,0,0,0,5399458,5543742,10943200,0.0
WA03,3p,2,->C,0,0,0,5399458,5543742,10943200,0.0
WA03,3p,3,->C,0,0,0,5399458,5543742,10943200,0.0
WA03,3p,4,->C,0,0,0,5399458,5543736,10943194,0.0
WA03,3p,5,->C,0,0,0,5399458,5543740,10943198,0.0
WA03,3p,6,->C,0,0,0,5399458,5543741,10943199,0.0
WA03,3p,7,->C,0,1,1,5399458,5543739,10943197,9.138097395121372e-08
WA03,3p,8,->C,6,3,9,5399449,5543673,10943122,8.224344021751745e-07
WA03,3p,9,->C,3,22,25,5399436,5543670,10943106,2.28454334628578e-06
WA03,3p,10,->C,2,8,10,5399438,5543654,10943092,9.138185076027872e-07
WA03,3p,11,->C,5,9,14,5399404,5543644,10943048,1.2793510546604569e-06
WA03,3p,12,->C,7,24,31,5399397,5543595,10942992,2.8328632607974126e-06
WA03,3p,13,->C,28,35,63,5399378,5543551,10942929,5.757142351924243e-06
WA03,3p,14,->C,14,43,57,5399356,5543493,10942849,5.208881160655694e-06
WA03,3p,15,->C,29,53,82,5399349,5543505,10942854,7.493474737029298e-06
WA03,3p,16,->C,33,39,72,5399342,5543495,10942837,6.579646576111844e-06
WA03,3p,17,->C,23,62,85,5399346,5543438,10942784,7.767675940601587e-06
WA03,3p,18,->C,33,63,96,5399325,5543443,10942768,8.772917419066181e-06
WA03,3p,19,->C,31,66,97,5399297,5543425,10942722,8.864339238445425e-06
WA03,3p,20,->C,39,70,109,5399252,5543409,10942661,9.96101405316312e-06
WA03,3p,21,->C,49,55,104,5399248,5543303,10942551,9.504182342855885e-06
WA03,3p,22,->C,44,97,141,5399256,5543263,10942519,1.2885515665999758e-05
WA03,3p,23,->C,43,80,123,5399255,5543267,10942522,1.1240553137567372e-05
WA03,3p,24,->C,76,90,166,5399198,5543130,10942328,1.5170446362053853e-05
WA03,3p,25,->C,70,253,323,5399050,5543142,10942192,2.9518765527053445e-05
WA03,5p,1,->C,0,0,0,5399457,5543742,10943199,0.0
WA03,5p,2,->C,0,0,0,5399258,5543638,10942896,0.0
WA03,5p,3,->C,0,0,0,5399457,5543742,10943199,0.0
WA03,5p,4,->C,0,0,0,5399458,5543742,10943200,0.0
WA03,5p,5,->C,0,0,0,5399456,5543740,10943196,0.0
WA03,5p,6,->C,4,0,4,5399452,5543742,10943194,3.6552399601067113e-07
WA03,5p,7,->C,1,0,1,5399453,5543742,10943195,9.138099065218157e-08
WA03,5p,8,->C,14,4,18,5399403,5543732,10943135,1.6448668503130044e-06
WA03,5p,9,->C,18,3,21,5399319,5543732,10943051,1.919026055896112e-06
WA03,5p,10,->C,26,3,29,5399344,5543717,10943061,2.6500811792970907e-06
WA03,5p,11,->C,18,8,26,5399321,5543705,10943026,2.375942449556457e-06
WA03,5p,12,->C,63,10,73,5399213,5543665,10942878,6.671005561790966e-06
WA03,5p,13,->C,65,9,74,5399156,5543662,10942818,6.762426278130551e-06
WA03,5p,14,->C,78,12,90,5399124,5543629,10942753,8.224621354425162e-06
WA03,5p,15,->C,108,32,140,5399092,5543505,10942597,1.279403783215264e-05
WA03,5p,16,->C,92,27,119,5399083,5543501,10942584,1.0874945076958056e-05
WA03,5p,17,->C,97,30,127,5399113,5543491,10942604,1.1606012609064533e-05
WA03,5p,18,->C,96,28,124,5399074,5543600,10942674,1.1331782341318036e-05
WA03,5p,19,->C,102,32,134,5399071,5543546,10942617,1.2245699543354208e-05
WA03,5p,20,->C,120,49,169,5399050,5543533,10942583,1.5444251142531887e-05
WA03,5p,21,->C,106,46,152,5399034,5543509,10942543,1.3890738194951576e-05
WA03,5p,22,->C,105,30,135,5398989,5543454,10942443,1.2337281537587172e-05
WA03,5p,23,->C,126,63,189,5398935,5543457,10942392,1.7272274654390007e-05
WA03,5p,24,->C,163,72,235,5398952,5543428,10942380,2.147613224910851e-05
WA03,5p,25,->C,119,71,190,5398991,5543444,10942435,1.7363594117762636e-05
WA07,3p,1,->C,0,0,0,5691729,6013979,11705708,0.0
WA07,3p,2,->C,0,0,0,5691729,6013979,11705708,0.0
WA07,3p,3,->C,0,0,0,5691729,6013979,11705708,0.0
WA07,3p,4,->C,0,0,0,5691729,6013979,11705708,0.0
WA07,3p,5,->C,0,0,0,5691729,6013979,11705708,0.0
WA07,3p,6,->C,0,0,0,5691729,6013979,11705708,0.0
WA07,3p,7,->C,0,0,0,5691729,6013979,11705708,0.0
WA07,3p,8,->C,2,0,2,5691713,6013800,11705513,1.7085966245135945e-07
WA07,3p,9,->C,2,2,4,5691720,6013901,11705621,3.417161720851888e-07
WA07,3p,10,->C,0,9,9,5691718,6013892,11705610,7.688621097063715e-07
WA07,3p,11,->C,2,3,5,5691711,6013883,11705594,4.271462003551465e-07
WA07,3p,12,->C,4,23,27,5691705,6013884,11705589,2.3065904671691448e-06
WA07,3p,13,->C,3,20,23,5691711,6013848,11705559,1.9648783966660627e-06
WA07,3p,14,->C,4,4,8,5691695,6013877,11705572,6.834352050459388e-07
WA07,3p,15,->C,17,9,26,5691211,6013856,11705067,2.2212602456696743e-06
WA07,3p,16,->C,15,25,40,5691636,6013850,11705486,3.4172011311619184e-06
WA07,3p,17,->C,13,17,30,5691662,6013813,11705475,2.5629032568093137e-06
WA07,3p,18,->C,23,36,59,5691639,6013769,11705408,5.040405255416984e-06
WA07,3p,19,->C,8,48,56,5691628,6013742,11705370,4.7841289937866125e-06
WA07,3p,20,->C,16,37,53,5691604,6013772,11705376,4.527834048218528e-06
WA07,3p,21,->C,23,54,77,5691611,6013735,11705346,6.5781908539909885e-06
WA07,3p,22,->C,14,44,58,5691577,6013736,11705313,4.955014872306277e-06
WA07,3p,23,->C,38,50,88,5691568,6013670,11705238,7.518001769805962e-06
WA07,3p,24,->C,37,60,97,5691554,6013661,11705215,8.28690459765156e-06
WA07,3p,25,->C,37,76,113,5691455,6013662,11705117,9.653897521912851e-06
WA07,5p,1,->C,0,0,0,5691729,6013979,11705708,0.0
WA07,5p,2,->C,0,0,0,5691636,6013923,11705559,0.0
WA07,5p,3,->C,0,0,0,5691729,6013979,11705708,0.0
WA07,5p,4,->C,0,0,0,5691728,6013979,11705707,0.0
WA07,5p,5,->C,0,0,0,5691729,6013978,11705707,0.0
WA07,5p,6,->C,0,0,0,5691728,6013979,11705707,0.0
WA07,5p,7,->C,0,0,0,5691728,6013979,11705707,0.0
WA07,5p,8,->C,117,1,118,5691579,6013975,11705554,1.0080684775791049e-05
WA07,5p,9,->C,5,2,7,5691672,6013971,11705643,5.980021772404985e-07
WA07,5p,10,->C,75,4,79,5691582,6013961,11705543,6.748939370006159e-06
WA07,5p,11,->C,357,0,357,5691326,6013942,11705268,3.049908810289521e-05
WA07,5p,12,->C,130,4,134,5691520,6013938,11705458,1.1447651172641002e-05
WA07,5p,13,->C,113,3,116,5691511,6013949,11705460,9.909905292060286e-06
WA07,5p,14,->C,55,4,59,5691556,6013950,11705506,5.040363056496661e-06
WA07,5p,15,->C,48,6,54,5691563,6013633,11705196,4.613335821117391e-06
WA07,5p,16,->C,33,9,42,5691534,6013925,11705459,3.5880694639996605e-06
WA07,5p,17,->C,45,10,55,5691561,6013916,11705477,4.698655168003832e-06
WA07,5p,18,->C,68,12,80,5691474,6013905,11705379,6.834464736255016e-06
WA07,5p,19,->C,55,28,83,5691482,6013884,11705366,7.090765038871916e-06
WA07,5p,20,->C,56,35,91,5691421,6013876,11705297,7.774258098705227e-06
WA07,5p,21,->C,74,23,97,5691379,6013853,11705232,8.286892562232e-06
WA07,5p,22,->C,73,28,101,5691396,6013861,11705257,8.628601661629472e-06
WA07,5p,23,->C,143,31,174,5691314,6013795,11705109,1.4865303689183927e-05
WA07,5p,24,->C,77,29,106,5691332,6013785,11705117,9.055868471882853e-06
WA07,5p,25,->C,147,45,192,5691334,6013719,11705053,1.6403172202637612e-05
WA08,3p,1,->C,0,0,0,6798117,7189085,13987202,0.0
WA08,3p,2,->C,0,0,0,6798117,7189085,13987202,0.0
WA08,3p,3,->C,0,0,0,6798117,7189085,13987202,0.0
WA08,3p,4,->C,0,0,0,6798117,7189081,13987198,0.0
WA08,3p,5,->C,0,0,0,6798117,7189085,13987202,0.0
WA08,3p,6,->C,0,0,0,6798117,7189085,13987202,0.0
WA08,3p,7,->C,0,0,0,6798117,7189084,13987201,0.0
WA08,3p,8,->C,2,4,6,6798110,7189053,13987163,4.289647586147384e-07
WA08,3p,9,->C,2,9,11,6798103,7189051,13987154,7.864358968236141e-07
WA08,3p,10,->C,7,10,17,6798074,7189042,13987116,1.2154042334388305e-06
WA08,3p,11,->C,3,7,10,6798109,7189046,13987155,7.149416732709403e-07
WA08,3p,12,->C,3,12,15,6798091,7189018,13987109,1.0724160367950233e-06
WA08,3p,13,->C,5,7,12,6798090,7189013,13987103,8.579331974605463e-07
WA08,3p,14,->C,13,16,29,6798067,7188981,13987048,2.07334671333079e-06
WA08,3p,15,->C,14,25,39,6798069,7188978,13987047,2.7882940552069354e-06
WA08,3p,16,->C,13,21,34,6798049,7188961,13987010,2.430826888663124e-06
WA08,3p,17,->C,47,11,58,6798000,7188943,13986943,4.146724555894737e-06
WA08,3p,18,->C,22,15,37,6798023,7188956,13986979,2.645317477062059e-06
WA08,3p,19,->C,23,16,39,6798028,7188946,13986974,2.788308607708858e-06
WA08,3p,20,->C,28,15,43,6798009,7188917,13986926,3.0742995280020785e-06
WA08,3p,21,->C,16,17,33,6798010,7188926,13986936,2.359344462575649e-06
WA08,3p,22,->C,20,17,37,6798012,7188920,13986932,2.645326366067984e-06
WA08,3p,23,->C,23,24,47,6798009,7188864,13986873,3.36029361244647e-06
WA08,3p,24,->C,25,47,72,6798015,7188867,13986882,5.147680519503918e-06
WA08,3p,25,->C,23,49,72,6797966,7188892,13986858,5.147689352390651e-06
WA08,5p,1,->C,0,0,0,6798116,7189085,13987201,0.0
WA08,5p,2,->C,0,0,0,6797941,7188997,13986938,0.0
WA08,5p,3,->C,0,0,0,6798117,7189084,13987201,0.0
WA08,5p,4,->C,0,0,0,6798115,7189085,13987200,0.0
WA08,5p,5,->C,0,0,0,6798116,7189084,13987200,0.0
WA08,5p,6,->C,0,0,0,6798112,7189085,13987197,0.0
WA08,5p,7,->C,1,0,1,6798110,7189085,13987195,7.149396287104027e-08
WA08,5p,8,->C,11,1,12,6798069,7189064,13987133,8.579313573410648e-07
WA08,5p,9,->C,6,5,11,6798054,7189067,13987121,7.86437752272251e-07
WA08,5p,10,->C,22,1,23,6798015,7189037,13987052,1.644377957556746e-06
WA08,5p,11,->C,52,5,57,6797997,7189047,13987044,4.075199877829797e-06
WA08,5p,12,->C,49,3,52,6798016,7189056,13987072,3.717718762011092e-06
WA08,5p,13,->C,28,4,32,6797995,7189043,13987038,2.28783249176845e-06
WA08,5p,14,->C,42,1,43,6797984,7189041,13987025,3.074277768145835e-06
WA08,5p,15,->C,25,11,36,6797997,7189013,13987010,2.573816705643308e-06
WA08,5p,16,->C,48,12,60,6797921,7188997,13986918,4.289722725192212e-06
WA08,5p,17,->C,37,14,51,6797959,7188875,13986834,3.646286214592952e-06
WA08,5p,18,->C,17,35,52,6797991,7188972,13986963,3.7177477340863776e-06
WA08,5p,19,->C,34,27,61,6797966,7188988,13986954,4.361206878924461e-06
WA08,5p,20,->C,104,32,136,6797883,7188971,13986854,9.723416001911507e-06
WA08,5p,21,->C,30,20,50,6797885,7188979,13986864,3.5747827390042545e-06
WA08,5p,22,->C,44,25,69,6797887,7188939,13986826,4.93321358255261e-06
WA08,5p,23,->C,71,38,109,6797851,7188919,13986770,7.793078745128432e-06
WA08,5p,24,->C,54,34,88,6797841,7188876,13986717,6.291683745370697e-06
WA08,5p,25,->C,51,57,108,6797835,7188817,13986652,7.721647753872763e-06
WA09,3p,1,->C,0,0,0,4741672,4881751,9623423,0.0
WA09,3p,2,->C,0,0,0,4741672,4881751,9623423,0.0
WA09,3p,3,->C,0,0,0,4741672,4881751,9623423,0.0
WA09,3p,4,->C,0,0,0,4741672,4881748,9623420,0.0
WA09,3p,5,->C,0,0,0,4741672,4881751,9623423,0.0
WA09,3p,6,->C,0,0,0,4741672,4881751,9623423,0.0
WA09,3p,7,->C,0,2,2,4741672,4881748,9623420,2.0782632369781227e-07
WA09,3p,8,->C,5,0,5,4741663,4881718,9623381,5.195679148523788e-07
WA09,3p,9,->C,1,3,4,4741664,4881723,9623387,4.156540727292792e-07
WA09,3p,10,->C,1,1,2,4741658,4881705,9623363,2.078275546708568e-07
WA09,3p,11,->C,3,6,9,4741648,4881712,9623360,9.352242875669204e-07
WA09,3p,12,->C,4,13,17,4741642,4881680,9623322,1.7665417409913125e-06
WA09,3p,13,->C,16,31,47,4741628,4881645,9623273,4.883993211041607e-06
WA09,3p,14,->C,10,41,51,4741616,4881571,9623187,5.299699569383823e-06
WA09,3p,15,->C,20,66,86,4741598,4881557,9623155,8.936778010953788e-06
WA09,3p,16,->C,15,38,53,4741586,4881546,9623132,5.507562402760349e-06
WA09,3p,17,->C,19,70,89,4741582,4881528,9623110,9.24856932945794e-06
WA09,3p,18,->C,20,63,83,4741560,4881490,9623050,8.625124051106458e-06
WA09,3p,19,->C,35,53,88,4741552,4881442,9622994,9.144763053993385e-06
WA09,3p,20,->C,33,67,100,4741534,4881501,9623035,1.039173192241325e-05
WA09,3p,21,->C,17,57,74,4741546,4881493,9623039,7.689878426139601e-06
WA09,3p,22,->C,31,66,97,4741524,4881498,9623022,1.0079993582057696e-05
WA09,3p,23,->C,21,49,70,4741501,4881486,9622987,7.274248629869291e-06
WA09,3p,24,->C,44,62,106,4741491,4881450,9622941,1.1015343438144326e-05
WA09,3p,25,->C,56,50,106,4741451,4881469,9622920,1.1015367476815769e-05
WA09,5p,1,->C,0,0,0,4741672,4881751,9623423,0.0
WA09,5p,2,->C,0,0,0,4741495,4881667,9623162,0.0
WA09,5p,3,->C,0,0,0,4741672,4881750,9623422,0.0
WA09,5p,4,->C,0,0,0,4741672,4881751,9623423,0.0
WA09,5p,5,->C,0,0,0,4741671,4881751,9623422,0.0
WA09,5p,6,->C,0,0,0,4741669,4881751,9623420,0.0
WA09,5p,7,->C,0,0,0,4741667,4881751,9623418,0.0
WA09,5p,8,->C,2,2,4,4741639,4881744,9623383,4.156542454976592e-07
WA09,5p,9,->C,2,1,3,4741618,4881747,9623365,3.1174126721785984e-07
WA09,5p,10,->C,7,0,7,4741622,4881737,9623359,7.273967436941716e-07
WA09,5p,11,->C,14,2,16,4741614,4881733,9623347,1.6626232016781686e-06
WA09,5p,12,->C,22,2,24,4741580,4881734,9623314,2.4939433546489288e-06
WA09,5p,13,->C,23,4,27,4741530,4881708,9623238,2.8057084320267253e-06
WA09,5p,14,->C,41,8,49,4741498,4881705,9623203,5.091859747736799e-06
WA09,5p,15,->C,46,18,64,4741496,4881672,9623168,6.650616512150676e-06
WA09,5p,16,->C,37,19,56,4741451,4881636,9623087,5.819338430588853e-06
WA09,5p,17,->C,31,16,47,4741476,4881638,9623114,4.884073907884704e-06
WA09,5p,18,->C,44,23,67,4741455,4881610,9623065,6.962438682477984e-06
WA09,5p,19,->C,63,23,86,4741379,4881580,9622959,8.936960034849988e-06
WA09,5p,20,->C,57,26,83,4741390,4881557,9622947,8.62521637082694e-06
WA09,5p,21,->C,73,42,115,4741379,4881587,9622966,1.1950577399940934e-05
WA09,5p,22,->C,69,56,125,4741354,4881580,9622934,1.2989801239414091e-05
WA09,5p,23,->C,89,52,141,4741312,4881565,9622877,1.465258259042488e-05
WA09,5p,24,->C,72,53,125,4741363,4881548,9622911,1.2989832286716566e-05
WA09,5p,25,->C,59,79,138,4741301,4881503,9622804,1.4340934305634824e-05
WA11,3p,1,->C,0,0,0,9756642,10108269,19864911,0.0
WA11,3p,2,->C,0,0,0,9756642,10108269,19864911,0.0
WA11,3p,3,->C,0,0,0,9756642,10108269,19864911,0.0
WA11,3p,4,->C,0,0,0,9756642,10108267,19864909,0.0
WA11,3p,5,->C,0,0,0,9756642,10108269,19864911,0.0
WA11,3p,6,->C,0,0,0,9756642,10108269,19864911,0.0
WA11,3p,7,->C,0,1,1,9756642,10108265,19864907,5.034002927876783e-08
WA11,3p,8,->C,3,7,10,9756629,10108160,19864789,5.034032830653273e-07
WA11,3p,9,->C,8,10,18,9756610,10108092,19864702,9.061298780117616e-07
WA11,3p,10,->C,8,193,201,9756615,10107969,19864584,1.0118510410285963e-05
WA11,3p,11,->C,7,41,48,9756587,10107918,19864505,2.416370304721915e-06
WA11,3p,12,->C,8,89,97,9756581,10108019,19864600,4.883058304722974e-06
WA11,3p,13,->C,21,68,89,9756565,10107963,19864528,4.480348085793934e-06
WA11,3p,14,->C,35,153,188,9756515,10107914,19864429,9.464153235917327e-06
WA11,3p,15,->C,27,23,50,9756471,10107972,19864443,2.517060256861972e-06
WA11,3p,16,->C,36,35,71,9756477,10108011,19864488,3.574217467875336e-06
WA11,3p,17,->C,36,50,86,9756469,10108044,19864513,4.3293283857500055e-06
WA11,3p,18,->C,52,42,94,9756421,10108016,19864437,4.73207471221057e-06
WA11,3p,19,->C,34,55,89,9756438,10108000,19864438,4.48036838495003e-06
WA11,3p,20,->C,41,59,100,9756433,10107963,19864396,5.0341324246657184e-06
WA11,3p,21,->C,52,69,121,9756421,10107904,19864325,6.091322005655868e-06
WA11,3p,22,->C,47,89,136,9756405,10107842,19864247,6.846471451950834e-06
WA11,3p,23,->C,53,83,136,9756375,10107816,19864191,6.846490753134623e-06
WA11,3p,24,->C,51,97,148,9756358,10107704,19864062,7.450641263604594e-06
WA11,3p,25,->C,73,97,170,9756281,10107693,19863974,8.558206932812135e-06
WA11,5p,1,->C,0,0,0,9756641,10108269,19864910,0.0
WA11,5p,2,->C,0,0,0,9756471,10108196,19864667,0.0
WA11,5p,3,->C,0,0,0,9756642,10108269,19864911,0.0
WA11,5p,4,->C,0,0,0,9756638,10108269,19864907,0.0
WA11,5p,5,->C,1,0,1,9756638,10108267,19864905,5.034003434700544e-08
WA11,5p,6,->C,0,0,0,9756642,10108269,19864911,0.0
WA11,5p,7,->C,0,0,0,9756629,10108269,19864898,0.0
WA11,5p,8,->C,55,1,56,9756500,10108261,19864761,2.8190623587165232e-06
WA11,5p,9,->C,45,4,49,9756493,10108240,19864733,2.466683040743613e-06
WA11,5p,10,->C,41,2,43,9756446,10108197,19864643,2.164650026683087e-06
WA11,5p,11,->C,53,6,59,9756457,10108195,19864652,2.970099853750269e-06
WA11,5p,12,->C,53,3,56,9756411,10108221,19864632,2.8190806655768907e-06
WA11,5p,13,->C,60,11,71,9756334,10108178,19864512,3.574213149560382e-06
WA11,5p,14,->C,67,10,77,9756261,10108167,19864428,3.876275722613306e-06
WA11,5p,15,->C,55,13,68,9756237,10108096,19864333,3.4232209055295235e-06
WA11,5p,16,->C,73,40,113,9756275,10108079,19864354,5.6885816674431e-06
WA11,5p,17,->C,56,44,100,9756369,10108078,19864447,5.034119500029374e-06
WA11,5p,18,->C,61,16,77,9756327,10108075,19864402,3.876280796169953e-06
WA11,5p,19,->C,82,39,121,9756284,10108088,19864372,6.091307593313295e-06
WA11,5p,20,->C,65,37,102,9756292,10108082,19864374,5.134820760019923e-06
WA11,5p,21,->C,84,55,139,9756251,10108036,19864287,6.99748246690153e-06
WA11,5p,22,->C,143,37,180,9756136,10108029,19864165,9.061543739694066e-06
WA11,5p,23,->C,165,44,209,9756095,10108016,19864111,1.0521487722254473e-05
WA11,5p,24,->C,120,52,172,9756046,10108010,19864056,8.658855975838972e-06
WA11,5p,25,->C,162,60,222,9756056,10107943,19863999,1.117599734071674e-05
WA12,3p,1,->C,0,0,0,6632243,6940679,13572922,0.0
WA12,3p,2,->C,0,0,0,6632243,6940679,13572922,0.0
WA12,3p,3,->C,0,0,0,6632243,6940679,13572922,0.0
WA12,3p,4,->C,0,0,0,6632243,6940676,13572919,0.0
WA12,3p,5,->C,0,0,0,6632243,6940678,13572921,0.0
WA12,3p,6,->C,0,0,0,6632243,6940679,13572922,0.0
WA12,3p,7,->C,0,0,0,6632243,6940676,13572919,0.0
WA12,3p,8,->C,0,0,0,6632240,6940664,13572904,0.0
WA12,3p,9,->C,0,2,2,6632231,6940656,13572887,1.4735258607840766e-07
WA12,3p,10,->C,7,4,11,6632228,6940644,13572872,8.104401190845976e-07
WA12,3p,11,->C,0,5,5,6632231,6940642,13572873,3.68381845170142e-07
WA12,3p,12,->C,3,14,17,6632223,6940615,13572838,1.2525015033701868e-06
WA12,3p,13,->C,12,10,22,6632204,6940591,13572795,1.6208894336059745e-06
WA12,3p,14,->C,14,22,36,6632209,6940533,13572742,2.6523748848979817e-06
WA12,3p,15,->C,14,69,83,6632188,6940474,13572662,6.115233695497611e-06
WA12,3p,16,->C,21,67,88,6632187,6940478,13572665,6.483619834424558e-06
WA12,3p,17,->C,18,36,54,6632168,6940473,13572641,3.978591933581681e-06
WA12,3p,18,->C,13,41,54,6632160,6940482,13572642,3.978591640448484e-06
WA12,3p,19,->C,28,90,118,6632121,6940435,13572556,8.694014598282003e-06
WA12,3p,20,->C,35,64,99,6632105,6940432,13572537,7.294141102728252e-06
WA12,3p,21,->C,39,54,93,6632096,6940454,13572550,6.852065381965806e-06
WA12,3p,22,->C,103,69,172,6632039,6940438,13572477,1.2672705210699564e-05
WA12,3p,23,->C,37,67,104,6631950,6940459,13572409,7.662604332068096e-06
WA12,3p,24,->C,100,66,166,6631933,6940411,13572344,1.2230753950828242e-05
WA12,3p,25,->C,118,83,201,6631986,6940428,13572414,1.4809450993758369e-05
WA12,5p,1,->C,0,0,0,6632243,6940679,13572922,0.0
WA12,5p,2,->C,0,0,0,6631949,6940524,13572473,0.0
WA12,5p,3,->C,0,0,0,6632242,6940678,13572920,0.0
WA12,5p,4,->C,1,0,1,6632242,6940679,13572921,7.367610848099683e-08
WA12,5p,5,->C,0,0,0,6632242,6940677,13572919,0.0
WA12,5p,6,->C,0,0,0,6632242,6940679,13572921,0.0
WA12,5p,7,->C,2,0,2,6632238,6940679,13572917,1.4735226038735814e-07
WA12,5p,8,->C,10,4,14,6632204,6940670,13572874,1.0314690904815e-06
WA12,5p,9,->C,8,0,8,6632209,6940675,13572884,5.89410474590367e-07
WA12,5p,10,->C,14,1,15,6632199,6940665,13572864,1.1051462683189044e-06
WA12,5p,11,->C,15,1,16,6632166,6940667,13572833,1.178825378607399e-06
WA12,5p,12,->C,25,4,29,6632126,6940660,13572786,2.1366283974417637e-06
WA12,5p,13,->C,39,3,42,6632065,6940658,13572723,3.0944416975134616e-06
WA12,5p,14,->C,57,5,62,6632026,6940638,13572664,4.568005219903771e-06
WA12,5p,15,->C,56,8,64,6631987,6940631,13572618,4.7153762081862175e-06
WA12,5p,16,->C,59,7,66,6631930,6940590,13572520,4.86276682591e-06
WA12,5p,17,->C,95,14,109,6631958,6940621,13572579,8.03089818081e-06
WA12,5p,18,->C,52,37,89,6632019,6940577,13572596,6.55733066835556e-06
WA12,5p,19,->C,60,27,87,6631996,6940532,13572528,6.410007037745658e-06
WA12,5p,20,->C,79,17,96,6631973,6940532,13572505,7.07312320017565e-06
WA12,5p,21,->C,81,37,118,6631936,6940534,13572470,8.694069686652467e-06
WA12,5p,22,->C,76,46,122,6631921,6940529,13572450,8.988797158950669e-06
WA12,5p,23,->C,59,45,104,6631926,6940534,13572460,7.662575538995879e-06
WA12,5p,24,->C,70,55,125,6631934,6940518,13572452,9.209831797526342e-06
WA12,5p,25,->C,64,38,102,6631933,6940515,13572448,7.515224961628145e-06
WA13,3p,1,->C,0,0,0,5896847,6081528,11978375,0.0
WA13,3p,2,->C,0,0,0,5896847,6081528,11978375,0.0
WA13,3p,3,->C,0,0,0,5896847,6081528,11978375,0.0
WA13,3p,4,->C,0,0,0,5896847,6081522,11978369,0.0
WA13,3p,5,->C,0,0,0,5896847,6081527,11978374,0.0
WA13,3p,6,->C,0,0,0,5896847,6081528,11978375,0.0
WA13,3p,7,->C,0,0,0,5896847,6081528,11978375,0.0
WA13,3p,8,->C,0,0,0,5896845,6081521,11978366,0.0
WA13,3p,9,->C,2,1,3,5896842,6081517,11978359,2.504516687135525e-07
WA13,3p,10,->C,0,0,0,5896843,6081517,11978360,0.0
WA13,3p,11,->C,0,1,1,5896841,6081492,11978333,8.348407078013276e-08
WA13,3p,12,->C,4,1,5,5896836,6081505,11978341,4.174200751172471e-07
WA13,3p,13,->C,3,1,4,5896834,6081495,11978329,3.339363946340095e-07
WA13,3p,14,->C,7,14,21,5896832,6081501,11978333,1.753165486382788e-06
WA13,3p,15,->C,7,6,13,5896825,6081505,11978330,1.0852931919558068e-06
WA13,3p,16,->C,1,6,7,5896830,6081509,11978339,5.843882027382928e-07
WA13,3p,17,->C,5,11,16,5896823,6081499,11978322,1.3357463591311037e-06
WA13,3p,18,->C,2,4,6,5896827,6081499,11978326,5.009047174037508e-07
WA13,3p,19,->C,5,13,18,5896822,6081480,11978302,1.5027171630837158e-06
WA13,3p,20,->C,3,42,45,5896818,6081448,11978266,3.7568041985375847e-06
WA13,3p,21,->C,4,11,15,5896824,6081466,11978290,1.2522655571037268e-06
WA13,3p,22,->C,6,14,20,5896824,6081460,11978284,1.6696882458288682e-06
WA13,3p,23,->C,7,17,24,5896819,6081454,11978273,2.003627734983165e-06
WA13,3p,24,->C,6,26,32,5896803,6081440,11978243,2.671510337534478e-06
WA13,3p,25,->C,6,27,33,5896783,6081437,11978220,2.7550003255909475e-06
WA13,5p,1,->C,0,0,0,5896847,6081528,11978375,0.0
WA13,5p,2,->C,0,0,0,5896725,6081443,11978168,0.0
WA13,5p,3,->C,0,0,0,5896847,6081528,11978375,0.0
WA13,5p,4,->C,0,0,0,5896841,6081528,11978369,0.0
WA13,5p,5,->C,0,0,0,5896841,6081528,11978369,0.0
WA13,5p,6,->C,0,0,0,5896841,6081528,11978369,0.0
WA13,5p,7,->C,0,0,0,5896845,6081528,11978373,0.0
WA13,5p,8,->C,0,1,1,5896843,6081526,11978369,8.348381987564417e-08
WA13,5p,9,->C,0,2,2,5896837,6081518,11978355,1.6696783489886548e-07
WA13,5p,10,->C,0,2,2,5896833,6081518,11978351,1.6696789065539988e-07
WA13,5p,11,->C,4,2,6,5896827,6081513,11978340,5.009041319581845e-07
WA13,5p,12,->C,4,11,15,5896822,6081502,11978324,1.2522620025973584e-06
WA13,5p,13,->C,7,0,7,5896809,6081508,11978317,5.843892760560603e-07
WA13,5p,14,->C,16,5,21,5896802,6081520,11978322,1.7531670963595736e-06
WA13,5p,15,->C,8,5,13,5896798,6081508,11978306,1.085295366473356e-06
WA13,5p,16,->C,13,5,18,5896754,6081491,11978245,1.502724313954173e-06
WA13,5p,17,->C,11,4,15,5896805,6081514,11978319,1.2522625253176176e-06
WA13,5p,18,->C,11,2,13,5896796,6081504,11978300,1.085295910104105e-06
WA13,5p,19,->C,9,7,16,5896797,6081472,11978269,1.3357522693804922e-06
WA13,5p,20,->C,13,8,21,5896788,6081482,11978270,1.7531747071989528e-06
WA13,5p,21,->C,17,3,20,5896782,6081484,11978266,1.6696907549055932e-06
WA13,5p,22,->C,16,7,23,5896771,6081483,11978254,1.920146291771739e-06
WA13,5p,23,->C,19,3,22,5896768,6081501,11978269,1.836659370398177e-06
WA13,5p,24,->C,12,7,19,5896781,6081498,11978279,1.5862044956541757e-06
WA13,5p,25,->C,19,7,26,5896769,6081462,11978231,2.170604323793722e-06
WA14,3p,1,->C,0,0,0,6684341,7140972,13825313,0.0
WA14,3p,2,->C,0,0,0,6684341,7140972,13825313,0.0
WA14,3p,3,->C,0,0,0,6684341,7140972,13825313,0.0
WA14,3p,4,->C,0,0,0,6684341,7140971,13825312,0.0
WA14,3p,5,->C,0,0,0,6684341,7140970,13825311,0.0
WA14,3p,6,->C,0,0,0,6684341,7140971,13825312,0.0
WA14,3p,7,->C,0,0,0,6684341,7140969,13825310,0.0
WA14,3p,8,->C,0,2,2,6684326,7140932,13825258,1.446627614472005e-07
WA14,3p,9,->C,3,4,7,6684323,7140920,13825243,5.063202144078046e-07
WA14,3p,10,->C,0,4,4,6684256,7140912,13825168,2.893274063649715e-07
WA14,3p,11,->C,8,1,9,6684256,7140894,13825150,6.509875118895635e-07
WA14,3p,12,->C,5,12,17,6684291,7140849,13825140,1.2296439674390275e-06
WA14,3p,13,->C,5,16,21,6684289,7140794,13825083,1.5189782224092253e-06
WA14,3p,14,->C,20,20,40,6684291,7140742,13825033,2.89330231616807e-06
WA14,3p,15,->C,7,45,52,6684271,7140702,13824973,3.7613093349260074e-06
WA14,3p,16,->C,12,36,48,6684263,7140648,13824911,3.47199341825781e-06
WA14,3p,17,->C,12,44,56,6684212,7140653,13824865,4.050672465879414e-06
WA14,3p,18,->C,40,49,89,6684177,7140647,13824824,6.437694975357372e-06
WA14,3p,19,->C,28,68,96,6684172,7140542,13824714,6.944085787235815e-06
WA14,3p,20,->C,53,62,115,6684176,7140544,13824720,8.318432489048603e-06
WA14,3p,21,->C,57,61,118,6684132,7140443,13824575,8.53552460021375e-06
WA14,3p,22,->C,67,52,119,6684105,7140560,13824665,8.607803516396237e-06
WA14,3p,23,->C,98,82,180,6683638,7140562,13824200,1.3020644955946818e-05
WA14,3p,24,->C,530,80,610,6683623,7140532,13824155,4.412566265352204e-05
WA14,3p,25,->C,491,68,559,6683613,7140513,13824126,4.043655273396669e-05
WA14,5p,1,->C,0,0,0,6684341,7140972,13825313,0.0
WA14,5p,2,->C,0,0,0,6684184,7140911,13825095,0.0
WA14,5p,3,->C,0,0,0,6684338,7140972,13825310,0.0
WA14,5p,4,->C,0,0,0,6684341,7140972,13825313,0.0
WA14,5p,5,->C,0,0,0,6684341,7140972,13825313,0.0
WA14,5p,6,->C,1,0,1,6684340,7140972,13825312,7.23310982059573e-08
WA14,5p,7,->C,0,0,0,6684336,7140972,13825308,0.0
WA14,5p,8,->C,3,0,3,6684277,7140970,13825247,2.169943148212831e-07
WA14,5p,9,->C,11,1,12,6684241,7140959,13825200,8.679802100512109e-07
WA14,5p,10,->C,13,4,17,6684210,7140628,13824838,1.2296708286925315e-06
WA14,5p,11,->C,33,2,35,6684218,7140646,13824864,2.53167047429906e-06
WA14,5p,12,->C,60,6,66,6684139,7140917,13825056,4.773940879516148e-06
WA14,5p,13,->C,121,1,122,6684018,7140931,13824949,8.824625682163456e-06
WA14,5p,14,->C,107,2,109,6683951,7140942,13824893,7.884328652670223e-06
WA14,5p,15,->C,80,5,85,6684030,7140908,13824938,6.148309670538848e-06
WA14,5p,16,->C,117,22,139,6683910,7140868,13824778,1.005441100030684e-05
WA14,5p,17,->C,182,21,203,6683904,7140873,13824777,1.468378115610834e-05
WA14,5p,18,->C,121,8,129,6683891,7140646,13824537,9.3312347458725e-06
WA14,5p,19,->C,124,26,150,6683958,7140595,13824553,1.085026040263291e-05
WA14,5p,20,->C,169,18,187,6683860,7140558,13824418,1.352679006089081e-05
WA14,5p,21,->C,132,42,174,6683480,7140494,13823974,1.2586829228700804e-05
WA14,5p,22,->C,218,48,266,6683768,7140398,13824166,1.9241667092249903e-05
WA14,5p,23,->C,190,62,252,6683762,7140257,13824019,1.8229141612146225e-05
WA14,5p,24,->C,229,77,306,6683714,7140421,13824135,2.213520050259926e-05
WA14,5p,25,->C,202,43,245,6683731,7140511,13824242,1.772249067977832e-05
WA18,3p,1,->C,0,0,0,14112928,14131239,28244167,0.0
WA18,3p,2,->C,0,0,0,14112928,14131239,28244167,0.0
WA18,3p,3,->C,0,0,0,14112928,14131239,28244167,0.0
WA18,3p,4,->C,0,0,0,14112928,14131238,28244166,0.0
WA18,3p,5,->C,0,0,0,14112928,14131239,28244167,0.0
WA18,3p,6,->C,0,0,0,14112928,14131239,28244167,0.0
WA18,3p,7,->C,0,0,0,14112928,14131237,28244165,0.0
WA18,3p,8,->C,0,4,4,14112927,14131187,28244114,1.4162242795082898e-07
WA18,3p,9,->C,3,1,4,14112909,14131177,28244086,1.4162256834935285e-07
WA18,3p,10,->C,0,5,5,14112909,14131197,28244106,1.770280850808307e-07
WA18,3p,11,->C,4,8,12,14112900,14131167,28244067,4.248679908598149e-07
WA18,3p,12,->C,2,29,31,14112895,14131136,28244031,1.0975770420305798e-06
WA18,3p,13,->C,3,46,49,14112898,14131061,28243959,1.7348842632153658e-06
WA18,3p,14,->C,28,67,95,14112830,14131006,28243836,3.363565770598583e-06
WA18,3p,15,->C,15,78,93,14112809,14130957,28243766,3.292762020475598e-06
WA18,3p,16,->C,35,66,101,14112765,14130927,28243692,3.5760197356634537e-06
WA18,3p,17,->C,27,160,187,14112743,14130850,28243593,6.620970639252591e-06
WA18,3p,18,->C,52,115,167,14112708,14130769,28243477,5.912869722095477e-06
WA18,3p,19,->C,36,101,137,14112724,14130771,28243495,4.850674465040534e-06
WA18,3p,20,->C,33,86,119,14112697,14130797,28243494,4.213359721003358e-06
WA18,3p,21,->C,52,86,138,14112659,14130783,28243442,4.886090016932072e-06
WA18,3p,22,->C,58,100,158,14112575,14130715,28243290,5.594249111912954e-06
WA18,3p,23,->C,88,137,225,14112548,14130648,28243196,7.966520502849607e-06
WA18,3p,24,->C,66,146,212,14112551,14130690,28243241,7.5062206918816436e-06
WA18,3p,25,->C,88,107,195,14112486,14130651,28243137,6.904332192277366e-06
WA18,5p,1,->C,0,0,0,14112926,14131239,28244165,0.0
WA18,5p,2,->C,0,0,0,14112820,14131183,28244003,0.0
WA18,5p,3,->C,0,0,0,14112928,14131239,28244167,0.0
WA18,5p,4,->C,0,0,0,14112928,14131239,28244167,0.0
WA18,5p,5,->C,0,0,0,14112925,14131239,28244164,0.0
WA18,5p,6,->C,0,0,0,14112927,14131239,28244166,0.0
WA18,5p,7,->C,3,0,3,14112921,14131239,28244160,1.0621664797253664e-07
WA18,5p,8,->C,4,1,5,14112828,14131230,28244058,1.770283859351939e-07
WA18,5p,9,->C,2,1,3,14112833,14131230,28244063,1.0621701275769e-07
WA18,5p,10,->C,6,5,11,14112791,14131213,28244004,3.8946319367466453e-07
WA18,5p,11,->C,9,2,11,14112776,14131211,28243987,3.8946342809179173e-07
WA18,5p,12,->C,74,1,75,14112682,14131223,28243905,2.655440173729518e-06
WA18,5p,13,->C,33,2,35,14112608,14131206,28243814,1.239209407058126e-06
WA18,5p,14,->C,63,7,70,14112535,14131179,28243714,2.478427589232776e-06
WA18,5p,15,->C,61,10,71,14112545,14131148,28243693,2.513835566758214e-06
WA18,5p,16,->C,64,38,102,14112522,14131083,28243605,3.611436996091682e-06
WA18,5p,17,->C,65,31,96,14112485,14130990,28243475,3.39901517076068e-06
WA18,5p,18,->C,69,62,131,14112481,14130987,28243468,4.638240601331253e-06
WA18,5p,19,->C,102,59,161,14112359,14130867,28243226,5.700481949193764e-06
WA18,5p,20,->C,54,167,221,14112397,14130866,28243263,7.824874909106643e-06
WA18,5p,21,->C,99,42,141,14112347,14130679,28243026,4.992382898348073e-06
WA18,5p,22,->C,128,274,402,14112376,14129592,28241968,1.4234135524833114e-05
WA18,5p,23,->C,108,1213,1321,14112288,14129275,28241563,4.677503153773748e-05
WA18,5p,24,->C,151,402,553,14112253,14129481,28241734,1.9580950659757646e-05
WA18,5p,25,->C,118,100,218,14112273,14130551,28242824,7.71877486472316e-06
WA22,3p,1,->C,0,0,0,1513709,1653397,3167106,0.0
WA22,3p,2,->C,0,0,0,1513709,1653396,3167105,0.0
WA22,3p,3,->C,0,1,1,1513709,1653396,3167105,3.1574576782266455e-07
WA22,3p,4,->C,0,0,0,1513709,1653394,3167103,0.0
WA22,3p,5,->C,0,0,0,1513709,1653397,3167106,0.0
WA22,3p,6,->C,0,0,0,1513709,1653397,3167106,0.0
WA22,3p,7,->C,0,0,0,1513709,1653397,3167106,0.0
WA22,3p,8,->C,0,0,0,1513709,1653395,3167104,0.0
WA22,3p,9,->C,0,0,0,1513709,1653397,3167106,0.0
WA22,3p,10,->C,0,0,0,1513706,1653396,3167102,0.0
WA22,3p,11,->C,11,0,11,1513685,1653390,3167075,3.473236345839616e-06
WA22,3p,12,->C,0,0,0,1513662,1653379,3167041,0.0
WA22,3p,13,->C,0,1,1,1513689,1653380,3167069,3.157493568974973e-07
WA22,3p,14,->C,0,8,8,1513686,1653352,3167038,2.5260195804407777e-06
WA22,3p,15,->C,9,2,11,1513677,1653343,3167020,3.473296663740677e-06
WA22,3p,16,->C,0,6,6,1513637,1653341,3166978,1.894550577869502e-06
WA22,3p,17,->C,15,6,21,1513671,1653319,3166990,6.630901897385214e-06
WA22,3p,18,->C,11,18,29,1513665,1653288,3166953,9.157066745227984e-06
WA22,3p,19,->C,0,6,6,1513662,1653275,3166937,1.894575105219965e-06
WA22,3p,20,->C,9,24,33,1513684,1653304,3166988,1.0419995276268808e-05
WA22,3p,21,->C,10,26,36,1513677,1653327,3167004,1.1367210145613962e-05
WA22,3p,22,->C,7,0,7,1513684,1653356,3167040,2.2102657370920483e-06
WA22,3p,23,->C,7,17,24,1513676,1653329,3167005,7.5781377042347585e-06
WA22,3p,24,->C,24,6,30,1513672,1653285,3166957,9.472815702897136e-06
WA22,3p,25,->C,6,9,15,1513669,1653296,3166965,4.736395886913812e-06
WA22,5p,1,->C,0,0,0,1513709,1653397,3167106,0.0
WA22,5p,2,->C,0,0,0,1513674,1653378,3167052,0.0
WA22,5p,3,->C,0,0,0,1513709,1653397,3167106,0.0
WA22,5p,4,->C,0,0,0,1513709,1653397,3167106,0.0
WA22,5p,5,->C,0,0,0,1513708,1653396,3167104,0.0
WA22,5p,6,->C,0,0,0,1513704,1653397,3167101,0.0
WA22,5p,7,->C,0,0,0,1513707,1653397,3167104,0.0
WA22,5p,8,->C,10,0,10,1513692,1653397,3167089,3.157473629569614e-06
WA22,5p,9,->C,0,0,0,1513700,1653389,3167089,0.0
WA22,5p,10,->C,0,0,0,1513705,1653389,3167094,0.0
WA22,5p,11,->C,4,2,6,1513699,1653381,3167080,1.894489561362517e-06
WA22,5p,12,->C,8,9,17,1513692,1653345,3167037,5.367793303330526e-06
WA22,5p,13,->C,4,0,4,1513697,1653377,3167074,1.2629954336400097e-06
WA22,5p,14,->C,0,0,0,1513677,1653376,3167053,0.0
WA22,5p,15,->C,2,1,3,1513695,1653381,3167076,9.472459770463356e-07
WA22,5p,16,->C,1,10,11,1513668,1653368,3167036,3.4732791164988337e-06
WA22,5p,17,->C,6,0,6,1513675,1653395,3167070,1.8944955431992347e-06
WA22,5p,18,->C,8,0,8,1513651,1653392,3167043,2.5260155924627483e-06
WA22,5p,19,->C,7,16,23,1513674,1653350,3167024,7.26233839718297e-06
WA22,5p,20,->C,7,0,7,1513678,1653356,3167034,2.2102699244782344e-06
WA22,5p,21,->C,0,0,0,1513690,1653371,3167061,0.0
WA22,5p,22,->C,0,3,3,1513691,1653380,3167071,9.472474725069316e-07
WA22,5p,23,->C,18,4,22,1513634,1653393,3167027,6.946577973601109e-06
WA22,5p,24,->C,12,1,13,1513632,1653375,3167007,4.104821997551631e-06
WA22,5p,25,->C,1,13,14,1513644,1653364,3167008,4.420576140003436e-06
WA25,3p,1,->C,0,0,0,3375244,3569089,6944333,0.0
WA25,3p,2,->C,0,0,0,3375244,3569089,6944333,0.0
WA25,3p,3,->C,0,0,0,3375244,3569089,6944333,0.0
WA25,3p,4,->C,0,0,0,3375244,3569087,6944331,0.0
WA25,3p,5,->C,0,0,0,3375244,3569089,6944333,0.0
WA25,3p,6,->C,0,0,0,3375244,3569089,6944333,0.0
WA25,3p,7,->C,0,0,0,3375244,3569089,6944333,0.0
WA25,3p,8,->C,0,0,0,3375239,3569076,6944315,0.0
WA25,3p,9,->C,0,0,0,3375240,3569076,6944316,0.0
WA25,3p,10,->C,2,3,5,3375240,3569075,6944315,7.200134210501684e-07
WA25,3p,11,->C,6,1,7,3375233,3569054,6944287,1.0080228538941436e-06
WA25,3p,12,->C,1,1,2,3375226,3569069,6944295,2.880061978933787e-07
WA25,3p,13,->C,3,12,15,3375230,3569053,6944283,2.1600502168474413e-06
WA25,3p,14,->C,0,11,11,3375223,3569037,6944260,1.5840420721574365e-06
WA25,3p,15,->C,0,7,7,3375218,3569039,6944257,1.0080272086704164e-06
WA25,3p,16,->C,9,16,25,3375196,3569030,6944226,3.60011324516224e-06
WA25,3p,17,->C,20,15,35,3375198,3569022,6944220,5.040162898064865e-06
WA25,3p,18,->C,4,23,27,3375213,3569006,6944219,3.88812622412974e-06
WA25,3p,19,->C,7,20,27,3375204,3569005,6944209,3.888131823221335e-06
WA25,3p,20,->C,14,37,51,3375190,3568979,6944169,7.344291303970281e-06
WA25,3p,21,->C,19,24,43,3375199,3568998,6944197,6.192220641205887e-06
WA25,3p,22,->C,10,21,31,3375179,3568994,6944173,4.464174495652686e-06
WA25,3p,23,->C,13,39,52,3375175,3568972,6944147,7.488320739753925e-06
WA25,3p,24,->C,5,28,33,3375177,3568962,6944139,4.752209021161586e-06
WA25,3p,25,->C,31,42,73,3375156,3568970,6944126,1.051248206037736e-05
WA25,5p,1,->C,0,0,0,3375244,3569089,6944333,0.0
WA25,5p,2,->C,0,0,0,3375147,3569045,6944192,0.0
WA25,5p,3,->C,0,0,0,3375243,3569089,6944332,0.0
WA25,5p,4,->C,0,0,0,3375243,3569089,6944332,0.0
WA25,5p,5,->C,0,0,0,3375244,3569088,6944332,0.0
WA25,5p,6,->C,0,0,0,3375244,3569089,6944333,0.0
WA25,5p,7,->C,0,0,0,3375242,3569089,6944331,0.0
WA25,5p,8,->C,6,0,6,3375221,3569088,6944309,8.640168517846772e-07
WA25,5p,9,->C,4,2,6,3375227,3569087,6944314,8.640162296808583e-07
WA25,5p,10,->C,4,0,4,3375217,3569085,6944302,5.760118151543524e-07
WA25,5p,11,->C,17,0,17,3375193,3569088,6944281,2.448057617484085e-06
WA25,5p,12,->C,51,2,53,3375142,3569084,6944226,7.632240079743948e-06
WA25,5p,13,->C,10,1,11,3375133,3569081,6944214,1.5840525652003237e-06
WA25,5p,14,->C,36,2,38,3375151,3569071,6944222,5.47217528471872e-06
WA25,5p,15,->C,33,1,34,3375137,3569055,6944192,4.896177985862142e-06
WA25,5p,16,->C,41,7,48,3375081,3569035,6944116,6.912326925414264e-06
WA25,5p,17,->C,30,8,38,3375076,3568871,6943947,5.472391998383628e-06
WA25,5p,18,->C,19,6,25,3375102,3568996,6944098,3.600179605760172e-06
WA25,5p,19,->C,13,8,21,3375134,3569021,6944155,3.02412604557358e-06
WA25,5p,20,->C,20,13,33,3375145,3569019,6944164,4.752191912518195e-06
WA25,5p,21,->C,18,25,43,3375130,3569013,6944143,6.19226879400381e-06
WA25,5p,22,->C,17,22,39,3375139,3569001,6944140,5.61624621623412e-06
WA25,5p,23,->C,10,29,39,3375144,3569002,6944146,5.616241363588842e-06
WA25,5p,24,->C,20,49,69,3375124,3568967,6944091,9.936505728395552e-06
WA25,5p,25,->C,15,29,44,3375125,3568950,6944075,6.336337093133355e-06
WA26,3p,1,->C,0,0,0,2709623,2900126,5609749,0.0
WA26,3p,2,->C,0,0,0,2709623,2900126,5609749,0.0
WA26,3p,3,->C,0,0,0,2709623,2900126,5609749,0.0
WA26,3p,4,->C,0,0,0,2709623,2900126,5609749,0.0
WA26,3p,5,->C,0,0,0,2709623,2900126,5609749,0.0
WA26,3p,6,->C,0,0,0,2709623,2900126,5609749,0.0
WA26,3p,7,->C,0,0,0,2709623,2900126,5609749,0.0
WA26,3p,8,->C,4,2,6,2709619,2900114,5609733,1.069569621227962e-06
WA26,3p,9,->C,1,3,4,2709613,2900111,5609724,7.130475581329848e-07
WA26,3p,10,->C,6,0,6,2709609,2900074,5609683,1.0695791544727215e-06
WA26,3p,11,->C,9,3,12,2709594,2900076,5609670,2.139163266288391e-06
WA26,3p,12,->C,3,5,8,2709607,2900081,5609688,1.4261042681874645e-06
WA26,3p,13,->C,3,2,5,2709604,2900084,5609688,8.913151676171652e-07
WA26,3p,14,->C,8,7,15,2709584,2900069,5609653,2.6739621862528757e-06
WA26,3p,15,->C,10,3,13,2709593,2900082,5609675,2.317424806249916e-06
WA26,3p,16,->C,8,11,19,2709580,2900075,5609655,3.3870175616860573e-06
WA26,3p,17,->C,16,10,26,2709570,2900078,5609648,4.634871920662402e-06
WA26,3p,18,->C,15,6,21,2709582,2900059,5609641,3.743555068853782e-06
WA26,3p,19,->C,19,0,19,2709567,2900016,5609583,3.387061034661578e-06
WA26,3p,20,->C,12,9,21,2709563,2899983,5609546,3.743618467519475e-06
WA26,3p,21,->C,6,13,19,2709562,2900021,5609583,3.387061034661578e-06
WA26,3p,22,->C,17,18,35,2709522,2900007,5609529,6.239383021283962e-06
WA26,3p,23,->C,3,19,22,2709541,2899974,5609515,3.9219076872064695e-06
WA26,3p,24,->C,11,14,25,2709558,2899951,5609509,4.456718047871926e-06
WA26,3p,25,->C,23,16,39,2709500,2900002,5609502,6.95248883055929e-06
WA26,5p,1,->C,0,0,0,2709622,2900126,5609748,0.0
WA26,5p,2,->C,0,0,0,2709554,2900092,5609646,0.0
WA26,5p,3,->C,0,0,0,2709623,2900126,5609749,0.0
WA26,5p,4,->C,0,0,0,2709623,2900126,5609749,0.0
WA26,5p,5,->C,0,0,0,2709623,2900125,5609748,0.0
WA26,5p,6,->C,2,0,2,2709621,2900126,5609747,3.5652231731662765e-07
WA26,5p,7,->C,0,0,0,2709622,2900126,5609748,0.0
WA26,5p,8,->C,0,0,0,2709609,2900124,5609733,0.0
WA26,5p,9,->C,9,1,10,2709594,2900123,5609717,1.782621119746326e-06
WA26,5p,10,->C,3,0,3,2709601,2900123,5609724,5.347856685997386e-07
WA26,5p,11,->C,0,4,4,2709605,2900103,5609708,7.130495918860661e-07
WA26,5p,12,->C,6,4,10,2709595,2900107,5609702,1.7826258863661564e-06
WA26,5p,13,->C,12,2,14,2709592,2900104,5609696,2.4956789102297166e-06
WA26,5p,14,->C,25,2,27,2709563,2900089,5609652,4.8131327932641815e-06
WA26,5p,15,->C,11,5,16,2709545,2900085,5609630,2.852238026393897e-06
WA26,5p,16,->C,18,6,24,2709540,2900076,5609616,4.2783677171485536e-06
WA26,5p,17,->C,19,3,22,2709554,2900055,5609609,3.921841967951777e-06
WA26,5p,18,->C,16,5,21,2709554,2900082,5609636,3.743558405572126e-06
WA26,5p,19,->C,16,5,21,2709570,2900086,5609656,3.74354505873444e-06
WA26,5p,20,->C,11,5,16,2709563,2900082,5609645,2.8522303996063924e-06
WA26,5p,21,->C,23,10,33,2709545,2900061,5609606,5.882766098011162e-06
WA26,5p,22,->C,17,21,38,2709542,2900059,5609601,6.774100332626153e-06
WA26,5p,23,->C,25,10,35,2709528,2900065,5609593,6.239311835992379e-06
WA26,5p,24,->C,32,18,50,2709495,2900057,5609552,8.913367769832599e-06
WA26,5p,25,->C,18,30,48,2709506,2900041,5609547,8.556840686066094e-06
