Sample,End,Position,Substitution,Pos_Count,Neg_Count,Combined_Count,Pos_Total,Neg_Total,Combined_Total,Frequency
DAL192,3p,1,->T,0,0,0,6350003,6167708,12517711,0.0
DAL192,3p,2,->T,0,0,0,6350003,6167706,12517709,0.0
DAL192,3p,3,->T,0,0,0,6350003,6167708,12517711,0.0
DAL192,3p,4,->T,0,0,0,6350003,6167708,12517711,0.0
DAL192,3p,5,->T,0,0,0,6350003,6167708,12517711,0.0
DAL192,3p,6,->T,0,0,0,6350003,6167708,12517711,0.0
DAL192,3p,7,->T,0,0,0,6350003,6167708,12517711,0.0
DAL192,3p,8,->T,0,65,65,6350003,6167618,12517621,5.192679982881732e-06
DAL192,3p,9,->T,0,42,42,6350003,6167637,12517640,3.3552650499614942e-06
DAL192,3p,10,->T,0,37,37,6350003,6167645,12517648,2.955826845426553e-06
DAL192,3p,11,->T,3,43,46,6349987,6167644,12517631,3.674816744478249e-06
DAL192,3p,12,->T,0,31,31,6349997,6167646,12517643,2.4765045624004456e-06
DAL192,3p,13,->T,3,49,52,6349992,6167621,12517613,4.15414664121666e-06
DAL192,3p,14,->T,10,57,67,6349967,6167610,12517577,5.352473565770756e-06
DAL192,3p,15,->T,3,63,66,6349968,6167615,12517583,5.272583373323748e-06
DAL192,3p,16,->T,16,56,72,6349943,6167587,12517530,5.751933488475762e-06
DAL192,3p,17,->T,19,38,57,6349922,6167606,12517528,4.553614739268009e-06
DAL192,3p,18,->T,15,55,70,6349922,6167564,12517486,5.592177215137288e-06
DAL192,3p,19,->T,12,70,82,6349921,6167519,12517440,6.55086023979344e-06
DAL192,3p,20,->T,30,68,98,6349910,6167516,12517426,7.82908562830729e-06
DAL192,3p,21,->T,28,63,91,6349882,6167507,12517389,7.269886715192761e-06
DAL192,3p,22,->T,30,88,118,6349894,6167488,12517382,9.426891341975502e-06
DAL192,3p,23,->T,17,102,119,6349902,6167465,12517367,9.506791643961544e-06
DAL192,3p,24,->T,21,103,124,6349899,6167465,12517364,9.906239045217507e-06
DAL192,3p,25,->T,33,76,109,6349856,6167384,12517240,8.707989940274373e-06
DAL192,5p,1,->T,0,0,0,6350003,6167708,12517711,0.0
DAL192,5p,2,->T,0,0,0,6349992,6167694,12517686,0.0
DAL192,5p,3,->T,0,0,0,6350003,6167707,12517710,0.0
DAL192,5p,4,->T,0,0,0,6350003,6167708,12517711,0.0
DAL192,5p,5,->T,0,0,0,6350003,6167707,12517710,0.0
DAL192,5p,6,->T,1,0,1,6350002,6167707,12517709,7.98868227404871e-08
DAL192,5p,7,->T,1,0,1,6350002,6167708,12517710,7.988681635858315e-08
DAL192,5p,8,->T,9,0,9,6349926,6167708,12517634,7.189857124756963e-07
DAL192,5p,9,->T,22,0,22,6349914,6167708,12517622,1.7575223153407252e-06
DAL192,5p,10,->T,25,0,25,6349896,6167708,12517604,1.9971873211518757e-06
DAL192,5p,11,->T,28,1,29,6349942,6167706,12517648,2.316729149118109e-06
DAL192,5p,12,->T,37,5,42,6349906,6167700,12517606,3.3552741634462693e-06
DAL192,5p,13,->T,20,0,20,6349906,6167705,12517611,1.597748963440388e-06
DAL192,5p,14,->T,36,11,47,6349889,6167679,12517568,3.7547229621600616e-06
DAL192,5p,15,->T,32,21,53,6349890,6167649,12517539,4.234059106985806e-06
DAL192,5p,16,->T,23,26,49,6349904,6167639,12517543,3.914506225383048e-06
DAL192,5p,17,->T,21,51,72,6349778,6167623,12517401,5.751992765910432e-06
DAL192,5p,18,->T,37,44,81,6349859,6167631,12517490,6.470945852563094e-06
DAL192,5p,19,->T,48,44,92,6349822,6167638,12517460,7.349733891700073e-06
DAL192,5p,20,->T,51,46,97,6349836,6167621,12517457,7.749177808240125e-06
DAL192,5p,21,->T,37,17,54,6349784,6167624,12517408,4.313992161955574e-06
DAL192,5p,22,->T,46,45,91,6349783,6167584,12517367,7.269899492441182e-06
DAL192,5p,23,->T,31,72,103,6349801,6167567,12517368,8.228566900006455e-06
DAL192,5p,24,->T,50,64,114,6349759,6167564,12517323,9.107378630398848e-06
DAL192,5p,25,->T,63,78,141,6349777,6167551,12517328,1.1264384859132875e-05
DAL193,3p,1,->T,0,0,0,6484405,6362696,12847101,0.0
DAL193,3p,2,->T,0,0,0,6484402,6362696,12847098,0.0
DAL193,3p,3,->T,0,0,0,6484405,6362696,12847101,0.0
DAL193,3p,4,->T,0,0,0,6484405,6362696,12847101,0.0
DAL193,3p,5,->T,0,0,0,6484405,6362696,12847101,0.0
DAL193,3p,6,->T,0,0,0,6484405,6362696,12847101,0.0
DAL193,3p,7,->T,0,0,0,6484405,6362696,12847101,0.0
DAL193,3p,8,->T,0,30,30,6484400,6362644,12847044,2.335167529588908e-06
DAL193,3p,9,->T,5,41,46,6484400,6362631,12847031,3.5805938352604582e-06
DAL193,3p,10,->T,2,42,44,6484393,6362640,12847033,3.424915309239106e-06
DAL193,3p,11,->T,0,33,33,6484398,6362639,12847037,2.568685682153792e-06
DAL193,3p,12,->T,26,41,67,6484368,6362594,12846962,5.215240770541705e-06
DAL193,3p,13,->T,9,54,63,6484385,6362543,12846928,4.90389609095653e-06
DAL193,3p,14,->T,6,71,77,6484363,6362486,12846849,5.993687634999057e-06
DAL193,3p,15,->T,25,126,151,6484332,6362438,12846770,1.1753927251752774e-05
DAL193,3p,16,->T,15,83,98,6484341,6362460,12846801,7.628358219295216e-06
DAL193,3p,17,->T,27,101,128,6484294,6362445,12846739,9.96361800453796e-06
DAL193,3p,18,->T,30,108,138,6484244,6362380,12846624,1.0742121821266038e-05
DAL193,3p,19,->T,31,80,111,6484265,6362400,12846665,8.640374758740887e-06
DAL193,3p,20,->T,30,117,147,6484261,6362382,12846643,1.1442678059941418e-05
DAL193,3p,21,->T,42,103,145,6484248,6362443,12846691,1.1286953192849428e-05
DAL193,3p,22,->T,29,91,120,6484224,6362407,12846631,9.340970406949496e-06
DAL193,3p,23,->T,32,105,137,6484218,6362399,12846617,1.0664286169658518e-05
DAL193,3p,24,->T,33,117,150,6484164,6362319,12846483,1.1676347526400806e-05
DAL193,3p,25,->T,59,115,174,6484128,6362355,12846483,1.3544563130624936e-05
DAL193,5p,1,->T,0,0,0,6484405,6362696,12847101,0.0
DAL193,5p,2,->T,0,0,0,6484386,6362681,12847067,0.0
DAL193,5p,3,->T,0,0,0,6484400,6362696,12847096,0.0
DAL193,5p,4,->T,1,0,1,6484403,6362696,12847099,7.783858441504965e-08
DAL193,5p,5,->T,0,0,0,6484403,6362696,12847099,0.0
DAL193,5p,6,->T,1,0,1,6484404,6362696,12847100,7.78385783562049e-08
DAL193,5p,7,->T,1,0,1,6484404,6362696,12847100,7.78385783562049e-08
DAL193,5p,8,->T,11,0,11,6484314,6362693,12847007,8.562305601608219e-07
DAL193,5p,9,->T,25,0,25,6484295,6362695,12846990,1.945981120869558e-06
DAL193,5p,10,->T,13,0,13,6484284,6362694,12846978,1.0119111280489466e-06
DAL193,5p,11,->T,30,3,33,6484315,6362677,12846992,2.568694679657308e-06
DAL193,5p,12,->T,64,3,67,6484218,6362670,12846888,5.215270811110052e-06
DAL193,5p,13,->T,61,11,72,6484143,6362652,12846795,5.60451069702599e-06
DAL193,5p,14,->T,64,11,75,6484145,6362627,12846772,5.838042428090107e-06
DAL193,5p,15,->T,48,27,75,6484166,6362534,12846700,5.838075147703301e-06
DAL193,5p,16,->T,58,47,105,6484111,6362519,12846630,8.173349742305959e-06
DAL193,5p,17,->T,54,38,92,6484043,6362598,12846641,7.161405070788543e-06
DAL193,5p,18,->T,53,55,108,6483967,6362571,12846538,8.406934226170506e-06
DAL193,5p,19,->T,97,43,140,6483980,6362593,12846573,1.0897848009737696e-05
DAL193,5p,20,->T,126,52,178,6483952,6362554,12846506,1.38559075907488e-05
DAL193,5p,21,->T,97,73,170,6484003,6362532,12846535,1.3233140298142651e-05
DAL193,5p,22,->T,71,72,143,6484010,6362499,12846509,1.1131428779600746e-05
DAL193,5p,23,->T,80,96,176,6483966,6362463,12846429,1.3700305353339826e-05
DAL193,5p,24,->T,97,67,164,6483905,6362426,12846331,1.276629101336405e-05
DAL193,5p,25,->T,75,79,154,6483942,6362403,12846345,1.1987845570082385e-05
DAL195,3p,1,->T,0,0,0,2363278,2267461,4630739,0.0
DAL195,3p,2,->T,0,0,0,2363278,2267460,4630738,0.0
DAL195,3p,3,->T,0,0,0,2363278,2267461,4630739,0.0
DAL195,3p,4,->T,0,0,0,2363278,2267461,4630739,0.0
DAL195,3p,5,->T,0,0,0,2363278,2267461,4630739,0.0
DAL195,3p,6,->T,0,0,0,2363278,2267461,4630739,0.0
DAL195,3p,7,->T,0,0,0,2363278,2267461,4630739,0.0
DAL195,3p,8,->T,0,26,26,2363278,2267413,4630691,5.614712793403836e-06
DAL195,3p,9,->T,1,16,17,2363276,2267438,4630714,3.6711401308739855e-06
DAL195,3p,10,->T,1,20,21,2363274,2267432,4630706,4.53494564327772e-06
DAL195,3p,11,->T,0,13,13,2363274,2267431,4630705,2.8073479092276446e-06
DAL195,3p,12,->T,0,15,15,2363273,2267414,4630687,3.239260178889223e-06
DAL195,3p,13,->T,3,28,31,2363269,2267412,4630681,6.694479710435679e-06
DAL195,3p,14,->T,7,19,26,2363250,2267410,4630660,5.61475038115517e-06
DAL195,3p,15,->T,7,14,21,2363254,2267411,4630665,4.534985795776633e-06
DAL195,3p,16,->T,3,22,25,2363259,2267394,4630653,5.398806604597667e-06
DAL195,3p,17,->T,13,24,37,2363234,2267398,4630632,7.990270010659452e-06
DAL195,3p,18,->T,9,35,44,2363236,2267374,4630610,9.501987859050968e-06
DAL195,3p,19,->T,13,44,57,2363215,2267369,4630584,1.23094624781669e-05
DAL195,3p,20,->T,13,33,46,2363222,2267380,4630602,9.93391356026711e-06
DAL195,3p,21,->T,8,29,37,2363235,2267382,4630617,7.990295893614177e-06
DAL195,3p,22,->T,10,32,42,2363231,2267383,4630614,9.070071485120548e-06
DAL195,3p,23,->T,10,26,36,2363219,2267370,4630589,7.774388960022148e-06
DAL195,3p,24,->T,12,44,56,2363198,2267373,4630571,1.2093540947757846e-05
DAL195,3p,25,->T,24,29,53,2363180,2267377,4630557,1.144570728748183e-05
DAL195,5p,1,->T,0,0,0,2363278,2267461,4630739,0.0
DAL195,5p,2,->T,0,0,0,2363264,2267447,4630711,0.0
DAL195,5p,3,->T,0,0,0,2363278,2267459,4630737,0.0
DAL195,5p,4,->T,0,0,0,2363278,2267461,4630739,0.0
DAL195,5p,5,->T,0,0,0,2363277,2267461,4630738,0.0
DAL195,5p,6,->T,0,0,0,2363277,2267461,4630738,0.0
DAL195,5p,7,->T,0,0,0,2363277,2267461,4630738,0.0
DAL195,5p,8,->T,22,0,22,2363212,2267460,4630672,4.75093031853692e-06
DAL195,5p,9,->T,66,0,66,2363181,2267461,4630642,1.4252883293504443e-05
DAL195,5p,10,->T,72,0,72,2363146,2267458,4630604,1.554872755260437e-05
DAL195,5p,11,->T,307,1,308,2362948,2267450,4630398,6.651696031313074e-05
DAL195,5p,12,->T,380,1,381,2362864,2267454,4630318,8.228376539149148e-05
DAL195,5p,13,->T,165,4,169,2363073,2267445,4630518,3.649699666430408e-05
DAL195,5p,14,->T,135,18,153,2363094,2267434,4630528,3.304158834586466e-05
DAL195,5p,15,->T,32,13,45,2363178,2267432,4630610,9.717942128574852e-06
DAL195,5p,16,->T,33,10,43,2363170,2267429,4630599,9.286055648524087e-06
DAL195,5p,17,->T,53,10,63,2363159,2267431,4630590,1.3605177741929217e-05
DAL195,5p,18,->T,16,24,40,2363182,2267420,4630602,8.638185704580095e-06
DAL195,5p,19,->T,27,18,45,2363138,2267420,4630558,9.718051258617213e-06
DAL195,5p,20,->T,29,24,53,2363110,2267401,4630511,1.1445820990383134e-05
DAL195,5p,21,->T,29,20,49,2363086,2267400,4630486,1.0582042576092443e-05
DAL195,5p,22,->T,36,37,73,2363094,2267388,4630482,1.576509745637711e-05
DAL195,5p,23,->T,34,22,56,2363068,2267398,4630466,1.2093815179724893e-05
DAL195,5p,24,->T,45,22,67,2363067,2267402,4630469,1.4469376644136911e-05
DAL195,5p,25,->T,24,35,59,2363135,2267374,4630509,1.274157981336393e-05
DAL212,3p,1,->T,0,0,0,4131322,4008153,8139475,0.0
DAL212,3p,2,->T,0,0,0,4131322,4008153,8139475,0.0
DAL212,3p,3,->T,0,0,0,4131322,4008153,8139475,0.0
DAL212,3p,4,->T,0,0,0,4131322,4008153,8139475,0.0
DAL212,3p,5,->T,0,2,2,4131322,4008151,8139473,2.457161538591012e-07
DAL212,3p,6,->T,0,2,2,4131322,4008151,8139473,2.457161538591012e-07
DAL212,3p,7,->T,0,0,0,4131322,4008153,8139475,0.0
DAL212,3p,8,->T,0,35,35,4131319,4008093,8139412,4.300064918694373e-06
DAL212,3p,9,->T,2,25,27,4131316,4008115,8139431,3.3171851939036035e-06
DAL212,3p,10,->T,0,29,29,4131317,4008102,8139419,3.562907868485453e-06
DAL212,3p,11,->T,2,24,26,4131313,4008105,8139418,3.194331584887273e-06
DAL212,3p,12,->T,1,67,68,4131314,4008034,8139348,8.354477533089874e-06
DAL212,3p,13,->T,6,59,65,4131307,4007923,8139230,7.986013418959779e-06
DAL212,3p,14,->T,16,120,136,4131271,4007904,8139175,1.670931021878753e-05
DAL212,3p,15,->T,25,132,157,4131254,4007935,8139189,1.928939111746883e-05
DAL212,3p,16,->T,15,72,87,4131236,4007982,8139218,1.068898756612736e-05
DAL212,3p,17,->T,8,70,78,4131249,4007981,8139230,9.583216102751734e-06
DAL212,3p,18,->T,34,84,118,4131222,4007954,8139176,1.4497782085066104e-05
DAL212,3p,19,->T,21,74,95,4131233,4007956,8139189,1.1671924561525723e-05
DAL212,3p,20,->T,36,90,126,4131221,4007928,8139149,1.548073391947979e-05
DAL212,3p,21,->T,24,109,133,4131228,4007917,8139145,1.6340782723492455e-05
DAL212,3p,22,->T,37,142,179,4131183,4007898,8139081,2.1992654944704446e-05
DAL212,3p,23,->T,40,107,147,4131172,4007904,8139076,1.806101822860482e-05
DAL212,3p,24,->T,60,91,151,4131124,4007904,8139028,1.8552583920340365e-05
DAL212,3p,25,->T,76,83,159,4131071,4007924,8138995,1.9535581481497408e-05
DAL212,5p,1,->T,0,0,0,4131322,4008153,8139475,0.0
DAL212,5p,2,->T,0,0,0,4131307,4008143,8139450,0.0
DAL212,5p,3,->T,0,0,0,4131321,4008153,8139474,0.0
DAL212,5p,4,->T,0,0,0,4131322,4008153,8139475,0.0
DAL212,5p,5,->T,0,0,0,4131322,4008153,8139475,0.0
DAL212,5p,6,->T,0,0,0,4131322,4008153,8139475,0.0
DAL212,5p,7,->T,0,0,0,4131322,4008153,8139475,0.0
DAL212,5p,8,->T,14,0,14,4131248,4008153,8139401,1.7200282920082202e-06
DAL212,5p,9,->T,13,0,13,4131243,4008153,8139396,1.597170109428267e-06
DAL212,5p,10,->T,44,3,47,4131179,4008148,8139327,5.774433193309472e-06
DAL212,5p,11,->T,49,2,51,4131234,4008143,8139377,6.265835825026904e-06
DAL212,5p,12,->T,33,1,34,4131187,4008141,8139328,4.177249030878225e-06
DAL212,5p,13,->T,32,2,34,4131181,4008142,8139323,4.177251596969428e-06
DAL212,5p,14,->T,29,15,44,4131134,4008108,8139242,5.40590880575857e-06
DAL212,5p,15,->T,48,16,64,4131156,4008091,8139247,7.86313525071791e-06
DAL212,5p,16,->T,41,22,63,4131154,4008081,8139235,7.740285174220918e-06
DAL212,5p,17,->T,33,41,74,4131159,4008081,8139240,9.091757952830976e-06
DAL212,5p,18,->T,30,45,75,4131113,4008066,8139179,9.214688606799284e-06
DAL212,5p,19,->T,78,40,118,4131040,4008052,8139092,1.4497931710318549e-05
DAL212,5p,20,->T,53,47,100,4131020,4008040,8139060,1.2286431111209403e-05
DAL212,5p,21,->T,73,46,119,4130973,4008040,8139013,1.4620937452735362e-05
DAL212,5p,22,->T,49,30,79,4131015,4007967,8138982,9.70637359807406e-06
DAL212,5p,23,->T,75,38,113,4131005,4007962,8138967,1.3883825797549e-05
DAL212,5p,24,->T,67,50,117,4131060,4007918,8138978,1.4375269229134174e-05
DAL212,5p,25,->T,74,65,139,4131016,4007614,8138630,1.7079041558591556e-05
DAL218,3p,1,->T,0,0,0,6952891,6658031,13610922,0.0
DAL218,3p,2,->T,0,0,0,6952891,6658031,13610922,0.0
DAL218,3p,3,->T,0,1,1,6952891,6658030,13610921,7.34704139418633e-08
DAL218,3p,4,->T,0,0,0,6952891,6658031,13610922,0.0
DAL218,3p,5,->T,0,0,0,6952891,6658031,13610922,0.0
DAL218,3p,6,->T,0,0,0,6952891,6658030,13610921,0.0
DAL218,3p,7,->T,0,1,1,6952891,6658026,13610917,7.347043553347654e-08
DAL218,3p,8,->T,0,39,39,6952887,6657945,13610832,2.8653648799720693e-06
DAL218,3p,9,->T,2,28,30,6952882,6657945,13610827,2.2041276404438907e-06
DAL218,3p,10,->T,0,25,25,6952881,6657960,13610841,1.8367711444134864e-06
DAL218,3p,11,->T,1,65,66,6952866,6657905,13610771,4.84910075997899e-06
DAL218,3p,12,->T,14,58,72,6952858,6657882,13610740,5.289940150204912e-06
DAL218,3p,13,->T,6,101,107,6952870,6657811,13610681,7.861472912339949e-06
DAL218,3p,14,->T,15,103,118,6952816,6657779,13610595,8.669716496596953e-06
DAL218,3p,15,->T,28,63,91,6952788,6657738,13610526,6.686001701918059e-06
DAL218,3p,16,->T,57,100,157,6952760,6657689,13610449,1.153525500885386e-05
DAL218,3p,17,->T,82,155,237,6952737,6657651,13610388,1.7413169999268207e-05
DAL218,3p,18,->T,46,117,163,6952711,6657672,13610383,1.1976150854828992e-05
DAL218,3p,19,->T,47,119,166,6952716,6657697,13610413,1.2196543925595792e-05
DAL218,3p,20,->T,42,75,117,6952697,6657752,13610449,8.596336535260519e-06
DAL218,3p,21,->T,97,105,202,6952660,6657692,13610352,1.4841644066222534e-05
DAL218,3p,22,->T,62,112,174,6952654,6657637,13610291,1.2784443771261024e-05
DAL218,3p,23,->T,46,113,159,6952651,6657632,13610283,1.1682343416371284e-05
DAL218,3p,24,->T,50,144,194,6952669,6657588,13610257,1.425395567475324e-05
DAL218,3p,25,->T,70,149,219,6952605,6657566,13610171,1.6090907307483498e-05
DAL218,5p,1,->T,0,0,0,6952891,6658031,13610922,0.0
DAL218,5p,2,->T,0,0,0,6952874,6658014,13610888,0.0
DAL218,5p,3,->T,0,0,0,6952891,6658031,13610922,0.0
DAL218,5p,4,->T,0,0,0,6952891,6658031,13610922,0.0
DAL218,5p,5,->T,0,0,0,6952891,6658031,13610922,0.0
DAL218,5p,6,->T,0,0,0,6952891,6658031,13610922,0.0
DAL218,5p,7,->T,2,0,2,6952888,6658031,13610919,1.469408494753367e-07
DAL218,5p,8,->T,42,0,42,6952719,6658029,13610748,3.085796607210713e-06
DAL218,5p,9,->T,36,0,36,6952736,6658029,13610765,2.644965216870617e-06
DAL218,5p,10,->T,23,0,23,6952716,6658028,13610744,1.689841495806548e-06
DAL218,5p,11,->T,53,3,56,6952715,6658016,13610731,4.114400615220446e-06
DAL218,5p,12,->T,94,15,109,6952625,6658005,13610630,8.008446339368567e-06
DAL218,5p,13,->T,194,13,207,6952475,6658005,13610480,1.5208868460186565e-05
DAL218,5p,14,->T,88,25,113,6952554,6657955,13610509,8.302408087750429e-06
DAL218,5p,15,->T,68,45,113,6952449,6657923,13610372,8.302491658567452e-06
DAL218,5p,16,->T,91,53,144,6952253,6657920,13610173,1.0580321058373028e-05
DAL218,5p,17,->T,105,82,187,6952350,6657874,13610224,1.373967100027156e-05
DAL218,5p,18,->T,123,84,207,6952457,6657843,13610300,1.5209069601698714e-05
DAL218,5p,19,->T,187,112,299,6952296,6657770,13610066,2.1969033801893392e-05
DAL218,5p,20,->T,246,125,371,6952289,6657772,13610061,2.725924593578236e-05
DAL218,5p,21,->T,115,102,217,6952371,6657729,13610100,1.5944041557372833e-05
DAL218,5p,22,->T,106,77,183,6952322,6657786,13610108,1.3445888893754553e-05
DAL218,5p,23,->T,250,78,328,6952288,6657745,13610033,2.409986808995981e-05
DAL218,5p,24,->T,138,79,217,6952375,6657772,13610147,1.5943986497721148e-05
DAL218,5p,25,->T,164,84,248,6952272,6657720,13609992,1.822190637584504e-05
DAL224,3p,1,->T,0,0,0,4609472,4586477,9195949,0.0
DAL224,3p,2,->T,0,0,0,4609471,4586476,9195947,0.0
DAL224,3p,3,->T,0,0,0,4609472,4586477,9195949,0.0
DAL224,3p,4,->T,0,0,0,4609472,4586477,9195949,0.0
DAL224,3p,5,->T,0,0,0,4609472,4586477,9195949,0.0
DAL224,3p,6,->T,0,0,0,4609472,4586477,9195949,0.0
DAL224,3p,7,->T,0,0,0,4609472,4586476,9195948,0.0
DAL224,3p,8,->T,2,37,39,4609469,4586423,9195892,4.241024144259197e-06
DAL224,3p,9,->T,1,24,25,4609466,4586431,9195897,2.7186037425169077e-06
DAL224,3p,10,->T,2,34,36,4609461,4586371,9195832,3.914817060598758e-06
DAL224,3p,11,->T,2,47,49,4609461,4586382,9195843,5.328494625234467e-06
DAL224,3p,12,->T,2,42,44,4609458,4586384,9195842,4.784771204202943e-06
DAL224,3p,13,->T,8,54,62,4609454,4586364,9195818,6.742195202210396e-06
DAL224,3p,14,->T,16,69,85,4609412,4586293,9195705,9.243445717321291e-06
DAL224,3p,15,->T,21,83,104,4609400,4586272,9195672,1.130966828742913e-05
DAL224,3p,16,->T,28,65,93,4609379,4586240,9195619,1.0113511662455783e-05
DAL224,3p,17,->T,10,78,88,4609381,4586216,9195597,9.569797371502906e-06
DAL224,3p,18,->T,29,43,72,4609363,4586282,9195645,7.82979334239197e-06
DAL224,3p,19,->T,44,77,121,4609353,4586195,9195548,1.3158541502909886e-05
DAL224,3p,20,->T,23,100,123,4609344,4586225,9195569,1.3376007509703858e-05
DAL224,3p,21,->T,24,112,136,4609343,4586223,9195566,1.4789736705712297e-05
DAL224,3p,22,->T,40,99,139,4609324,4586172,9195496,1.5116095966982097e-05
DAL224,3p,23,->T,45,111,156,4609323,4586083,9195406,1.696499317159025e-05
DAL224,3p,24,->T,37,111,148,4609325,4586202,9195527,1.60947817346412e-05
DAL224,3p,25,->T,47,116,163,4609265,4586173,9195438,1.7726181178101577e-05
DAL224,5p,1,->T,0,0,0,4609472,4586477,9195949,0.0
DAL224,5p,2,->T,3,0,3,4609461,4586469,9195930,3.262312784025107e-07
DAL224,5p,3,->T,0,0,0,4609468,4586477,9195945,0.0
DAL224,5p,4,->T,1,0,1,4609471,4586477,9195948,1.0874354661422618e-07
DAL224,5p,5,->T,0,0,0,4609471,4586477,9195948,0.0
DAL224,5p,6,->T,0,0,0,4609472,4586477,9195949,0.0
DAL224,5p,7,->T,0,0,0,4609471,4586477,9195948,0.0
DAL224,5p,8,->T,21,0,21,4609397,4586477,9195874,2.283632855343603e-06
DAL224,5p,9,->T,42,2,44,4609357,4586473,9195830,4.784777448038948e-06
DAL224,5p,10,->T,43,2,45,4609338,4586470,9195808,4.893534097275628e-06
DAL224,5p,11,->T,39,1,40,4609388,4586469,9195857,4.3497849085735024e-06
DAL224,5p,12,->T,52,5,57,4609357,4586464,9195821,6.1984677605186094e-06
DAL224,5p,13,->T,51,6,57,4609320,4586461,9195781,6.198494722742962e-06
DAL224,5p,14,->T,67,34,101,4609270,4586428,9195698,1.0983396801417358e-05
DAL224,5p,15,->T,57,33,90,4609299,4586416,9195715,9.78716717514625e-06
DAL224,5p,16,->T,53,56,109,4609292,4586373,9195665,1.1853411362854128e-05
DAL224,5p,17,->T,49,45,94,4609285,4586385,9195670,1.0222202406132451e-05
DAL224,5p,18,->T,58,65,123,4609226,4586351,9195577,1.3375995872798412e-05
DAL224,5p,19,->T,72,71,143,4609203,4586337,9195540,1.5551017123518577e-05
DAL224,5p,20,->T,130,65,195,4609148,4586313,9195461,2.120611462546576e-05
DAL224,5p,21,->T,61,53,114,4609195,4586347,9195542,1.2397311653842698e-05
DAL224,5p,22,->T,129,78,207,4609138,4586312,9195450,2.2511133223496405e-05
DAL224,5p,23,->T,90,50,140,4609100,4586313,9195413,1.522498228192687e-05
DAL224,5p,24,->T,118,66,184,4609109,4586316,9195425,2.0009950600434456e-05
DAL224,5p,25,->T,78,101,179,4609125,4586257,9195382,1.9466292971841736e-05
DAL227,3p,1,->T,0,0,0,3765386,3771243,7536629,0.0
DAL227,3p,2,->T,0,0,0,3765386,3771243,7536629,0.0
DAL227,3p,3,->T,0,0,0,3765386,3771243,7536629,0.0
DAL227,3p,4,->T,0,0,0,3765386,3771243,7536629,0.0
DAL227,3p,5,->T,0,0,0,3765386,3771243,7536629,0.0
DAL227,3p,6,->T,0,0,0,3765386,3771243,7536629,0.0
DAL227,3p,7,->T,0,0,0,3765386,3771243,7536629,0.0
DAL227,3p,8,->T,0,24,24,3765386,3771207,7536593,3.1844627937318625e-06
DAL227,3p,9,->T,1,15,16,3765384,3771218,7536602,2.122972660623448e-06
DAL227,3p,10,->T,2,22,24,3765382,3771209,7536591,3.184463638799027e-06
DAL227,3p,11,->T,3,15,18,3765378,3771214,7536592,2.388347412199042e-06
DAL227,3p,12,->T,3,22,25,3765377,3771173,7536550,3.317167669557025e-06
DAL227,3p,13,->T,3,15,18,3765373,3771183,7536556,2.388358820660259e-06
DAL227,3p,14,->T,7,29,36,3765341,3771166,7536507,4.776748698037433e-06
DAL227,3p,15,->T,8,25,33,3765341,3771186,7536527,4.378674686629531e-06
DAL227,3p,16,->T,7,33,40,3765340,3771079,7536419,5.307560527088529e-06
DAL227,3p,17,->T,7,38,45,3765328,3771049,7536377,5.9710388692073125e-06
DAL227,3p,18,->T,5,39,44,3765321,3771036,7536357,5.838364610381382e-06
DAL227,3p,19,->T,12,41,53,3765313,3771111,7536424,7.032513032706228e-06
DAL227,3p,20,->T,18,67,85,3765308,3771082,7536390,1.1278609519942573e-05
DAL227,3p,21,->T,10,61,71,3765307,3771104,7536411,9.420929936013309e-06
DAL227,3p,22,->T,18,54,72,3765309,3771137,7536446,9.553574722090492e-06
DAL227,3p,23,->T,15,71,86,3765319,3771112,7536431,1.1411236963491074e-05
DAL227,3p,24,->T,7,64,71,3765312,3771081,7536393,9.420952437061071e-06
DAL227,3p,25,->T,22,67,89,3765249,3771100,7536349,1.1809431861502168e-05
DAL227,5p,1,->T,0,0,0,3765386,3771243,7536629,0.0
DAL227,5p,2,->T,0,0,0,3765373,3771238,7536611,0.0
DAL227,5p,3,->T,0,0,0,3765386,3771243,7536629,0.0
DAL227,5p,4,->T,1,0,1,3765385,3771243,7536628,1.3268533354704518e-07
DAL227,5p,5,->T,0,0,0,3765386,3771242,7536628,0.0
DAL227,5p,6,->T,0,0,0,3765386,3771243,7536629,0.0
DAL227,5p,7,->T,0,0,0,3765386,3771243,7536629,0.0
DAL227,5p,8,->T,5,0,5,3765342,3771242,7536584,6.634305409453408e-07
DAL227,5p,9,->T,7,0,7,3765324,3771243,7536567,9.288048523949964e-07
DAL227,5p,10,->T,12,0,12,3765318,3771238,7536556,1.592239213773506e-06
DAL227,5p,11,->T,5,3,8,3765365,3771237,7536602,1.061486330311724e-06
DAL227,5p,12,->T,21,3,24,3765326,3771232,7536558,3.1844775824719985e-06
DAL227,5p,13,->T,13,7,20,3765325,3771231,7536556,2.653732022955844e-06
DAL227,5p,14,->T,15,10,25,3765297,3771226,7536523,3.317179553489056e-06
DAL227,5p,15,->T,7,18,25,3765318,3771201,7536519,3.3171813140788206e-06
DAL227,5p,16,->T,15,24,39,3765316,3771188,7536504,5.17481314943905e-06
DAL227,5p,17,->T,12,50,62,3765326,3771175,7536501,8.226629307154607e-06
DAL227,5p,18,->T,26,37,63,3765280,3771169,7536449,8.359374554249621e-06
DAL227,5p,19,->T,29,30,59,3765279,3771164,7536443,7.828626846909078e-06
DAL227,5p,20,->T,24,31,55,3765254,3771167,7536421,7.297893788046077e-06
DAL227,5p,21,->T,26,33,59,3765270,3771169,7536439,7.828631001989136e-06
DAL227,5p,22,->T,27,52,79,3765253,3771158,7536411,1.048244316824016e-05
DAL227,5p,23,->T,24,41,65,3765254,3771157,7536411,8.624795011843171e-06
DAL227,5p,24,->T,31,42,73,3765270,3771180,7536450,9.686258118875598e-06
DAL227,5p,25,->T,51,48,99,3765247,3771148,7536395,1.3136254137422469e-05
WA02,3p,1,->T,0,0,0,6552698,6754258,13306956,0.0
WA02,3p,2,->T,0,0,0,6552698,6754258,13306956,0.0
WA02,3p,3,->T,0,0,0,6552698,6754258,13306956,0.0
WA02,3p,4,->T,0,0,0,6552698,6754256,13306954,0.0
WA02,3p,5,->T,0,0,0,6552698,6754256,13306954,0.0
WA02,3p,6,->T,0,0,0,6552698,6754257,13306955,0.0
WA02,3p,7,->T,0,1,1,6552698,6754257,13306955,7.514867225447144e-08
WA02,3p,8,->T,2,18,20,6552692,6754207,13306899,1.5029797701177411e-06
WA02,3p,9,->T,5,26,31,6552688,6754191,13306879,2.329622145057455e-06
WA02,3p,10,->T,5,19,24,6552680,6754207,13306887,1.8035773505854524e-06
WA02,3p,11,->T,7,13,20,6552667,6754202,13306869,1.5029831585476643e-06
WA02,3p,12,->T,6,29,35,6552670,6754189,13306859,2.6302225040484763e-06
WA02,3p,13,->T,5,23,28,6552675,6754177,13306852,2.10417911013063e-06
WA02,3p,14,->T,14,38,52,6552653,6754155,13306808,3.907774125845958e-06
WA02,3p,15,->T,9,25,34,6552632,6754146,13306778,2.5550888426935504e-06
WA02,3p,16,->T,16,33,49,6552629,6754119,13306748,3.682342222156758e-06
WA02,3p,17,->T,15,58,73,6552608,6754116,13306724,5.485948307036352e-06
WA02,3p,18,->T,20,43,63,6552611,6754085,13306696,4.7344585011936845e-06
WA02,3p,19,->T,22,111,133,6552605,6754056,13306661,9.99499423634524e-06
WA02,3p,20,->T,26,81,107,6552618,6754033,13306651,8.041091631545758e-06
WA02,3p,21,->T,28,72,100,6552597,6754089,13306686,7.515019141505255e-06
WA02,3p,22,->T,21,74,95,6552593,6754062,13306655,7.139284816507229e-06
WA02,3p,23,->T,43,74,117,6552585,6754052,13306637,8.792604773091805e-06
WA02,3p,24,->T,38,87,125,6552556,6754026,13306582,9.393847345621887e-06
WA02,3p,25,->T,51,76,127,6552517,6754038,13306555,9.544168268947149e-06
WA02,5p,1,->T,0,0,0,6552698,6754258,13306956,0.0
WA02,5p,2,->T,0,0,0,6552562,6754179,13306741,0.0
WA02,5p,3,->T,0,0,0,6552698,6754258,13306956,0.0
WA02,5p,4,->T,0,0,0,6552698,6754258,13306956,0.0
WA02,5p,5,->T,0,0,0,6552698,6754258,13306956,0.0
WA02,5p,6,->T,1,0,1,6552697,6754258,13306955,7.514867225447144e-08
WA02,5p,7,->T,8,0,8,6552685,6754258,13306943,6.011899201792628e-07
WA02,5p,8,->T,10,0,10,6552655,6754257,13306912,7.514891509014263e-07
WA02,5p,9,->T,8,4,12,6552662,6754226,13306888,9.017886075241634e-07
WA02,5p,10,->T,28,18,46,6552618,6754222,13306840,3.4568687983022264e-06
WA02,5p,11,->T,14,6,20,6552625,6754225,13306850,1.5029853045611846e-06
WA02,5p,12,->T,20,3,23,6552628,6754236,13306864,1.7284312817805907e-06
WA02,5p,13,->T,14,15,29,6552614,6754205,13306819,2.1793337686489917e-06
WA02,5p,14,->T,28,29,57,6552607,6754183,13306790,4.283527432235724e-06
WA02,5p,15,->T,22,34,56,6552586,6754168,13306754,4.208389213477607e-06
WA02,5p,16,->T,36,24,60,6552525,6754178,13306703,4.509005724408218e-06
WA02,5p,17,->T,37,24,61,6552567,6754148,13306715,4.584151685821782e-06
WA02,5p,18,->T,35,42,77,6552548,6754087,13306635,5.786586916977884e-06
WA02,5p,19,->T,39,49,88,6552516,6754124,13306640,6.613239705891194e-06
WA02,5p,20,->T,47,56,103,6552507,6754132,13306639,7.740497055642675e-06
WA02,5p,21,->T,49,23,72,6552521,6754152,13306673,5.410819067996936e-06
WA02,5p,22,->T,54,33,87,6552516,6754117,13306633,6.538092694072197e-06
WA02,5p,23,->T,50,35,85,6552465,6754131,13306596,6.3878094743388914e-06
WA02,5p,24,->T,65,34,99,6552457,6754135,13306592,7.439921506573584e-06
WA02,5p,25,->T,55,49,104,6552470,6754083,13306553,7.815698024875413e-06
WA03,3p,1,->T,0,0,0,5399458,5543742,10943200,0.0
WA03,3p,2,->T,0,0,0,5399458,5543742,10943200,0.0
WA03,3p,3,->T,0,0,0,5399458,5543742,10943200,0.0
WA03,3p,4,->T,0,0,0,5399458,5543736,10943194,0.0
WA03,3p,5,->T,0,0,0,5399458,5543740,10943198,0.0
WA03,3p,6,->T,0,0,0,5399458,5543741,10943199,0.0
WA03,3p,7,->T,0,0,0,5399458,5543739,10943197,0.0
WA03,3p,8,->T,0,35,35,5399449,5543673,10943122,3.198356008459012e-06
WA03,3p,9,->T,7,24,31,5399436,5543670,10943106,2.832833749394368e-06
WA03,3p,10,->T,6,27,33,5399438,5543654,10943092,3.015601075089198e-06
WA03,3p,11,->T,18,28,46,5399404,5543644,10943048,4.2035820367415e-06
WA03,3p,12,->T,25,37,62,5399397,5543595,10942992,5.665726521594825e-06
WA03,3p,13,->T,20,53,73,5399378,5543551,10942929,6.670974471277297e-06
WA03,3p,14,->T,27,75,102,5399356,5543493,10942849,9.321155761173348e-06
WA03,3p,15,->T,35,69,104,5399349,5543505,10942854,9.503919178671305e-06
WA03,3p,16,->T,34,72,106,5399342,5543495,10942837,9.686701903720217e-06
WA03,3p,17,->T,24,82,106,5399346,5543438,10942784,9.686748820044332e-06
WA03,3p,18,->T,37,89,126,5399325,5543443,10942768,1.1514454112524363e-05
WA03,3p,19,->T,42,105,147,5399297,5543425,10942722,1.3433586268571931e-05
WA03,3p,20,->T,42,76,118,5399252,5543409,10942661,1.0783483103424294e-05
WA03,3p,21,->T,65,157,222,5399248,5543303,10942551,2.028777384725006e-05
WA03,3p,22,->T,52,145,197,5399256,5543263,10942519,1.8003167278028028e-05
WA03,3p,23,->T,56,139,195,5399255,5543267,10942522,1.782038912053364e-05
WA03,3p,24,->T,70,285,355,5399198,5543130,10942328,3.244282203933203e-05
WA03,3p,25,->T,167,102,269,5399050,5543142,10942192,2.458373971138507e-05
WA03,5p,1,->T,0,0,0,5399457,5543742,10943199,0.0
WA03,5p,2,->T,0,0,0,5399258,5543638,10942896,0.0
WA03,5p,3,->T,0,0,0,5399457,5543742,10943199,0.0
WA03,5p,4,->T,0,0,0,5399458,5543742,10943200,0.0
WA03,5p,5,->T,2,0,2,5399456,5543740,10943196,1.8276196460339375e-07
WA03,5p,6,->T,2,0,2,5399452,5543742,10943194,1.8276199800533562e-07
WA03,5p,7,->T,1,0,1,5399453,5543742,10943195,9.138099065218157e-08
WA03,5p,8,->T,9,3,12,5399403,5543732,10943135,1.0965779002086696e-06
WA03,5p,9,->T,30,4,34,5399319,5543732,10943051,3.1069945666889428e-06
WA03,5p,10,->T,25,8,33,5399344,5543717,10943061,3.0156096178208275e-06
WA03,5p,11,->T,51,9,60,5399321,5543705,10943026,5.482944114361055e-06
WA03,5p,12,->T,72,46,118,5399213,5543665,10942878,1.078326926426485e-05
WA03,5p,13,->T,90,33,123,5399156,5543662,10942818,1.12402490839197e-05
WA03,5p,14,->T,123,45,168,5399124,5543629,10942753,1.53526265282603e-05
WA03,5p,15,->T,110,145,255,5399092,5543505,10942597,2.330342605142088e-05
WA03,5p,16,->T,76,53,129,5399083,5543501,10942584,1.1788806007794868e-05
WA03,5p,17,->T,106,141,247,5399113,5543491,10942604,2.2572323735739683e-05
WA03,5p,18,->T,127,58,185,5399074,5543600,10942674,1.690628817051481e-05
WA03,5p,19,->T,107,59,166,5399071,5543546,10942617,1.5170045702961185e-05
WA03,5p,20,->T,112,62,174,5399050,5543533,10942583,1.5901181649707387e-05
WA03,5p,21,->T,137,88,225,5399034,5543509,10942543,2.0561947985948057e-05
WA03,5p,22,->T,136,84,220,5398989,5543454,10942443,2.010519954273465e-05
WA03,5p,23,->T,160,95,255,5398935,5543457,10942392,2.3303862628938906e-05
WA03,5p,24,->T,132,109,241,5398952,5543428,10942380,2.202445902993681e-05
WA03,5p,25,->T,123,63,186,5398991,5543444,10942435,1.6998044767915004e-05
WA07,3p,1,->T,0,0,0,5691729,6013979,11705708,0.0
WA07,3p,2,->T,0,0,0,5691729,6013979,11705708,0.0
WA07,3p,3,->T,0,0,0,5691729,6013979,11705708,0.0
WA07,3p,4,->T,0,0,0,5691729,6013979,11705708,0.0
WA07,3p,5,->T,0,0,0,5691729,6013979,11705708,0.0
WA07,3p,6,->T,0,0,0,5691729,6013979,11705708,0.0
WA07,3p,7,->T,0,0,0,5691729,6013979,11705708,0.0
WA07,3p,8,->T,7,152,159,5691713,6013800,11705513,1.3583343164883076e-05
WA07,3p,9,->T,0,67,67,5691720,6013901,11705621,5.723745882426912e-06
WA07,3p,10,->T,11,49,60,5691718,6013892,11705610,5.125747398042477e-06
WA07,3p,11,->T,7,70,77,5691711,6013883,11705594,6.578051485469255e-06
WA07,3p,12,->T,9,54,63,5691705,6013884,11705589,5.382044423394671e-06
WA07,3p,13,->T,7,91,98,5691711,6013848,11705559,8.37209055970757e-06
WA07,3p,14,->T,10,48,58,5691695,6013877,11705572,4.9549052365830565e-06
WA07,3p,15,->T,476,66,542,5691211,6013856,11705067,4.630473281357552e-05
WA07,3p,16,->T,25,54,79,5691636,6013850,11705486,6.7489722340447885e-06
WA07,3p,17,->T,6,60,66,5691662,6013813,11705475,5.63838716498049e-06
WA07,3p,18,->T,17,95,112,5691639,6013769,11705408,9.568226925537323e-06
WA07,3p,19,->T,22,92,114,5691628,6013742,11705370,9.739119737351318e-06
WA07,3p,20,->T,34,72,106,5691604,6013772,11705376,9.055668096437055e-06
WA07,3p,21,->T,31,116,147,5691611,6013735,11705346,1.255836435761916e-05
WA07,3p,22,->T,31,72,103,5691577,6013736,11705313,8.799422962888732e-06
WA07,3p,23,->T,33,92,125,5691568,6013670,11705238,1.0678979786656196e-05
WA07,3p,24,->T,29,94,123,5691554,6013661,11705215,1.0508136757846824e-05
WA07,3p,25,->T,99,123,222,5691455,6013662,11705117,1.896606415809428e-05
WA07,5p,1,->T,0,0,0,5691729,6013979,11705708,0.0
WA07,5p,2,->T,0,0,0,5691636,6013923,11705559,0.0
WA07,5p,3,->T,0,0,0,5691729,6013979,11705708,0.0
WA07,5p,4,->T,0,0,0,5691728,6013979,11705707,0.0
WA07,5p,5,->T,0,0,0,5691729,6013978,11705707,0.0
WA07,5p,6,->T,1,0,1,5691728,6013979,11705707,8.54284153874687e-08
WA07,5p,7,->T,0,0,0,5691728,6013979,11705707,0.0
WA07,5p,8,->T,4,2,6,5691579,6013975,11705554,5.125771919893753e-07
WA07,5p,9,->T,12,2,14,5691672,6013971,11705643,1.196004354480997e-06
WA07,5p,10,->T,21,3,24,5691582,6013961,11705543,2.050310694685416e-06
WA07,5p,11,->T,10,2,12,5691326,6013942,11705268,1.0251794320300911e-06
WA07,5p,12,->T,18,9,27,5691520,6013938,11705458,2.3066162810545304e-06
WA07,5p,13,->T,27,11,38,5691511,6013949,11705460,3.2463482853300937e-06
WA07,5p,14,->T,46,8,54,5691556,6013950,11705506,4.613213644929147e-06
WA07,5p,15,->T,33,9,42,5691563,6013633,11705196,3.588150083091304e-06
WA07,5p,16,->T,32,13,45,5691534,6013925,11705459,3.8443601399996364e-06
WA07,5p,17,->T,31,27,58,5691561,6013916,11705477,4.954945449894951e-06
WA07,5p,18,->T,61,32,93,5691474,6013905,11705379,7.945065255896455e-06
WA07,5p,19,->T,67,22,89,5691482,6013884,11705366,7.603350463368681e-06
WA07,5p,20,->T,75,28,103,5691421,6013876,11705297,8.79943499084218e-06
WA07,5p,21,->T,92,52,144,5691379,6013853,11705232,1.2302191020220702e-05
WA07,5p,22,->T,77,50,127,5691396,6013861,11705257,1.084982585175191e-05
WA07,5p,23,->T,77,33,110,5691314,6013795,11705109,9.397605780518575e-06
WA07,5p,24,->T,114,64,178,5691332,6013785,11705117,1.5207024415048564e-05
WA07,5p,25,->T,69,62,131,5691334,6013719,11705053,1.1191747700757955e-05
WA08,3p,1,->T,0,0,0,6798117,7189085,13987202,0.0
WA08,3p,2,->T,0,0,0,6798117,7189085,13987202,0.0
WA08,3p,3,->T,0,0,0,6798117,7189085,13987202,0.0
WA08,3p,4,->T,0,0,0,6798117,7189081,13987198,0.0
WA08,3p,5,->T,0,0,0,6798117,7189085,13987202,0.0
WA08,3p,6,->T,0,0,0,6798117,7189085,13987202,0.0
WA08,3p,7,->T,0,1,1,6798117,7189084,13987201,7.149393220273307e-08
WA08,3p,8,->T,2,23,25,6798110,7189053,13987163,1.7873531608947433e-06
WA08,3p,9,->T,3,21,24,6798103,7189051,13987154,1.7158601385242488e-06
WA08,3p,10,->T,13,15,28,6798074,7189042,13987116,2.0018422668404268e-06
WA08,3p,11,->T,1,15,16,6798109,7189046,13987155,1.143906677233505e-06
WA08,3p,12,->T,15,28,43,6798091,7189018,13987109,3.0742593054790666e-06
WA08,3p,13,->T,11,25,36,6798090,7189013,13987103,2.573799592381639e-06
WA08,3p,14,->T,11,43,54,6798067,7188981,13987048,3.8607145696504366e-06
WA08,3p,15,->T,8,30,38,6798069,7188978,13987047,2.716799335842655e-06
WA08,3p,16,->T,16,28,44,6798049,7188961,13987010,3.145775973564042e-06
WA08,3p,17,->T,19,33,52,6798000,7188943,13986943,3.7177530501125223e-06
WA08,3p,18,->T,22,33,55,6798023,7188956,13986979,3.9322286821192765e-06
WA08,3p,19,->T,9,51,60,6798028,7188946,13986974,4.28970555032132e-06
WA08,3p,20,->T,28,67,95,6798009,7188917,13986926,6.792057096748778e-06
WA08,3p,21,->T,30,70,100,6798010,7188926,13986936,7.149528674471664e-06
WA08,3p,22,->T,25,74,99,6798012,7188920,13986932,7.078035411911633e-06
WA08,3p,23,->T,37,94,131,6798009,7188864,13986873,9.365924749584844e-06
WA08,3p,24,->T,27,62,89,6798015,7188867,13986882,6.36310508660901e-06
WA08,3p,25,->T,41,71,112,6797966,7188892,13986858,8.007516770385457e-06
WA08,5p,1,->T,0,0,0,6798116,7189085,13987201,0.0
WA08,5p,2,->T,0,0,0,6797941,7188997,13986938,0.0
WA08,5p,3,->T,0,0,0,6798117,7189084,13987201,0.0
WA08,5p,4,->T,1,0,1,6798115,7189085,13987200,7.149393731411576e-08
WA08,5p,5,->T,1,0,1,6798116,7189084,13987200,7.149393731411576e-08
WA08,5p,6,->T,1,0,1,6798112,7189085,13987197,7.149395264826826e-08
WA08,5p,7,->T,1,0,1,6798110,7189085,13987195,7.149396287104027e-08
WA08,5p,8,->T,15,15,30,6798069,7189064,13987133,2.144828393352662e-06
WA08,5p,9,->T,22,4,26,6798054,7189067,13987121,1.8588528690071387e-06
WA08,5p,10,->T,23,30,53,6798015,7189037,13987052,3.789218771761197e-06
WA08,5p,11,->T,26,6,32,6797997,7189047,13987044,2.287831510360588e-06
WA08,5p,12,->T,23,6,29,6798016,7189056,13987072,2.0733431557369547e-06
WA08,5p,13,->T,28,10,38,6797995,7189043,13987038,2.7168010839750342e-06
WA08,5p,14,->T,23,14,37,6797984,7189041,13987025,2.645308777241765e-06
WA08,5p,15,->T,28,23,51,6797997,7189013,13987010,3.6462403329946857e-06
WA08,5p,16,->T,46,23,69,6797921,7188997,13986918,4.933181133971043e-06
WA08,5p,17,->T,45,47,92,6797959,7188875,13986834,6.577614347893168e-06
WA08,5p,18,->T,30,35,65,6797991,7188972,13986963,4.647184667607972e-06
WA08,5p,19,->T,35,23,58,6797966,7188988,13986954,4.146721294715061e-06
WA08,5p,20,->T,38,30,68,6797883,7188971,13986854,4.8617080009557545e-06
WA08,5p,21,->T,75,39,114,6797885,7188979,13986864,8.1505046449297e-06
WA08,5p,22,->T,59,36,95,6797887,7188939,13986826,6.792105657137652e-06
WA08,5p,23,->T,59,28,87,6797851,7188919,13986770,6.220163769047464e-06
WA08,5p,24,->T,99,64,163,6797841,7188876,13986717,1.1653914210175268e-05
WA08,5p,25,->T,88,53,141,6797835,7188817,13986652,1.0081040123111663e-05
WA09,3p,1,->T,0,0,0,4741672,4881751,9623423,0.0
WA09,3p,2,->T,0,0,0,4741672,4881751,9623423,0.0
WA09,3p,3,->T,0,0,0,4741672,4881751,9623423,0.0
WA09,3p,4,->T,0,0,0,4741672,4881748,9623420,0.0
WA09,3p,5,->T,0,0,0,4741672,4881751,9623423,0.0
WA09,3p,6,->T,0,0,0,4741672,4881751,9623423,0.0
WA09,3p,7,->T,0,0,0,4741672,4881748,9623420,0.0
WA09,3p,8,->T,1,17,18,4741663,4881718,9623381,1.870444493468564e-06
WA09,3p,9,->T,6,12,18,4741664,4881723,9623387,1.8704433272817565e-06
WA09,3p,10,->T,3,27,30,4741658,4881705,9623363,3.117413320062851e-06
WA09,3p,11,->T,2,17,19,4741648,4881712,9623360,1.974362384863499e-06
WA09,3p,12,->T,8,22,30,4741642,4881680,9623322,3.117426601749375e-06
WA09,3p,13,->T,9,46,55,4741628,4881645,9623273,5.715311204410391e-06
WA09,3p,14,->T,13,73,86,4741616,4881571,9623187,8.93674829347076e-06
WA09,3p,15,->T,17,68,85,4741598,4881557,9623155,8.832861987570604e-06
WA09,3p,16,->T,18,72,90,4741586,4881546,9623132,9.352464457517573e-06
WA09,3p,17,->T,21,86,107,4741582,4881528,9623110,1.1119066497213478e-05
WA09,3p,18,->T,25,78,103,4741560,4881490,9623050,1.0703467195951387e-05
WA09,3p,19,->T,24,128,152,4741552,4881442,9622994,1.5795499820534025e-05
WA09,3p,20,->T,39,87,126,4741534,4881501,9623035,1.3093582222240697e-05
WA09,3p,21,->T,28,113,141,4741546,4881493,9623039,1.4652335920076807e-05
WA09,3p,22,->T,33,91,124,4741524,4881498,9623022,1.2885764991496437e-05
WA09,3p,23,->T,44,95,139,4741501,4881486,9622987,1.444457942216902e-05
WA09,3p,24,->T,33,95,128,4741491,4881450,9622941,1.3301546793230884e-05
WA09,3p,25,->T,48,104,152,4741451,4881469,9622920,1.5795621287509405e-05
WA09,5p,1,->T,0,0,0,4741672,4881751,9623423,0.0
WA09,5p,2,->T,0,0,0,4741495,4881667,9623162,0.0
WA09,5p,3,->T,0,0,0,4741672,4881750,9623422,0.0
WA09,5p,4,->T,0,0,0,4741672,4881751,9623423,0.0
WA09,5p,5,->T,0,0,0,4741671,4881751,9623422,0.0
WA09,5p,6,->T,1,0,1,4741669,4881751,9623420,1.0391316184890613e-07
WA09,5p,7,->T,0,0,0,4741667,4881751,9623418,0.0
WA09,5p,8,->T,10,0,10,4741639,4881744,9623383,1.039135613744148e-06
WA09,5p,9,->T,21,0,21,4741618,4881747,9623365,2.182188870525019e-06
WA09,5p,10,->T,10,5,15,4741622,4881737,9623359,1.5587073079160822e-06
WA09,5p,11,->T,14,0,14,4741614,4881733,9623347,1.4547953014683976e-06
WA09,5p,12,->T,23,3,26,4741580,4881734,9623314,2.7017719675363397e-06
WA09,5p,13,->T,27,12,39,4741530,4881708,9623238,4.0526899573719365e-06
WA09,5p,14,->T,27,7,34,4741498,4881705,9623203,3.5331271718990027e-06
WA09,5p,15,->T,22,15,37,4741496,4881672,9623168,3.84488767108711e-06
WA09,5p,16,->T,46,36,82,4741451,4881636,9623087,8.521174130505107e-06
WA09,5p,17,->T,43,32,75,4741476,4881638,9623114,7.793734959390485e-06
WA09,5p,18,->T,46,38,84,4741455,4881610,9623065,8.729027601912696e-06
WA09,5p,19,->T,74,56,130,4741379,4881580,9622959,1.3509358192215098e-05
WA09,5p,20,->T,49,69,118,4741390,4881557,9622947,1.2262355804308182e-05
WA09,5p,21,->T,55,37,92,4741379,4881587,9622966,9.560461919952746e-06
WA09,5p,22,->T,65,54,119,4741354,4881580,9622934,1.2366290779922217e-05
WA09,5p,23,->T,75,58,133,4741312,4881565,9622877,1.382123038671283e-05
WA09,5p,24,->T,69,57,126,4741363,4881548,9622911,1.3093750945010298e-05
WA09,5p,25,->T,78,64,142,4741301,4881503,9622804,1.4756613560870616e-05
WA11,3p,1,->T,0,0,0,9756642,10108269,19864911,0.0
WA11,3p,2,->T,0,0,0,9756642,10108269,19864911,0.0
WA11,3p,3,->T,0,0,0,9756642,10108269,19864911,0.0
WA11,3p,4,->T,0,0,0,9756642,10108267,19864909,0.0
WA11,3p,5,->T,0,0,0,9756642,10108269,19864911,0.0
WA11,3p,6,->T,0,0,0,9756642,10108269,19864911,0.0
WA11,3p,7,->T,0,3,3,9756642,10108265,19864907,1.5102008783630348e-07
WA11,3p,8,->T,0,30,30,9756629,10108160,19864789,1.5102098491959818e-06
WA11,3p,9,->T,7,27,34,9756610,10108092,19864702,1.711578658466661e-06
WA11,3p,10,->T,3,30,33,9756615,10107969,19864584,1.6612479778081433e-06
WA11,3p,11,->T,16,217,233,9756587,10107918,19864505,1.1729464187504295e-05
WA11,3p,12,->T,16,51,67,9756581,10108019,19864600,3.372834086767416e-06
WA11,3p,13,->T,15,124,139,9756565,10107963,19864528,6.99739757219502e-06
WA11,3p,14,->T,30,114,144,9756515,10107914,19864429,7.24913864878774e-06
WA11,3p,15,->T,30,185,215,9756471,10107972,19864443,1.082335910450648e-05
WA11,3p,16,->T,28,84,112,9756477,10108011,19864488,5.6382022028456e-06
WA11,3p,17,->T,35,82,117,9756469,10108044,19864513,5.889900245729659e-06
WA11,3p,18,->T,42,77,119,9756421,10108016,19864437,5.990605220777211e-06
WA11,3p,19,->T,35,89,124,9756438,10108000,19864438,6.242311008244985e-06
WA11,3p,20,->T,40,91,131,9756433,10107963,19864396,6.594713476312091e-06
WA11,3p,21,->T,47,133,180,9756421,10107904,19864325,9.06147075221534e-06
WA11,3p,22,->T,55,110,165,9756405,10107842,19864247,8.306380805675645e-06
WA11,3p,23,->T,49,122,171,9756375,10107816,19864191,8.608455285191327e-06
WA11,3p,24,->T,62,136,198,9756358,10107704,19864062,9.967749798606146e-06
WA11,3p,25,->T,90,117,207,9756281,10107693,19863974,1.0420875500541835e-05
WA11,5p,1,->T,0,0,0,9756641,10108269,19864910,0.0
WA11,5p,2,->T,0,0,0,9756471,10108196,19864667,0.0
WA11,5p,3,->T,0,0,0,9756642,10108269,19864911,0.0
WA11,5p,4,->T,0,0,0,9756638,10108269,19864907,0.0
WA11,5p,5,->T,0,0,0,9756638,10108267,19864905,0.0
WA11,5p,6,->T,0,0,0,9756642,10108269,19864911,0.0
WA11,5p,7,->T,2,0,2,9756629,10108269,19864898,1.0068010417169018e-07
WA11,5p,8,->T,23,2,25,9756500,10108261,19864761,1.2585099815698764e-06
WA11,5p,9,->T,17,12,29,9756493,10108240,19864733,1.459873636358465e-06
WA11,5p,10,->T,30,28,58,9756446,10108197,19864643,2.91976050110742e-06
WA11,5p,11,->T,45,29,74,9756457,10108195,19864652,3.72520998605966e-06
WA11,5p,12,->T,62,6,68,9756411,10108221,19864632,3.4231693796290813e-06
WA11,5p,13,->T,79,27,106,9756334,10108178,19864512,5.336149209202824e-06
WA11,5p,14,->T,58,42,100,9756261,10108167,19864428,5.034124315082216e-06
WA11,5p,15,->T,100,76,176,9756237,10108096,19864333,8.860101167252886e-06
WA11,5p,16,->T,73,44,117,9756275,10108079,19864354,5.889947390184448e-06
WA11,5p,17,->T,88,80,168,9756369,10108078,19864447,8.45732076004935e-06
WA11,5p,18,->T,89,93,182,9756327,10108075,19864402,9.162118245492616e-06
WA11,5p,19,->T,81,68,149,9756284,10108088,19864372,7.500866375237032e-06
WA11,5p,20,->T,77,64,141,9756292,10108082,19864374,7.098134580027541e-06
WA11,5p,21,->T,87,61,148,9756251,10108036,19864287,7.450556871233284e-06
WA11,5p,22,->T,116,81,197,9756136,10108029,19864165,9.917356203998508e-06
WA11,5p,23,->T,120,88,208,9756095,10108016,19864111,1.0471145675736507e-05
WA11,5p,24,->T,180,70,250,9756046,10108010,19864056,1.2585546476510135e-05
WA11,5p,25,->T,132,130,262,9756056,10107943,19863999,1.3189690555260298e-05
WA12,3p,1,->T,0,0,0,6632243,6940679,13572922,0.0
WA12,3p,2,->T,0,0,0,6632243,6940679,13572922,0.0
WA12,3p,3,->T,0,0,0,6632243,6940679,13572922,0.0
WA12,3p,4,->T,0,0,0,6632243,6940676,13572919,0.0
WA12,3p,5,->T,0,0,0,6632243,6940678,13572921,0.0
WA12,3p,6,->T,0,0,0,6632243,6940679,13572922,0.0
WA12,3p,7,->T,0,0,0,6632243,6940676,13572919,0.0
WA12,3p,8,->T,1,5,6,6632240,6940664,13572904,4.420572045599085e-07
WA12,3p,9,->T,1,8,9,6632231,6940656,13572887,6.630866373528344e-07
WA12,3p,10,->T,3,14,17,6632228,6940644,13572872,1.2524983658580145e-06
WA12,3p,11,->T,4,6,10,6632231,6940642,13572873,7.367636903402839e-07
WA12,3p,12,->T,5,21,26,6632223,6940615,13572838,1.915590534566168e-06
WA12,3p,13,->T,5,25,30,6632204,6940591,13572795,2.210303773099056e-06
WA12,3p,14,->T,8,59,67,6632209,6940533,13572742,4.936364369115688e-06
WA12,3p,15,->T,10,57,67,6632188,6940474,13572662,4.93639346504024e-06
WA12,3p,16,->T,8,78,86,6632187,6940478,13572665,6.336264838187637e-06
WA12,3p,17,->T,14,74,88,6632168,6940473,13572641,6.483631299170147e-06
WA12,3p,18,->T,13,67,80,6632160,6940482,13572642,5.894209837701459e-06
WA12,3p,19,->T,38,70,108,6632121,6940435,13572556,7.957233700122512e-06
WA12,3p,20,->T,31,82,113,6632105,6940432,13572537,8.325635804124167e-06
WA12,3p,21,->T,28,86,114,6632096,6940454,13572550,8.399305952087116e-06
WA12,3p,22,->T,28,76,104,6632039,6940438,13572477,7.662565941353225e-06
WA12,3p,23,->T,32,67,99,6631950,6940459,13572409,7.294209893026359e-06
WA12,3p,24,->T,54,91,145,6631933,6940411,13572344,1.0683489896807804e-05
WA12,3p,25,->T,43,68,111,6631986,6940428,13572414,8.178353533866562e-06
WA12,5p,1,->T,0,0,0,6632243,6940679,13572922,0.0
WA12,5p,2,->T,0,0,0,6631949,6940524,13572473,0.0
WA12,5p,3,->T,1,0,1,6632242,6940678,13572920,7.367611390916619e-08
WA12,5p,4,->T,0,0,0,6632242,6940679,13572921,0.0
WA12,5p,5,->T,0,0,0,6632242,6940677,13572919,0.0
WA12,5p,6,->T,1,0,1,6632242,6940679,13572921,7.367610848099683e-08
WA12,5p,7,->T,0,0,0,6632238,6940679,13572917,0.0
WA12,5p,8,->T,13,2,15,6632204,6940670,13572874,1.1051454540873216e-06
WA12,5p,9,->T,5,2,7,6632209,6940675,13572884,5.157341652665712e-07
WA12,5p,10,->T,11,0,11,6632199,6940665,13572864,8.104405967671967e-07
WA12,5p,11,->T,15,2,17,6632166,6940667,13572833,1.2525019647703614e-06
WA12,5p,12,->T,23,4,27,6632126,6940660,13572786,1.989274714859573e-06
WA12,5p,13,->T,22,7,29,6632065,6940658,13572723,2.136638314949771e-06
WA12,5p,14,->T,27,9,36,6632026,6940638,13572664,2.6523901276860608e-06
WA12,5p,15,->T,50,11,61,6631987,6940631,13572618,4.494342948427488e-06
WA12,5p,16,->T,60,17,77,6631930,6940590,13572520,5.673227963561668e-06
WA12,5p,17,->T,57,18,75,6631958,6940621,13572579,5.525847372116972e-06
WA12,5p,18,->T,28,17,45,6632019,6940577,13572596,3.315504270516856e-06
WA12,5p,19,->T,53,64,117,6631996,6940532,13572528,8.620354292140712e-06
WA12,5p,20,->T,51,71,122,6631973,6940532,13572505,8.988760733556555e-06
WA12,5p,21,->T,54,30,84,6631936,6940534,13572470,6.188998759989892e-06
WA12,5p,22,->T,72,34,106,6631921,6940529,13572450,7.80993851515386e-06
WA12,5p,23,->T,78,55,133,6631926,6940534,13572460,9.799255256600498e-06
WA12,5p,24,->T,52,42,94,6631934,6940518,13572452,6.925793511739809e-06
WA12,5p,25,->T,51,66,117,6631933,6940515,13572448,8.62040510304405e-06
WA13,3p,1,->T,0,0,0,5896847,6081528,11978375,0.0
WA13,3p,2,->T,0,0,0,5896847,6081528,11978375,0.0
WA13,3p,3,->T,0,0,0,5896847,6081528,11978375,0.0
WA13,3p,4,->T,0,0,0,5896847,6081522,11978369,0.0
WA13,3p,5,->T,0,0,0,5896847,6081527,11978374,0.0
WA13,3p,6,->T,0,0,0,5896847,6081528,11978375,0.0
WA13,3p,7,->T,0,0,0,5896847,6081528,11978375,0.0
WA13,3p,8,->T,0,3,3,5896845,6081521,11978366,2.5045152235288185e-07
WA13,3p,9,->T,0,4,4,5896842,6081517,11978359,3.3393555828473665e-07
WA13,3p,10,->T,1,3,4,5896843,6081517,11978360,3.339355304064997e-07
WA13,3p,11,->T,3,8,11,5896841,6081492,11978333,9.183247785814604e-07
WA13,3p,12,->T,2,6,8,5896836,6081505,11978341,6.678721201875952e-07
WA13,3p,13,->T,1,21,22,5896834,6081495,11978329,1.836650170487052e-06
WA13,3p,14,->T,4,7,11,5896832,6081501,11978333,9.183247785814604e-07
WA13,3p,15,->T,2,8,10,5896825,6081505,11978330,8.348409168890822e-07
WA13,3p,16,->T,2,7,9,5896830,6081509,11978339,7.513562606635194e-07
WA13,3p,17,->T,1,2,3,5896823,6081499,11978322,2.50452442337082e-07
WA13,3p,18,->T,4,14,18,5896827,6081499,11978326,1.5027141522112525e-06
WA13,3p,19,->T,6,23,29,5896822,6081480,11978302,2.4210443183015423e-06
WA13,3p,20,->T,9,12,21,5896818,6081448,11978266,1.7531752926508728e-06
WA13,3p,21,->T,6,32,38,5896824,6081466,11978290,3.172406077996108e-06
WA13,3p,22,->T,4,21,25,5896824,6081460,11978284,2.087110307286085e-06
WA13,3p,23,->T,2,33,35,5896819,6081454,11978273,2.921957113517116e-06
WA13,3p,24,->T,10,25,35,5896803,6081440,11978243,2.9219644316783357e-06
WA13,3p,25,->T,19,30,49,5896783,6081437,11978220,4.0907580592108005e-06
WA13,5p,1,->T,0,0,0,5896847,6081528,11978375,0.0
WA13,5p,2,->T,0,0,0,5896725,6081443,11978168,0.0
WA13,5p,3,->T,0,0,0,5896847,6081528,11978375,0.0
WA13,5p,4,->T,0,0,0,5896841,6081528,11978369,0.0
WA13,5p,5,->T,0,0,0,5896841,6081528,11978369,0.0
WA13,5p,6,->T,0,0,0,5896841,6081528,11978369,0.0
WA13,5p,7,->T,0,0,0,5896845,6081528,11978373,0.0
WA13,5p,8,->T,0,1,1,5896843,6081526,11978369,8.348381987564417e-08
WA13,5p,9,->T,3,2,5,5896837,6081518,11978355,4.174195872471638e-07
WA13,5p,10,->T,3,4,7,5896833,6081518,11978351,5.843876172938996e-07
WA13,5p,11,->T,5,5,10,5896827,6081513,11978340,8.348402199303075e-07
WA13,5p,12,->T,4,3,7,5896822,6081502,11978324,5.843889345454339e-07
WA13,5p,13,->T,4,5,9,5896809,6081508,11978317,7.513576406435061e-07
WA13,5p,14,->T,2,2,4,5896802,6081520,11978322,3.339365897827759e-07
WA13,5p,15,->T,3,4,7,5896798,6081508,11978306,5.843898127164225e-07
WA13,5p,16,->T,11,4,15,5896754,6081491,11978245,1.2522702616284771e-06
WA13,5p,17,->T,7,9,16,5896805,6081514,11978319,1.3357466936721254e-06
WA13,5p,18,->T,6,12,18,5896796,6081504,11978300,1.502717413990299e-06
WA13,5p,19,->T,8,28,36,5896797,6081472,11978269,3.005442606106108e-06
WA13,5p,20,->T,12,14,26,5896788,6081482,11978270,2.170597256532037e-06
WA13,5p,21,->T,9,27,36,5896782,6081484,11978266,3.005443358830068e-06
WA13,5p,22,->T,9,9,18,5896771,6081483,11978254,1.5027231848648391e-06
WA13,5p,23,->T,12,12,24,5896768,6081501,11978269,2.0036284040707386e-06
WA13,5p,24,->T,14,12,26,5896781,6081498,11978279,2.170595625632029e-06
WA13,5p,25,->T,16,33,49,5896769,6081462,11978231,4.090754302534322e-06
WA14,3p,1,->T,0,0,0,6684341,7140972,13825313,0.0
WA14,3p,2,->T,0,0,0,6684341,7140972,13825313,0.0
WA14,3p,3,->T,0,0,0,6684341,7140972,13825313,0.0
WA14,3p,4,->T,0,1,1,6684341,7140971,13825312,7.23310982059573e-08
WA14,3p,5,->T,0,1,1,6684341,7140970,13825311,7.233110343774545e-08
WA14,3p,6,->T,0,1,1,6684341,7140971,13825312,7.23310982059573e-08
WA14,3p,7,->T,0,2,2,6684341,7140969,13825310,1.446622173390687e-07
WA14,3p,8,->T,6,24,30,6684326,7140932,13825258,2.1699414217080077e-06
WA14,3p,9,->T,6,31,37,6684323,7140920,13825243,2.676263990441253e-06
WA14,3p,10,->T,71,31,102,6684256,7140912,13825168,7.377848862306773e-06
WA14,3p,11,->T,69,38,107,6684256,7140894,13825150,7.739518196909257e-06
WA14,3p,12,->T,26,48,74,6684291,7140849,13825140,5.352567858264004e-06
WA14,3p,13,->T,14,59,73,6684289,7140794,13825083,5.280257630279688e-06
WA14,3p,14,->T,7,104,111,6684291,7140742,13825033,8.028913927366395e-06
WA14,3p,15,->T,20,128,148,6684271,7140702,13824973,1.070526503017402e-05
WA14,3p,16,->T,20,161,181,6684263,7140648,13824911,1.3092308514680492e-05
WA14,3p,17,->T,30,143,173,6684212,7140653,13824865,1.251368458209176e-05
WA14,3p,18,->T,22,123,145,6684177,7140647,13824824,1.048837945423392e-05
WA14,3p,19,->T,35,207,242,6684172,7140542,13824714,1.7504882921990284e-05
WA14,3p,20,->T,26,268,294,6684176,7140544,13824720,2.126625349374165e-05
WA14,3p,21,->T,49,349,398,6684132,7140443,13824575,2.8789311787161632e-05
WA14,3p,22,->T,34,199,233,6684105,7140560,13824665,1.685393461613717e-05
WA14,3p,23,->T,44,147,191,6683638,7140562,13824200,1.3816351036588011e-05
WA14,3p,24,->T,37,152,189,6683623,7140532,13824155,1.3671721707402733e-05
WA14,3p,25,->T,66,165,231,6683613,7140513,13824126,1.6709917140512175e-05
WA14,5p,1,->T,0,0,0,6684341,7140972,13825313,0.0
WA14,5p,2,->T,1,0,1,6684184,7140911,13825095,7.233223352172265e-08
WA14,5p,3,->T,2,0,2,6684338,7140972,13825310,1.446622173390687e-07
WA14,5p,4,->T,0,0,0,6684341,7140972,13825313,0.0
WA14,5p,5,->T,0,0,0,6684341,7140972,13825313,0.0
WA14,5p,6,->T,0,0,0,6684340,7140972,13825312,0.0
WA14,5p,7,->T,3,0,3,6684336,7140972,13825308,2.169933573993433e-07
WA14,5p,8,->T,27,0,27,6684277,7140970,13825247,1.952948833391548e-06
WA14,5p,9,->T,12,0,12,6684241,7140959,13825200,8.679802100512109e-07
WA14,5p,10,->T,29,1,30,6684210,7140628,13824838,2.170007344751526e-06
WA14,5p,11,->T,24,6,30,6684218,7140646,13824864,2.1700032636849088e-06
WA14,5p,12,->T,53,5,58,6684139,7140917,13825056,4.195281378968736e-06
WA14,5p,13,->T,54,15,69,6684018,7140931,13824949,4.990976820239988e-06
WA14,5p,14,->T,77,17,94,6683951,7140942,13824893,6.799329296798174e-06
WA14,5p,15,->T,85,23,108,6684030,7140908,13824938,7.811969934331713e-06
WA14,5p,16,->T,43,38,81,6683910,7140868,13824778,5.859045259171612e-06
WA14,5p,17,->T,69,35,104,6683904,7140873,13824777,7.522725321355998e-06
WA14,5p,18,->T,60,248,308,6683891,7140646,13824537,2.227922714518396e-05
WA14,5p,19,->T,62,79,141,6683958,7140595,13824553,1.0199244778474937e-05
WA14,5p,20,->T,97,76,173,6683860,7140558,13824418,1.2514089200717163e-05
WA14,5p,21,->T,131,73,204,6683480,7140494,13823974,1.4756972199166465e-05
WA14,5p,22,->T,76,157,233,6683768,7140398,13824166,1.685454297930161e-05
WA14,5p,23,->T,110,391,501,6683762,7140257,13824019,3.624126963367165e-05
WA14,5p,24,->T,133,137,270,6683714,7140421,13824135,1.9531059266999345e-05
WA14,5p,25,->T,146,123,269,6683731,7140511,13824242,1.9458571399430076e-05
WA18,3p,1,->T,0,0,0,14112928,14131239,28244167,0.0
WA18,3p,2,->T,0,0,0,14112928,14131239,28244167,0.0
WA18,3p,3,->T,0,0,0,14112928,14131239,28244167,0.0
WA18,3p,4,->T,0,0,0,14112928,14131238,28244166,0.0
WA18,3p,5,->T,0,0,0,14112928,14131239,28244167,0.0
WA18,3p,6,->T,0,0,0,14112928,14131239,28244167,0.0
WA18,3p,7,->T,0,0,0,14112928,14131237,28244165,0.0
WA18,3p,8,->T,0,36,36,14112927,14131187,28244114,1.2746018515574608e-06
WA18,3p,9,->T,2,38,40,14112909,14131177,28244086,1.4162256834935286e-06
WA18,3p,10,->T,8,19,27,14112909,14131197,28244106,9.559516594364855e-07
WA18,3p,11,->T,8,34,42,14112900,14131167,28244067,1.4870379680093523e-06
WA18,3p,12,->T,18,24,42,14112895,14131136,28244031,1.4870398633962695e-06
WA18,3p,13,->T,20,73,93,14112898,14131061,28243959,3.292739519980184e-06
WA18,3p,14,->T,22,68,90,14112830,14131006,28243836,3.186535993198657e-06
WA18,3p,15,->T,30,89,119,14112809,14130957,28243766,4.213319144479529e-06
WA18,3p,16,->T,38,130,168,14112765,14130927,28243692,5.9482308474402e-06
WA18,3p,17,->T,53,112,165,14112743,14130850,28243593,5.84203291698758e-06
WA18,3p,18,->T,24,191,215,14112708,14130769,28243477,7.612377187128908e-06
WA18,3p,19,->T,39,227,266,14112724,14130771,28243495,9.418097866429066e-06
WA18,3p,20,->T,67,193,260,14112697,14130797,28243494,9.205659894629184e-06
WA18,3p,21,->T,51,188,239,14112659,14130783,28243442,8.46214140613598e-06
WA18,3p,22,->T,56,269,325,14112575,14130715,28243290,1.1507157983365253e-05
WA18,3p,23,->T,74,282,356,14112548,14130648,28243196,1.26048057733976e-05
WA18,3p,24,->T,70,237,307,14112551,14130690,28243241,1.0869857322677664e-05
WA18,3p,25,->T,85,251,336,14112486,14130651,28243137,1.1896695469770233e-05
WA18,5p,1,->T,0,0,0,14112926,14131239,28244165,0.0
WA18,5p,2,->T,0,0,0,14112820,14131183,28244003,0.0
WA18,5p,3,->T,0,0,0,14112928,14131239,28244167,0.0
WA18,5p,4,->T,0,0,0,14112928,14131239,28244167,0.0
WA18,5p,5,->T,2,0,2,14112925,14131239,28244164,7.081108861993579e-08
WA18,5p,6,->T,0,0,0,14112927,14131239,28244166,0.0
WA18,5p,7,->T,3,0,3,14112921,14131239,28244160,1.0621664797253664e-07
WA18,5p,8,->T,21,6,27,14112828,14131230,28244058,9.55953284050047e-07
WA18,5p,9,->T,29,6,35,14112833,14131230,28244063,1.23919848217305e-06
WA18,5p,10,->T,26,15,41,14112791,14131213,28244004,1.4516355400601133e-06
WA18,5p,11,->T,28,6,34,14112776,14131211,28243987,1.203796050465538e-06
WA18,5p,12,->T,46,7,53,14112682,14131223,28243905,1.8765110561021929e-06
WA18,5p,13,->T,52,3,55,14112608,14131206,28243814,1.9473290682341982e-06
WA18,5p,14,->T,123,20,143,14112535,14131179,28243714,5.063073503718385e-06
WA18,5p,15,->T,77,28,105,14112545,14131148,28243693,3.717644148022711e-06
WA18,5p,16,->T,79,42,121,14112522,14131083,28243605,4.284155652226407e-06
WA18,5p,17,->T,77,50,127,14112485,14130990,28243475,4.49661381965215e-06
WA18,5p,18,->T,126,68,194,14112481,14130987,28243468,6.868844859986741e-06
WA18,5p,19,->T,117,63,180,14112359,14130867,28243226,6.373209632638991e-06
WA18,5p,20,->T,140,59,199,14112397,14130866,28243263,7.045928085575665e-06
WA18,5p,21,->T,145,68,213,14112347,14130679,28243026,7.541684803887515e-06
WA18,5p,22,->T,100,74,174,14112376,14129592,28241968,6.161043734629258e-06
WA18,5p,23,->T,133,80,213,14112288,14129275,28241563,7.542075486402788e-06
WA18,5p,24,->T,147,81,228,14112253,14129481,28241734,8.073158680695739e-06
WA18,5p,25,->T,170,123,293,14112273,14130551,28242824,1.0374316675981129e-05
WA22,3p,1,->T,0,0,0,1513709,1653397,3167106,0.0
WA22,3p,2,->T,0,1,1,1513709,1653396,3167105,3.1574576782266455e-07
WA22,3p,3,->T,0,0,0,1513709,1653396,3167105,0.0
WA22,3p,4,->T,0,0,0,1513709,1653394,3167103,0.0
WA22,3p,5,->T,0,0,0,1513709,1653397,3167106,0.0
WA22,3p,6,->T,0,0,0,1513709,1653397,3167106,0.0
WA22,3p,7,->T,0,0,0,1513709,1653397,3167106,0.0
WA22,3p,8,->T,0,1,1,1513709,1653395,3167104,3.15745867518086e-07
WA22,3p,9,->T,0,0,0,1513709,1653397,3167106,0.0
WA22,3p,10,->T,3,1,4,1513706,1653396,3167102,1.26298426763647e-06
WA22,3p,11,->T,0,0,0,1513685,1653390,3167075,0.0
WA22,3p,12,->T,27,10,37,1513662,1653379,3167041,1.1682829492892575e-05
WA22,3p,13,->T,4,8,12,1513689,1653380,3167069,3.788992282769968e-06
WA22,3p,14,->T,9,2,11,1513686,1653352,3167038,3.4732769231060694e-06
WA22,3p,15,->T,8,10,18,1513677,1653343,3167020,5.6835763588483815e-06
WA22,3p,16,->T,18,3,21,1513637,1653341,3166978,6.630927022543258e-06
WA22,3p,17,->T,7,5,12,1513671,1653319,3166990,3.7890867985058367e-06
WA22,3p,18,->T,0,21,21,1513665,1653288,3166953,6.630979367234057e-06
WA22,3p,19,->T,24,51,75,1513662,1653275,3166937,2.3682188815249563e-05
WA22,3p,20,->T,14,39,53,1513684,1653304,3166988,1.6735143928552936e-05
WA22,3p,21,->T,9,27,36,1513677,1653327,3167004,1.1367210145613962e-05
WA22,3p,22,->T,9,17,26,1513684,1653356,3167040,8.209558452056178e-06
WA22,3p,23,->T,14,16,30,1513676,1653329,3167005,9.472672130293447e-06
WA22,3p,24,->T,3,33,36,1513672,1653285,3166957,1.136737884347656e-05
WA22,3p,25,->T,26,27,53,1513669,1653296,3166965,1.6735265467095468e-05
WA22,5p,1,->T,0,0,0,1513709,1653397,3167106,0.0
WA22,5p,2,->T,0,0,0,1513674,1653378,3167052,0.0
WA22,5p,3,->T,0,0,0,1513709,1653397,3167106,0.0
WA22,5p,4,->T,0,0,0,1513709,1653397,3167106,0.0
WA22,5p,5,->T,0,0,0,1513708,1653396,3167104,0.0
WA22,5p,6,->T,5,0,5,1513704,1653397,3167101,1.578730833023639e-06
WA22,5p,7,->T,0,0,0,1513707,1653397,3167104,0.0
WA22,5p,8,->T,6,0,6,1513692,1653397,3167089,1.8944841777417685e-06
WA22,5p,9,->T,0,0,0,1513700,1653389,3167089,0.0
WA22,5p,10,->T,1,8,9,1513705,1653389,3167094,2.841721780281861e-06
WA22,5p,11,->T,0,0,0,1513699,1653381,3167080,0.0
WA22,5p,12,->T,6,0,6,1513692,1653345,3167037,1.894515283528421e-06
WA22,5p,13,->T,0,9,9,1513697,1653377,3167074,2.8417397256900217e-06
WA22,5p,14,->T,7,9,16,1513677,1653376,3167053,5.0520152330889314e-06
WA22,5p,15,->T,5,6,11,1513695,1653381,3167076,3.473235249169897e-06
WA22,5p,16,->T,2,5,7,1513668,1653368,3167036,2.210268528681076e-06
WA22,5p,17,->T,5,1,6,1513675,1653395,3167070,1.8944955431992347e-06
WA22,5p,18,->T,31,0,31,1513651,1653392,3167043,9.78831042079315e-06
WA22,5p,19,->T,12,21,33,1513674,1653350,3167024,1.0419876830740785e-05
WA22,5p,20,->T,4,20,24,1513678,1653356,3167034,7.578068312496803e-06
WA22,5p,21,->T,2,8,10,1513690,1653371,3167061,3.1575015448076306e-06
WA22,5p,22,->T,2,3,5,1513691,1653380,3167071,1.5787457875115524e-06
WA22,5p,23,->T,13,0,13,1513634,1653393,3167027,4.104796075309747e-06
WA22,5p,24,->T,4,4,8,1513632,1653375,3167007,2.5260443061856197e-06
WA22,5p,25,->T,18,2,20,1513644,1653364,3167008,6.315108771433479e-06
WA25,3p,1,->T,0,0,0,3375244,3569089,6944333,0.0
WA25,3p,2,->T,0,0,0,3375244,3569089,6944333,0.0
WA25,3p,3,->T,0,0,0,3375244,3569089,6944333,0.0
WA25,3p,4,->T,0,0,0,3375244,3569087,6944331,0.0
WA25,3p,5,->T,0,0,0,3375244,3569089,6944333,0.0
WA25,3p,6,->T,0,0,0,3375244,3569089,6944333,0.0
WA25,3p,7,->T,0,0,0,3375244,3569089,6944333,0.0
WA25,3p,8,->T,2,2,4,3375239,3569076,6944315,5.760107368401347e-07
WA25,3p,9,->T,2,9,11,3375240,3569076,6944316,1.5840292982058997e-06
WA25,3p,10,->T,0,1,1,3375240,3569075,6944315,1.440026842100337e-07
WA25,3p,11,->T,4,16,20,3375233,3569054,6944287,2.88006529684041e-06
WA25,3p,12,->T,5,8,13,3375226,3569069,6944295,1.8720402863069612e-06
WA25,3p,13,->T,4,20,24,3375230,3569053,6944283,3.4560803469559062e-06
WA25,3p,14,->T,12,17,29,3375223,3569037,6944260,4.176110917505969e-06
WA25,3p,15,->T,7,20,27,3375218,3569039,6944257,3.888104947728749e-06
WA25,3p,16,->T,25,21,46,3375196,3569030,6944226,6.624208371098521e-06
WA25,3p,17,->T,10,24,34,3375198,3569022,6944220,4.896158243834441e-06
WA25,3p,18,->T,6,31,37,3375213,3569006,6944219,5.328172973807422e-06
WA25,3p,19,->T,6,16,22,3375204,3569005,6944209,3.16810741151368e-06
WA25,3p,20,->T,8,23,31,3375190,3568979,6944169,4.464177067119191e-06
WA25,3p,21,->T,8,16,24,3375199,3568998,6944197,3.4561231485800303e-06
WA25,3p,22,->T,24,35,59,3375179,3568994,6944173,8.496332104629306e-06
WA25,3p,23,->T,19,37,56,3375175,3568972,6944147,8.064345412042689e-06
WA25,3p,24,->T,13,43,56,3375177,3568962,6944139,8.064354702577237e-06
WA25,3p,25,->T,10,27,37,3375156,3568970,6944126,5.328244331972087e-06
WA25,5p,1,->T,0,0,0,3375244,3569089,6944333,0.0
WA25,5p,2,->T,0,0,0,3375147,3569045,6944192,0.0
WA25,5p,3,->T,0,0,0,3375243,3569089,6944332,0.0
WA25,5p,4,->T,0,0,0,3375243,3569089,6944332,0.0
WA25,5p,5,->T,0,0,0,3375244,3569088,6944332,0.0
WA25,5p,6,->T,0,0,0,3375244,3569089,6944333,0.0
WA25,5p,7,->T,0,0,0,3375242,3569089,6944331,0.0
WA25,5p,8,->T,10,0,10,3375221,3569088,6944309,1.4400280863077953e-06
WA25,5p,9,->T,5,0,5,3375227,3569087,6944314,7.200135247340486e-07
WA25,5p,10,->T,11,4,15,3375217,3569085,6944302,2.160044306828822e-06
WA25,5p,11,->T,13,0,13,3375193,3569088,6944281,1.8720440604290065e-06
WA25,5p,12,->T,22,1,23,3375142,3569084,6944226,3.3121041855492605e-06
WA25,5p,13,->T,59,2,61,3375133,3569081,6944214,8.784291497929067e-06
WA25,5p,14,->T,17,11,28,3375151,3569071,6944222,4.032129157161162e-06
WA25,5p,15,->T,21,16,37,3375137,3569055,6944192,5.328193690497037e-06
WA25,5p,16,->T,39,12,51,3375081,3569035,6944116,7.344347358252656e-06
WA25,5p,17,->T,58,15,73,3375076,3568871,6943947,1.0512753049526443e-05
WA25,5p,18,->T,43,37,80,3375102,3568996,6944098,1.152057473843255e-05
WA25,5p,19,->T,42,24,66,3375134,3569021,6944155,9.50439614323125e-06
WA25,5p,20,->T,21,19,40,3375145,3569019,6944164,5.760232621234176e-06
WA25,5p,21,->T,28,22,50,3375130,3569013,6944143,7.200312551167221e-06
WA25,5p,22,->T,22,23,45,3375139,3569001,6944140,6.480284095654753e-06
WA25,5p,23,->T,34,15,49,3375144,3569002,6944146,7.056303251688544e-06
WA25,5p,24,->T,18,32,50,3375124,3568967,6944091,7.20036646985185e-06
WA25,5p,25,->T,30,42,72,3375125,3568950,6944075,1.0368551606945489e-05
WA26,3p,1,->T,0,0,0,2709623,2900126,5609749,0.0
WA26,3p,2,->T,0,0,0,2709623,2900126,5609749,0.0
WA26,3p,3,->T,0,0,0,2709623,2900126,5609749,0.0
WA26,3p,4,->T,0,0,0,2709623,2900126,5609749,0.0
WA26,3p,5,->T,0,0,0,2709623,2900126,5609749,0.0
WA26,3p,6,->T,0,0,0,2709623,2900126,5609749,0.0
WA26,3p,7,->T,0,0,0,2709623,2900126,5609749,0.0
WA26,3p,8,->T,0,3,3,2709619,2900114,5609733,5.34784810613981e-07
WA26,3p,9,->T,4,6,10,2709613,2900111,5609724,1.782618895332462e-06
WA26,3p,10,->T,4,14,18,2709609,2900074,5609683,3.2087374634181644e-06
WA26,3p,11,->T,8,21,29,2709594,2900076,5609670,5.169644560196946e-06
WA26,3p,12,->T,1,21,22,2709607,2900081,5609688,3.921786737515527e-06
WA26,3p,13,->T,3,8,11,2709604,2900084,5609688,1.9608933687577635e-06
WA26,3p,14,->T,10,16,26,2709584,2900069,5609653,4.634867789504984e-06
WA26,3p,15,->T,4,13,17,2709593,2900082,5609675,3.030478592788352e-06
WA26,3p,16,->T,15,14,29,2709580,2900075,5609655,5.169658383626088e-06
WA26,3p,17,->T,13,18,31,2709570,2900078,5609648,5.526193443866709e-06
WA26,3p,18,->T,10,18,28,2709582,2900059,5609641,4.99140675847171e-06
WA26,3p,19,->T,12,29,41,2709567,2900016,5609583,7.3089211800591955e-06
WA26,3p,20,->T,16,91,107,2709563,2899983,5609546,1.9074627429742087e-05
WA26,3p,21,->T,12,15,27,2709562,2900021,5609583,4.813191996624348e-06
WA26,3p,22,->T,29,26,55,2709522,2900007,5609529,9.80474474773194e-06
WA26,3p,23,->T,29,80,109,2709541,2899974,5609515,1.943126990479569e-05
WA26,3p,24,->T,10,60,70,2709558,2899951,5609509,1.2478810534041392e-05
WA26,3p,25,->T,27,71,98,2709500,2900002,5609502,1.7470356548584884e-05
WA26,5p,1,->T,0,0,0,2709622,2900126,5609748,0.0
WA26,5p,2,->T,0,0,0,2709554,2900092,5609646,0.0
WA26,5p,3,->T,0,0,0,2709623,2900126,5609749,0.0
WA26,5p,4,->T,0,0,0,2709623,2900126,5609749,0.0
WA26,5p,5,->T,0,0,0,2709623,2900125,5609748,0.0
WA26,5p,6,->T,0,0,0,2709621,2900126,5609747,0.0
WA26,5p,7,->T,0,0,0,2709622,2900126,5609748,0.0
WA26,5p,8,->T,2,2,4,2709609,2900124,5609733,7.130464141519748e-07
WA26,5p,9,->T,6,0,6,2709594,2900123,5609717,1.0695726718477957e-06
WA26,5p,10,->T,6,0,6,2709601,2900123,5609724,1.069571337199477e-06
WA26,5p,11,->T,4,7,11,2709605,2900103,5609708,1.9608863776866817e-06
WA26,5p,12,->T,7,4,11,2709595,2900107,5609702,1.960888475002772e-06
WA26,5p,13,->T,6,14,20,2709592,2900104,5609696,3.565255586042452e-06
WA26,5p,14,->T,11,19,30,2709563,2900089,5609652,5.34792532584909e-06
WA26,5p,15,->T,18,12,30,2709545,2900085,5609630,5.347946299488558e-06
WA26,5p,16,->T,17,21,38,2709540,2900076,5609616,6.774082218818543e-06
WA26,5p,17,->T,11,30,41,2709554,2900055,5609609,7.30888730391013e-06
WA26,5p,18,->T,17,13,30,2709554,2900082,5609636,5.347940579388752e-06
WA26,5p,19,->T,11,14,25,2709570,2900086,5609656,4.456601260398142e-06
WA26,5p,20,->T,17,21,38,2709563,2900082,5609645,6.774047199065181e-06
WA26,5p,21,->T,12,22,34,2709545,2900061,5609606,6.061031737344833e-06
WA26,5p,22,->T,22,14,36,2709542,2900059,5609601,6.4175687361721445e-06
WA26,5p,23,->T,12,11,23,2709528,2900065,5609593,4.100119206509278e-06
WA26,5p,24,->T,28,17,45,2709495,2900057,5609552,8.02203099284934e-06
WA26,5p,25,->T,25,18,43,2709506,2900041,5609547,7.665503114600876e-06
