Sample,End,Position,Substitution,Pos_Count,Neg_Count,Combined_Count,Pos_Total,Neg_Total,Combined_Total,Frequency
DAL192,3p,1,->G,0,0,0,6350003,6167708,12517711,0.0
DAL192,3p,2,->G,0,0,0,6350003,6167706,12517709,0.0
DAL192,3p,3,->G,0,0,0,6350003,6167708,12517711,0.0
DAL192,3p,4,->G,0,0,0,6350003,6167708,12517711,0.0
DAL192,3p,5,->G,0,0,0,6350003,6167708,12517711,0.0
DAL192,3p,6,->G,0,0,0,6350003,6167708,12517711,0.0
DAL192,3p,7,->G,0,0,0,6350003,6167708,12517711,0.0
DAL192,3p,8,->G,0,2,2,6350003,6167618,12517621,1.597747687040533e-07
DAL192,3p,9,->G,0,9,9,6350003,6167637,12517640,7.189853678488916e-07
DAL192,3p,10,->G,0,3,3,6350003,6167645,12517648,2.3966163611566645e-07
DAL192,3p,11,->G,8,0,8,6349987,6167644,12517631,6.390985642570867e-07
DAL192,3p,12,->G,5,5,10,6349997,6167646,12517643,7.988724394840147e-07
DAL192,3p,13,->G,5,13,18,6349992,6167621,12517613,1.4379738373442286e-06
DAL192,3p,14,->G,4,14,18,6349967,6167610,12517577,1.4379779728936358e-06
DAL192,3p,15,->G,10,5,15,6349968,6167615,12517583,1.1983144030281243e-06
DAL192,3p,16,->G,11,6,17,6349943,6167587,12517530,1.3580954070012216e-06
DAL192,3p,17,->G,10,20,30,6349922,6167606,12517528,2.396639336456847e-06
DAL192,3p,18,->G,7,15,22,6349922,6167564,12517486,1.7575414104717194e-06
DAL192,3p,19,->G,16,24,40,6349921,6167519,12517440,3.195541580387044e-06
DAL192,3p,20,->G,13,24,37,6349910,6167516,12517426,2.955879267830303e-06
DAL192,3p,21,->G,22,59,81,6349882,6167507,12517389,6.470998065171579e-06
DAL192,3p,22,->G,20,52,72,6349894,6167488,12517382,5.752001496798612e-06
DAL192,3p,23,->G,31,42,73,6349902,6167465,12517367,5.831897395035234e-06
DAL192,3p,24,->G,27,38,65,6349899,6167465,12517364,5.192786596283371e-06
DAL192,3p,25,->G,24,25,49,6349856,6167384,12517240,3.914600982325177e-06
DAL192,5p,1,->G,0,0,0,6350003,6167708,12517711,0.0
DAL192,5p,2,->G,0,0,0,6349992,6167694,12517686,0.0
DAL192,5p,3,->G,0,0,0,6350003,6167707,12517710,0.0
DAL192,5p,4,->G,0,0,0,6350003,6167708,12517711,0.0
DAL192,5p,5,->G,0,0,0,6350003,6167707,12517710,0.0
DAL192,5p,6,->G,0,0,0,6350002,6167707,12517709,0.0
DAL192,5p,7,->G,0,0,0,6350002,6167708,12517710,0.0
DAL192,5p,8,->G,0,0,0,6349926,6167708,12517634,0.0
DAL192,5p,9,->G,5,0,5,6349914,6167708,12517622,3.994368898501648e-07
DAL192,5p,10,->G,2,0,2,6349896,6167708,12517604,1.5977498569215005e-07
DAL192,5p,11,->G,1,0,1,6349942,6167706,12517648,7.988721203855549e-08
DAL192,5p,12,->G,0,0,0,6349906,6167700,12517606,0.0
DAL192,5p,13,->G,4,0,4,6349906,6167705,12517611,3.1954979268807765e-07
DAL192,5p,14,->G,14,2,16,6349889,6167679,12517568,1.278203561586404e-06
DAL192,5p,15,->G,16,13,29,6349890,6167649,12517539,2.316749322690347e-06
DAL192,5p,16,->G,15,4,19,6349904,6167639,12517543,1.5178697608628148e-06
DAL192,5p,17,->G,28,7,35,6349778,6167623,12517401,2.796107594539793e-06
DAL192,5p,18,->G,32,9,41,6349859,6167631,12517490,3.275417036482554e-06
DAL192,5p,19,->G,29,8,37,6349822,6167638,12517460,2.9558712390532906e-06
DAL192,5p,20,->G,23,12,35,6349836,6167621,12517457,2.796095085447468e-06
DAL192,5p,21,->G,28,17,45,6349784,6167624,12517408,3.594993468296312e-06
DAL192,5p,22,->G,32,8,40,6349783,6167584,12517367,3.1955602164576625e-06
DAL192,5p,23,->G,47,15,62,6349801,6167567,12517368,4.953117939809711e-06
DAL192,5p,24,->G,69,32,101,6349759,6167564,12517323,8.068817909388453e-06
DAL192,5p,25,->G,43,19,62,6349777,6167551,12517328,4.953133767845662e-06
DAL193,3p,1,->G,0,0,0,6484405,6362696,12847101,0.0
DAL193,3p,2,->G,0,0,0,6484402,6362696,12847098,0.0
DAL193,3p,3,->G,0,0,0,6484405,6362696,12847101,0.0
DAL193,3p,4,->G,0,0,0,6484405,6362696,12847101,0.0
DAL193,3p,5,->G,0,0,0,6484405,6362696,12847101,0.0
DAL193,3p,6,->G,0,0,0,6484405,6362696,12847101,0.0
DAL193,3p,7,->G,0,0,0,6484405,6362696,12847101,0.0
DAL193,3p,8,->G,2,0,2,6484400,6362644,12847044,1.556778353059272e-07
DAL193,3p,9,->G,0,9,9,6484400,6362631,12847031,7.005509677683505e-07
DAL193,3p,10,->G,1,2,3,6484393,6362640,12847033,2.3351695290266639e-07
DAL193,3p,11,->G,5,2,7,6484398,6362639,12847037,5.448727204568649e-07
DAL193,3p,12,->G,1,14,15,6484368,6362594,12846962,1.1675912172854563e-06
DAL193,3p,13,->G,4,35,39,6484385,6362543,12846928,3.0357451991635665e-06
DAL193,3p,14,->G,6,58,64,6484363,6362486,12846849,4.981766345973242e-06
DAL193,3p,15,->G,4,29,33,6484332,6362438,12846770,2.5687390682638515e-06
DAL193,3p,16,->G,16,32,48,6484341,6362460,12846801,3.7363387196548e-06
DAL193,3p,17,->G,20,41,61,6484294,6362445,12846739,4.748286705287622e-06
DAL193,3p,18,->G,44,56,100,6484244,6362380,12846624,7.784146247294232e-06
DAL193,3p,19,->G,34,59,93,6484265,6362400,12846665,7.239232905972094e-06
DAL193,3p,20,->G,29,46,75,6484261,6362382,12846643,5.83810105099052e-06
DAL193,3p,21,->G,27,31,58,6484248,6362443,12846691,4.514781277139771e-06
DAL193,3p,22,->G,41,47,88,6484224,6362407,12846631,6.850044965096297e-06
DAL193,3p,23,->G,46,52,98,6484218,6362399,12846617,7.628467479025801e-06
DAL193,3p,24,->G,50,77,127,6484164,6362319,12846483,9.885974239019347e-06
DAL193,3p,25,->G,105,57,162,6484128,6362355,12846483,1.261045532851287e-05
DAL193,5p,1,->G,0,0,0,6484405,6362696,12847101,0.0
DAL193,5p,2,->G,0,0,0,6484386,6362681,12847067,0.0
DAL193,5p,3,->G,0,0,0,6484400,6362696,12847096,0.0
DAL193,5p,4,->G,0,0,0,6484403,6362696,12847099,0.0
DAL193,5p,5,->G,0,0,0,6484403,6362696,12847099,0.0
DAL193,5p,6,->G,0,0,0,6484404,6362696,12847100,0.0
DAL193,5p,7,->G,0,0,0,6484404,6362696,12847100,0.0
DAL193,5p,8,->G,0,2,2,6484314,6362693,12847007,1.55678283665604e-07
DAL193,5p,9,->G,1,1,2,6484295,6362695,12846990,1.5567848966956464e-07
DAL193,5p,10,->G,2,0,2,6484284,6362694,12846978,1.5567863508445334e-07
DAL193,5p,11,->G,3,2,5,6484315,6362677,12846992,3.891961635844407e-07
DAL193,5p,12,->G,52,0,52,6484218,6362670,12846888,4.04767286832422e-06
DAL193,5p,13,->G,40,0,40,6484143,6362652,12846795,3.113617053903328e-06
DAL193,5p,14,->G,38,12,50,6484145,6362627,12846772,3.892028285393405e-06
DAL193,5p,15,->G,56,6,62,6484166,6362534,12846700,4.826142122101395e-06
DAL193,5p,16,->G,70,15,85,6484111,6362519,12846630,6.616521219961967e-06
DAL193,5p,17,->G,76,10,86,6484043,6362598,12846641,6.694356913997986e-06
DAL193,5p,18,->G,72,7,79,6483967,6362571,12846538,6.149516702476574e-06
DAL193,5p,19,->G,77,14,91,6483980,6362593,12846573,7.0836012063295015e-06
DAL193,5p,20,->G,75,19,94,6483952,6362554,12846506,7.317164682754984e-06
DAL193,5p,21,->G,63,27,90,6484003,6362532,12846535,7.005780157840227e-06
DAL193,5p,22,->G,94,34,128,6484010,6362499,12846509,9.963796390132135e-06
DAL193,5p,23,->G,105,26,131,6483966,6362463,12846429,1.0197386370951804e-05
DAL193,5p,24,->G,132,55,187,6483905,6362426,12846331,1.455668548475047e-05
DAL193,5p,25,->G,134,45,179,6483942,6362403,12846345,1.393392439639446e-05
DAL195,3p,1,->G,0,0,0,2363278,2267461,4630739,0.0
DAL195,3p,2,->G,0,0,0,2363278,2267460,4630738,0.0
DAL195,3p,3,->G,0,0,0,2363278,2267461,4630739,0.0
DAL195,3p,4,->G,0,0,0,2363278,2267461,4630739,0.0
DAL195,3p,5,->G,0,0,0,2363278,2267461,4630739,0.0
DAL195,3p,6,->G,0,0,0,2363278,2267461,4630739,0.0
DAL195,3p,7,->G,0,0,0,2363278,2267461,4630739,0.0
DAL195,3p,8,->G,0,6,6,2363278,2267413,4630691,1.295702952323962e-06
DAL195,3p,9,->G,0,2,2,2363276,2267438,4630714,4.318988389263513e-07
DAL195,3p,10,->G,1,2,3,2363274,2267432,4630706,6.47849377611103e-07
DAL195,3p,11,->G,1,0,1,2363274,2267431,4630705,2.159498391713573e-07
DAL195,3p,12,->G,1,3,4,2363273,2267414,4630687,8.638027143704595e-07
DAL195,3p,13,->G,4,10,14,2363269,2267412,4630681,3.023313417616113e-06
DAL195,3p,14,->G,10,11,21,2363250,2267410,4630660,4.534990692471483e-06
DAL195,3p,15,->G,1,5,6,2363254,2267411,4630665,1.2957102273647522e-06
DAL195,3p,16,->G,3,17,20,2363259,2267394,4630653,4.319045283678133e-06
DAL195,3p,17,->G,7,9,16,2363234,2267398,4630632,3.455251896501385e-06
DAL195,3p,18,->G,6,18,24,2363236,2267374,4630610,5.182902468573255e-06
DAL195,3p,19,->G,15,12,27,2363215,2267369,4630584,5.830798015973795e-06
DAL195,3p,20,->G,11,9,20,2363222,2267380,4630602,4.319092852290048e-06
DAL195,3p,21,->G,12,11,23,2363235,2267382,4630617,4.966940690625029e-06
DAL195,3p,22,->G,16,14,30,2363231,2267383,4630614,6.47862248937182e-06
DAL195,3p,23,->G,11,17,28,2363219,2267370,4630589,6.046746968906115e-06
DAL195,3p,24,->G,16,11,27,2363198,2267373,4630571,5.830814385526105e-06
DAL195,3p,25,->G,18,17,35,2363180,2267377,4630557,7.558485944563473e-06
DAL195,5p,1,->G,0,0,0,2363278,2267461,4630739,0.0
DAL195,5p,2,->G,0,0,0,2363264,2267447,4630711,0.0
DAL195,5p,3,->G,0,0,0,2363278,2267459,4630737,0.0
DAL195,5p,4,->G,0,0,0,2363278,2267461,4630739,0.0
DAL195,5p,5,->G,1,0,1,2363277,2267461,4630738,2.1594830024933394e-07
DAL195,5p,6,->G,0,0,0,2363277,2267461,4630738,0.0
DAL195,5p,7,->G,1,0,1,2363277,2267461,4630738,2.1594830024933394e-07
DAL195,5p,8,->G,2,1,3,2363212,2267460,4630672,6.478541343459437e-07
DAL195,5p,9,->G,0,0,0,2363181,2267461,4630642,0.0
DAL195,5p,10,->G,3,0,3,2363146,2267458,4630604,6.47863648025182e-07
DAL195,5p,11,->G,1,0,1,2362948,2267450,4630398,2.159641568608141e-07
DAL195,5p,12,->G,9,2,11,2362864,2267454,4630318,2.375646769833087e-06
DAL195,5p,13,->G,6,5,11,2363073,2267445,4630518,2.375544161581922e-06
DAL195,5p,14,->G,14,3,17,2363094,2267434,4630528,3.671287593984962e-06
DAL195,5p,15,->G,10,4,14,2363178,2267432,4630610,3.0233597733343987e-06
DAL195,5p,16,->G,21,9,30,2363170,2267429,4630599,6.478643475714481e-06
DAL195,5p,17,->G,16,2,18,2363159,2267431,4630590,3.887193640551204e-06
DAL195,5p,18,->G,16,5,21,2363182,2267420,4630602,4.53504749490455e-06
DAL195,5p,19,->G,25,5,30,2363138,2267420,4630558,6.478700839078141e-06
DAL195,5p,20,->G,15,8,23,2363110,2267401,4630511,4.967054392053058e-06
DAL195,5p,21,->G,27,9,36,2363086,2267400,4630486,7.774561892639348e-06
DAL195,5p,22,->G,30,7,37,2363094,2267388,4630482,7.990528847752782e-06
DAL195,5p,23,->G,30,9,39,2363068,2267398,4630466,8.422478428736977e-06
DAL195,5p,24,->G,62,12,74,2363067,2267402,4630469,1.5981102562181067e-05
DAL195,5p,25,->G,38,16,54,2363135,2267374,4630509,1.1661784913926307e-05
DAL212,3p,1,->G,0,0,0,4131322,4008153,8139475,0.0
DAL212,3p,2,->G,0,0,0,4131322,4008153,8139475,0.0
DAL212,3p,3,->G,0,0,0,4131322,4008153,8139475,0.0
DAL212,3p,4,->G,0,0,0,4131322,4008153,8139475,0.0
DAL212,3p,5,->G,0,0,0,4131322,4008151,8139473,0.0
DAL212,3p,6,->G,0,0,0,4131322,4008151,8139473,0.0
DAL212,3p,7,->G,0,0,0,4131322,4008153,8139475,0.0
DAL212,3p,8,->G,0,2,2,4131319,4008093,8139412,2.4571799535396415e-07
DAL212,3p,9,->G,3,0,3,4131316,4008115,8139431,3.685761326559559e-07
DAL212,3p,10,->G,0,2,2,4131317,4008102,8139419,2.457177840334795e-07
DAL212,3p,11,->G,6,1,7,4131313,4008105,8139418,8.600123497773428e-07
DAL212,3p,12,->G,3,13,16,4131314,4008034,8139348,1.9657594195505585e-06
DAL212,3p,13,->G,3,50,53,4131307,4007923,8139230,6.511672480074896e-06
DAL212,3p,14,->G,5,35,40,4131271,4007904,8139175,4.914503005525744e-06
DAL212,3p,15,->G,9,16,25,4131254,4007935,8139189,3.0715590951383488e-06
DAL212,3p,16,->G,8,21,29,4131236,4007982,8139218,3.5629958553757865e-06
DAL212,3p,17,->G,5,53,58,4131249,4007981,8139230,7.125981204610264e-06
DAL212,3p,18,->G,13,37,50,4131222,4007954,8139176,6.143128002146655e-06
DAL212,3p,19,->G,8,32,40,4131233,4007956,8139189,4.9144945522213575e-06
DAL212,3p,20,->G,13,43,56,4131221,4007928,8139149,6.880326186435461e-06
DAL212,3p,21,->G,12,22,34,4131228,4007917,8139145,4.177342951870252e-06
DAL212,3p,22,->G,16,41,57,4131183,4007898,8139081,7.003247663956164e-06
DAL212,3p,23,->G,39,48,87,4131172,4007904,8139076,1.0689174053664075e-05
DAL212,3p,24,->G,22,48,70,4131124,4007904,8139028,8.600535592210765e-06
DAL212,3p,25,->G,38,45,83,4131071,4007924,8138995,1.019781926392632e-05
DAL212,5p,1,->G,0,0,0,4131322,4008153,8139475,0.0
DAL212,5p,2,->G,0,0,0,4131307,4008143,8139450,0.0
DAL212,5p,3,->G,0,0,0,4131321,4008153,8139474,0.0
DAL212,5p,4,->G,0,0,0,4131322,4008153,8139475,0.0
DAL212,5p,5,->G,0,0,0,4131322,4008153,8139475,0.0
DAL212,5p,6,->G,0,0,0,4131322,4008153,8139475,0.0
DAL212,5p,7,->G,0,0,0,4131322,4008153,8139475,0.0
DAL212,5p,8,->G,1,0,1,4131248,4008153,8139401,1.228591637148729e-07
DAL212,5p,9,->G,3,0,3,4131243,4008153,8139396,3.685777175603693e-07
DAL212,5p,10,->G,2,1,3,4131179,4008148,8139327,3.685808421261365e-07
DAL212,5p,11,->G,0,2,2,4131234,4008143,8139377,2.457190519618393e-07
DAL212,5p,12,->G,42,0,42,4131187,4008141,8139328,5.160131155790748e-06
DAL212,5p,13,->G,23,3,26,4131181,4008142,8139323,3.1943688682707397e-06
DAL212,5p,14,->G,21,9,30,4131134,4008108,8139242,3.6858469130172072e-06
DAL212,5p,15,->G,26,11,37,4131156,4008091,8139247,4.545875066821292e-06
DAL212,5p,16,->G,25,5,30,4131154,4008081,8139235,3.685850082962342e-06
DAL212,5p,17,->G,22,12,34,4131159,4008081,8139240,4.1772941945439626e-06
DAL212,5p,18,->G,49,9,58,4131113,4008066,8139179,7.126025855924781e-06
DAL212,5p,19,->G,51,8,59,4131040,4008052,8139092,7.248965855159273e-06
DAL212,5p,20,->G,91,14,105,4131020,4008040,8139060,1.2900752666769873e-05
DAL212,5p,21,->G,116,20,136,4130973,4008040,8139013,1.670964280312613e-05
DAL212,5p,22,->G,90,84,174,4131015,4007967,8138982,2.137859501347957e-05
DAL212,5p,23,->G,84,21,105,4131005,4007962,8138967,1.290090007736854e-05
DAL212,5p,24,->G,49,63,112,4131060,4007918,8138978,1.376094148429938e-05
DAL212,5p,25,->G,75,270,345,4131016,4007614,8138630,4.23904268900294e-05
DAL218,3p,1,->G,0,0,0,6952891,6658031,13610922,0.0
DAL218,3p,2,->G,0,0,0,6952891,6658031,13610922,0.0
DAL218,3p,3,->G,0,0,0,6952891,6658030,13610921,0.0
DAL218,3p,4,->G,0,0,0,6952891,6658031,13610922,0.0
DAL218,3p,5,->G,0,0,0,6952891,6658031,13610922,0.0
DAL218,3p,6,->G,0,0,0,6952891,6658030,13610921,0.0
DAL218,3p,7,->G,0,1,1,6952891,6658026,13610917,7.347043553347654e-08
DAL218,3p,8,->G,0,8,8,6952887,6657945,13610832,5.877671548660655e-07
DAL218,3p,9,->G,3,9,12,6952882,6657945,13610827,8.816510561775563e-07
DAL218,3p,10,->G,0,5,5,6952881,6657960,13610841,3.673542288826973e-07
DAL218,3p,11,->G,4,14,18,6952866,6657905,13610771,1.3224820254488154e-06
DAL218,3p,12,->G,3,33,36,6952858,6657882,13610740,2.644970075102456e-06
DAL218,3p,13,->G,2,50,52,6952870,6657811,13610681,3.8205288919782925e-06
DAL218,3p,14,->G,3,34,37,6952816,6657779,13610595,2.718470426899045e-06
DAL218,3p,15,->G,18,83,101,6952788,6657738,13610526,7.420727163667297e-06
DAL218,3p,16,->G,23,75,98,6952760,6657689,13610449,7.200350260303683e-06
DAL218,3p,17,->G,12,67,79,6952737,6657651,13610388,5.804389999756069e-06
DAL218,3p,18,->G,33,85,118,6952711,6657672,13610383,8.669851539078658e-06
DAL218,3p,19,->G,28,43,71,6952716,6657697,13610413,5.216594088658441e-06
DAL218,3p,20,->G,35,53,88,6952697,6657752,13610449,6.465620641905348e-06
DAL218,3p,21,->G,42,72,114,6952660,6657692,13610352,8.375977344303807e-06
DAL218,3p,22,->G,36,81,117,6952654,6657637,13610291,8.596436328951379e-06
DAL218,3p,23,->G,69,92,161,6952651,6657632,13610283,1.1829291132300482e-05
DAL218,3p,24,->G,48,104,152,6952669,6657588,13610257,1.1168047745167488e-05
DAL218,3p,25,->G,58,97,155,6952605,6657566,13610171,1.1388541701643572e-05
DAL218,5p,1,->G,0,0,0,6952891,6658031,13610922,0.0
DAL218,5p,2,->G,0,0,0,6952874,6658014,13610888,0.0
DAL218,5p,3,->G,0,0,0,6952891,6658031,13610922,0.0
DAL218,5p,4,->G,0,0,0,6952891,6658031,13610922,0.0
DAL218,5p,5,->G,0,0,0,6952891,6658031,13610922,0.0
DAL218,5p,6,->G,0,0,0,6952891,6658031,13610922,0.0
DAL218,5p,7,->G,1,0,1,6952888,6658031,13610919,7.347042473766835e-08
DAL218,5p,8,->G,15,0,15,6952719,6658029,13610748,1.102070216860969e-06
DAL218,5p,9,->G,4,1,5,6952736,6658029,13610765,3.67356280120919e-07
DAL218,5p,10,->G,23,1,24,6952716,6658028,13610744,1.7633128651894416e-06
DAL218,5p,11,->G,37,4,41,6952715,6658016,13610731,3.0123290218578268e-06
DAL218,5p,12,->G,34,5,39,6952625,6658005,13610630,2.8654074058291205e-06
DAL218,5p,13,->G,64,2,66,6952475,6658005,13610480,4.849204436581223e-06
DAL218,5p,14,->G,78,20,98,6952554,6657955,13610509,7.200318518580018e-06
DAL218,5p,15,->G,102,8,110,6952449,6657923,13610372,8.082071526039111e-06
DAL218,5p,16,->G,78,7,85,6952253,6657920,13610173,6.2453284025118566e-06
DAL218,5p,17,->G,84,20,104,6952350,6657874,13610224,7.641314353092205e-06
DAL218,5p,18,->G,85,26,111,6952457,6657843,13610300,8.155588047287716e-06
DAL218,5p,19,->G,115,36,151,6952296,6657770,13610066,1.1094729445103352e-05
DAL218,5p,20,->G,82,32,114,6952289,6657772,13610061,8.376156433097545e-06
DAL218,5p,21,->G,104,82,186,6952371,6657729,13610100,1.3666321334891e-05
DAL218,5p,22,->G,144,40,184,6952322,6657786,13610108,1.3519363696452666e-05
DAL218,5p,23,->G,134,41,175,6952288,6657745,13610033,1.2858161328484656e-05
DAL218,5p,24,->G,108,68,176,6952375,6657772,13610147,1.2931528219349873e-05
DAL218,5p,25,->G,108,80,188,6952272,6657720,13609992,1.3813380639753498e-05
DAL224,3p,1,->G,0,0,0,4609472,4586477,9195949,0.0
DAL224,3p,2,->G,0,0,0,4609471,4586476,9195947,0.0
DAL224,3p,3,->G,0,0,0,4609472,4586477,9195949,0.0
DAL224,3p,4,->G,0,0,0,4609472,4586477,9195949,0.0
DAL224,3p,5,->G,0,0,0,4609472,4586477,9195949,0.0
DAL224,3p,6,->G,0,0,0,4609472,4586477,9195949,0.0
DAL224,3p,7,->G,0,0,0,4609472,4586476,9195948,0.0
DAL224,3p,8,->G,1,3,4,4609469,4586423,9195892,4.349768353086356e-07
DAL224,3p,9,->G,2,2,4,4609466,4586431,9195897,4.349765988027052e-07
DAL224,3p,10,->G,4,3,7,4609461,4586371,9195832,7.612144284497586e-07
DAL224,3p,11,->G,1,1,2,4609461,4586382,9195843,2.1748957654018237e-07
DAL224,3p,12,->G,7,4,11,4609458,4586384,9195842,1.1961928010507357e-06
DAL224,3p,13,->G,4,20,24,4609454,4586364,9195818,2.609882013758863e-06
DAL224,3p,14,->G,1,18,19,4609412,4586293,9195705,2.0661819838718186e-06
DAL224,3p,15,->G,19,28,47,4609400,4586272,9195672,5.111100091434318e-06
DAL224,3p,16,->G,12,27,39,4609379,4586240,9195619,4.241150051997588e-06
DAL224,3p,17,->G,19,24,43,4609381,4586216,9195597,4.67615098834801e-06
DAL224,3p,18,->G,13,24,37,4609363,4586282,9195645,4.0236438009514285e-06
DAL224,3p,19,->G,20,63,83,4609353,4586195,9195548,9.02610698133488e-06
DAL224,3p,20,->G,22,46,68,4609344,4586225,9195569,7.394865940324084e-06
DAL224,3p,21,->G,17,55,72,4609343,4586223,9195566,7.82986060890651e-06
DAL224,3p,22,->G,25,65,90,4609324,4586172,9195496,9.787400266391285e-06
DAL224,3p,23,->G,36,34,70,4609323,4586083,9195406,7.612496935969983e-06
DAL224,3p,24,->G,31,34,65,4609325,4586202,9195527,7.068654140214041e-06
DAL224,3p,25,->G,24,50,74,4609265,4586173,9195438,8.047468755702556e-06
DAL224,5p,1,->G,0,0,0,4609472,4586477,9195949,0.0
DAL224,5p,2,->G,0,0,0,4609461,4586469,9195930,0.0
DAL224,5p,3,->G,0,0,0,4609468,4586477,9195945,0.0
DAL224,5p,4,->G,0,0,0,4609471,4586477,9195948,0.0
DAL224,5p,5,->G,0,0,0,4609471,4586477,9195948,0.0
DAL224,5p,6,->G,0,0,0,4609472,4586477,9195949,0.0
DAL224,5p,7,->G,0,0,0,4609471,4586477,9195948,0.0
DAL224,5p,8,->G,1,0,1,4609397,4586477,9195874,1.0874442168302872e-07
DAL224,5p,9,->G,1,0,1,4609357,4586473,9195830,1.0874494200088522e-07
DAL224,5p,10,->G,9,0,9,4609338,4586470,9195808,9.787068194551255e-07
DAL224,5p,11,->G,9,3,12,4609388,4586469,9195857,1.3049354725720506e-06
DAL224,5p,12,->G,11,1,12,4609357,4586464,9195821,1.3049405811618124e-06
DAL224,5p,13,->G,13,0,13,4609320,4586461,9195781,1.413691778871202e-06
DAL224,5p,14,->G,37,7,44,4609270,4586428,9195698,4.7848461313105325e-06
DAL224,5p,15,->G,27,9,36,4609299,4586416,9195715,3.9148668700585e-06
DAL224,5p,16,->G,30,10,40,4609292,4586373,9195665,4.349875729487753e-06
DAL224,5p,17,->G,28,6,34,4609285,4586385,9195670,3.697392359664929e-06
DAL224,5p,18,->G,39,10,49,4609226,4586351,9195577,5.328648762334326e-06
DAL224,5p,19,->G,55,14,69,4609203,4586337,9195540,7.503637633026445e-06
DAL224,5p,20,->G,52,29,81,4609148,4586313,9195461,8.808693767501161e-06
DAL224,5p,21,->G,49,19,68,4609195,4586347,9195542,7.39488765316933e-06
DAL224,5p,22,->G,50,24,74,4609138,4586312,9195450,8.047458253810308e-06
DAL224,5p,23,->G,52,41,93,4609100,4586313,9195413,1.0113738230137134e-05
DAL224,5p,24,->G,60,26,86,4609109,4586316,9195425,9.352476911072626e-06
DAL224,5p,25,->G,52,34,86,4609125,4586257,9195382,9.352520645689325e-06
DAL227,3p,1,->G,0,0,0,3765386,3771243,7536629,0.0
DAL227,3p,2,->G,0,0,0,3765386,3771243,7536629,0.0
DAL227,3p,3,->G,0,0,0,3765386,3771243,7536629,0.0
DAL227,3p,4,->G,0,0,0,3765386,3771243,7536629,0.0
DAL227,3p,5,->G,0,0,0,3765386,3771243,7536629,0.0
DAL227,3p,6,->G,0,0,0,3765386,3771243,7536629,0.0
DAL227,3p,7,->G,0,0,0,3765386,3771243,7536629,0.0
DAL227,3p,8,->G,0,3,3,3765386,3771207,7536593,3.980578492164828e-07
DAL227,3p,9,->G,1,1,2,3765384,3771218,7536602,2.65371582577931e-07
DAL227,3p,10,->G,0,1,1,3765382,3771209,7536591,1.3268598494995946e-07
DAL227,3p,11,->G,0,4,4,3765378,3771214,7536592,5.307438693775648e-07
DAL227,3p,12,->G,3,30,33,3765377,3771173,7536550,4.378661323815274e-06
DAL227,3p,13,->G,4,10,14,3765373,3771183,7536556,1.8576124160690903e-06
DAL227,3p,14,->G,1,5,6,3765341,3771166,7536507,7.961247830062388e-07
DAL227,3p,15,->G,13,8,21,3765341,3771186,7536527,2.7864293460369743e-06
DAL227,3p,16,->G,5,113,118,3765340,3771079,7536419,1.565730355491116e-05
DAL227,3p,17,->G,10,15,25,3765328,3771049,7536377,3.3172438162262847e-06
DAL227,3p,18,->G,16,17,33,3765321,3771036,7536357,4.3787734577860365e-06
DAL227,3p,19,->G,11,23,34,3765313,3771111,7536424,4.511423454943618e-06
DAL227,3p,20,->G,12,17,29,3765308,3771082,7536390,3.847996189156877e-06
DAL227,3p,21,->G,16,16,32,3765307,3771104,7536411,4.246052928907407e-06
DAL227,3p,22,->G,15,14,29,3765309,3771137,7536446,3.847967596397559e-06
DAL227,3p,23,->G,7,10,17,3765319,3771112,7536431,2.255709632318003e-06
DAL227,3p,24,->G,20,25,45,3765312,3771081,7536393,5.971026192503496e-06
DAL227,3p,25,->G,25,14,39,3765249,3771100,7536349,5.174919579759377e-06
DAL227,5p,1,->G,0,0,0,3765386,3771243,7536629,0.0
DAL227,5p,2,->G,0,0,0,3765373,3771238,7536611,0.0
DAL227,5p,3,->G,0,0,0,3765386,3771243,7536629,0.0
DAL227,5p,4,->G,0,0,0,3765385,3771243,7536628,0.0
DAL227,5p,5,->G,0,0,0,3765386,3771242,7536628,0.0
DAL227,5p,6,->G,0,0,0,3765386,3771243,7536629,0.0
DAL227,5p,7,->G,0,0,0,3765386,3771243,7536629,0.0
DAL227,5p,8,->G,3,0,3,3765342,3771242,7536584,3.980583245672045e-07
DAL227,5p,9,->G,1,0,1,3765324,3771243,7536567,1.326864074849995e-07
DAL227,5p,10,->G,2,1,3,3765318,3771238,7536556,3.980598034433765e-07
DAL227,5p,11,->G,1,1,2,3765365,3771237,7536602,2.65371582577931e-07
DAL227,5p,12,->G,2,1,3,3765326,3771232,7536558,3.980596978089998e-07
DAL227,5p,13,->G,7,2,9,3765325,3771231,7536556,1.1941794103301296e-06
DAL227,5p,14,->G,3,0,3,3765297,3771226,7536523,3.980615464186867e-07
DAL227,5p,15,->G,11,2,13,3765318,3771201,7536519,1.724934283320987e-06
DAL227,5p,16,->G,7,10,17,3765316,3771188,7536504,2.2556877830888166e-06
DAL227,5p,17,->G,22,6,28,3765326,3771175,7536501,3.715251945166597e-06
DAL227,5p,18,->G,15,16,31,3765280,3771169,7536449,4.113343034630766e-06
DAL227,5p,19,->G,10,8,18,3765279,3771164,7536443,2.388394631260397e-06
DAL227,5p,20,->G,20,14,34,3765254,3771167,7536421,4.51142525079212e-06
DAL227,5p,21,->G,24,4,28,3765270,3771169,7536439,3.715282509418573e-06
DAL227,5p,22,->G,17,14,31,3765253,3771158,7536411,4.11336377487905e-06
DAL227,5p,23,->G,16,12,28,3765254,3771157,7536411,3.715296312793981e-06
DAL227,5p,24,->G,12,11,23,3765270,3771180,7536450,3.0518347497827227e-06
DAL227,5p,25,->G,21,16,37,3765247,3771148,7536395,4.909509122066983e-06
WA02,3p,1,->G,0,0,0,6552698,6754258,13306956,0.0
WA02,3p,2,->G,0,0,0,6552698,6754258,13306956,0.0
WA02,3p,3,->G,0,0,0,6552698,6754258,13306956,0.0
WA02,3p,4,->G,0,0,0,6552698,6754256,13306954,0.0
WA02,3p,5,->G,0,0,0,6552698,6754256,13306954,0.0
WA02,3p,6,->G,0,0,0,6552698,6754257,13306955,0.0
WA02,3p,7,->G,0,0,0,6552698,6754257,13306955,0.0
WA02,3p,8,->G,3,4,7,6552692,6754207,13306899,5.260429195412094e-07
WA02,3p,9,->G,2,18,20,6552688,6754191,13306879,1.5029820290693258e-06
WA02,3p,10,->G,6,14,20,6552680,6754207,13306887,1.502981125487877e-06
WA02,3p,11,->G,4,20,24,6552667,6754202,13306869,1.8035797902571973e-06
WA02,3p,12,->G,10,9,19,6552670,6754189,13306859,1.4278350736263156e-06
WA02,3p,13,->G,4,17,21,6552675,6754177,13306852,1.5781343325979729e-06
WA02,3p,14,->G,8,25,33,6552653,6754155,13306808,2.479933579863781e-06
WA02,3p,15,->G,7,38,45,6552632,6754146,13306778,3.3817352329767582e-06
WA02,3p,16,->G,21,24,45,6552629,6754119,13306748,3.381742857082737e-06
WA02,3p,17,->G,16,21,37,6552608,6754116,13306724,2.7805491419225347e-06
WA02,3p,18,->G,21,51,72,6552611,6754085,13306696,5.4108097156499255e-06
WA02,3p,19,->G,14,14,28,6552605,6754056,13306661,2.1042093129147875e-06
WA02,3p,20,->G,14,44,58,6552618,6754033,13306651,4.358722566632281e-06
WA02,3p,21,->G,17,39,56,6552597,6754089,13306686,4.208410719242943e-06
WA02,3p,22,->G,23,15,38,6552593,6754062,13306655,2.855713926602892e-06
WA02,3p,23,->G,25,45,70,6552585,6754052,13306637,5.2605327702258655e-06
WA02,3p,24,->G,27,34,61,6552556,6754026,13306582,4.584197504663481e-06
WA02,3p,25,->G,36,35,71,6552517,6754038,13306555,5.335716118860216e-06
WA02,5p,1,->G,0,0,0,6552698,6754258,13306956,0.0
WA02,5p,2,->G,0,0,0,6552562,6754179,13306741,0.0
WA02,5p,3,->G,0,0,0,6552698,6754258,13306956,0.0
WA02,5p,4,->G,0,0,0,6552698,6754258,13306956,0.0
WA02,5p,5,->G,0,0,0,6552698,6754258,13306956,0.0
WA02,5p,6,->G,0,0,0,6552697,6754258,13306955,0.0
WA02,5p,7,->G,1,0,1,6552685,6754258,13306943,7.514874002240786e-08
WA02,5p,8,->G,3,1,4,6552655,6754257,13306912,3.005956603605705e-07
WA02,5p,9,->G,1,1,2,6552662,6754226,13306888,1.5029810125402725e-07
WA02,5p,10,->G,6,4,10,6552618,6754222,13306840,7.514932170222232e-07
WA02,5p,11,->G,15,6,21,6552625,6754225,13306850,1.5781345697892438e-06
WA02,5p,12,->G,12,7,19,6552628,6754236,13306864,1.427834537123097e-06
WA02,5p,13,->G,21,23,44,6552614,6754205,13306819,3.3065753731226078e-06
WA02,5p,14,->G,17,12,29,6552607,6754183,13306790,2.179338518155017e-06
WA02,5p,15,->G,18,22,40,6552586,6754168,13306754,3.005992295341148e-06
WA02,5p,16,->G,19,14,33,6552525,6754178,13306703,2.47995314842452e-06
WA02,5p,17,->G,34,31,65,6552567,6754148,13306715,4.884751796367473e-06
WA02,5p,18,->G,23,46,69,6552548,6754087,13306635,5.185383081447714e-06
WA02,5p,19,->G,29,21,50,6552516,6754124,13306640,3.757522560165451e-06
WA02,5p,20,->G,29,19,48,6552507,6754132,13306639,3.607221928843189e-06
WA02,5p,21,->G,26,19,45,6552521,6754152,13306673,3.381761917498085e-06
WA02,5p,22,->G,45,45,90,6552516,6754117,13306633,6.763544166281584e-06
WA02,5p,23,->G,46,45,91,6552465,6754131,13306596,6.838713672527519e-06
WA02,5p,24,->G,55,42,97,6552457,6754135,13306592,7.28962006199634e-06
WA02,5p,25,->G,59,47,106,6552470,6754083,13306553,7.965999909969171e-06
WA03,3p,1,->G,0,0,0,5399458,5543742,10943200,0.0
WA03,3p,2,->G,0,0,0,5399458,5543742,10943200,0.0
WA03,3p,3,->G,0,0,0,5399458,5543742,10943200,0.0
WA03,3p,4,->G,0,2,2,5399458,5543736,10943194,1.8276199800533562e-07
WA03,3p,5,->G,0,0,0,5399458,5543740,10943198,0.0
WA03,3p,6,->G,0,1,1,5399458,5543741,10943199,9.138095725025197e-08
WA03,3p,7,->G,0,2,2,5399458,5543739,10943197,1.8276194790242744e-07
WA03,3p,8,->G,0,11,11,5399449,5543673,10943122,1.0051976026585466e-06
WA03,3p,9,->G,7,11,18,5399436,5543670,10943106,1.644871209325762e-06
WA03,3p,10,->G,4,21,25,5399438,5543654,10943092,2.284546269006968e-06
WA03,3p,11,->G,6,11,17,5399404,5543644,10943048,1.5534977092305544e-06
WA03,3p,12,->G,3,33,36,5399397,5543595,10942992,3.289776689958285e-06
WA03,3p,13,->G,9,40,49,5399378,5543551,10942929,4.477777384829967e-06
WA03,3p,14,->G,14,61,75,5399356,5543493,10942849,6.853791000862756e-06
WA03,3p,15,->G,11,55,66,5399349,5543505,10942854,6.03133332492602e-06
WA03,3p,16,->G,16,65,81,5399342,5543495,10942837,7.402102398125824e-06
WA03,3p,17,->G,24,59,83,5399346,5543438,10942784,7.584907094940373e-06
WA03,3p,18,->G,32,54,86,5399325,5543443,10942768,7.85907185458012e-06
WA03,3p,19,->G,46,64,110,5399297,5543425,10942722,1.0052343466278317e-05
WA03,3p,20,->G,53,96,149,5399252,5543409,10942661,1.36164320543239e-05
WA03,3p,21,->G,37,97,134,5399248,5543303,10942551,1.2245773403295082e-05
WA03,3p,22,->G,44,101,145,5399256,5543263,10942519,1.3251062209716064e-05
WA03,3p,23,->G,43,115,158,5399255,5543267,10942522,1.4439084518175977e-05
WA03,3p,24,->G,41,131,172,5399198,5543130,10942328,1.571877574863411e-05
WA03,3p,25,->G,75,119,194,5399050,5543142,10942192,1.772953718962343e-05
WA03,5p,1,->G,0,0,0,5399457,5543742,10943199,0.0
WA03,5p,2,->G,1,0,1,5399258,5543638,10942896,9.138348751555348e-08
WA03,5p,3,->G,0,0,0,5399457,5543742,10943199,0.0
WA03,5p,4,->G,0,0,0,5399458,5543742,10943200,0.0
WA03,5p,5,->G,0,0,0,5399456,5543740,10943196,0.0
WA03,5p,6,->G,0,0,0,5399452,5543742,10943194,0.0
WA03,5p,7,->G,0,0,0,5399453,5543742,10943195,0.0
WA03,5p,8,->G,11,3,14,5399403,5543732,10943135,1.279340883576781e-06
WA03,5p,9,->G,55,1,56,5399319,5543732,10943051,5.117402815722964e-06
WA03,5p,10,->G,18,3,21,5399344,5543717,10943061,1.9190243022496173e-06
WA03,5p,11,->G,29,8,37,5399321,5543705,10943026,3.381148870522651e-06
WA03,5p,12,->G,36,9,45,5399213,5543665,10942878,4.112263702473883e-06
WA03,5p,13,->G,59,24,83,5399156,5543662,10942818,7.584883528173456e-06
WA03,5p,14,->G,53,37,90,5399124,5543629,10942753,8.224621354425162e-06
WA03,5p,15,->G,52,29,81,5399092,5543505,10942597,7.402264745745457e-06
WA03,5p,16,->G,55,114,169,5399083,5543501,10942584,1.5444249731142114e-05
WA03,5p,17,->G,50,45,95,5399113,5543491,10942604,8.681662975284494e-06
WA03,5p,18,->G,54,28,82,5399074,5543600,10942674,7.493597999903863e-06
WA03,5p,19,->G,73,59,132,5399071,5543546,10942617,1.2062927908378771e-05
WA03,5p,20,->G,59,44,103,5399050,5543533,10942583,9.412768447815292e-06
WA03,5p,21,->G,74,50,124,5399034,5543509,10942543,1.1331918001144706e-05
WA03,5p,22,->G,93,109,202,5398989,5543454,10942443,1.8460228671056363e-05
WA03,5p,23,->G,95,65,160,5398935,5543457,10942392,1.462203145345186e-05
WA03,5p,24,->G,96,51,147,5398952,5543428,10942380,1.343400613029341e-05
WA03,5p,25,->G,72,100,172,5398991,5543444,10942435,1.5718622043448283e-05
WA07,3p,1,->G,0,0,0,5691729,6013979,11705708,0.0
WA07,3p,2,->G,0,0,0,5691729,6013979,11705708,0.0
WA07,3p,3,->G,0,0,0,5691729,6013979,11705708,0.0
WA07,3p,4,->G,0,0,0,5691729,6013979,11705708,0.0
WA07,3p,5,->G,0,0,0,5691729,6013979,11705708,0.0
WA07,3p,6,->G,0,0,0,5691729,6013979,11705708,0.0
WA07,3p,7,->G,0,0,0,5691729,6013979,11705708,0.0
WA07,3p,8,->G,6,5,11,5691713,6013800,11705513,9.397281434824772e-07
WA07,3p,9,->G,4,2,6,5691720,6013901,11705621,5.125742581277833e-07
WA07,3p,10,->G,0,9,9,5691718,6013892,11705610,7.688621097063715e-07
WA07,3p,11,->G,3,7,10,5691711,6013883,11705594,8.542924007102929e-07
WA07,3p,12,->G,2,10,12,5691705,6013884,11705589,1.025151318741842e-06
WA07,3p,13,->G,4,12,16,5691711,6013848,11705559,1.366871928115522e-06
WA07,3p,14,->G,3,39,42,5691695,6013877,11705572,3.588034826491179e-06
WA07,3p,15,->G,7,18,25,5691211,6013856,11705067,2.135827159297764e-06
WA07,3p,16,->G,13,33,46,5691636,6013850,11705486,3.929781300836207e-06
WA07,3p,17,->G,17,49,66,5691662,6013813,11705475,5.63838716498049e-06
WA07,3p,18,->G,15,36,51,5691639,6013769,11705408,4.35696047502146e-06
WA07,3p,19,->G,18,55,73,5691628,6013742,11705370,6.236453866900406e-06
WA07,3p,20,->G,20,48,68,5691604,6013772,11705376,5.80929651469547e-06
WA07,3p,21,->G,30,35,65,5691611,6013735,11705346,5.553018253369016e-06
WA07,3p,22,->G,41,42,83,5691577,6013736,11705313,7.090797144852085e-06
WA07,3p,23,->G,34,87,121,5691568,6013670,11705238,1.0337252433483196e-05
WA07,3p,24,->G,41,60,101,5691554,6013661,11705215,8.628632622296985e-06
WA07,3p,25,->G,36,61,97,5691455,6013662,11705117,8.286973978987138e-06
WA07,5p,1,->G,0,0,0,5691729,6013979,11705708,0.0
WA07,5p,2,->G,0,0,0,5691636,6013923,11705559,0.0
WA07,5p,3,->G,0,0,0,5691729,6013979,11705708,0.0
WA07,5p,4,->G,0,0,0,5691728,6013979,11705707,0.0
WA07,5p,5,->G,0,0,0,5691729,6013978,11705707,0.0
WA07,5p,6,->G,0,0,0,5691728,6013979,11705707,0.0
WA07,5p,7,->G,0,0,0,5691728,6013979,11705707,0.0
WA07,5p,8,->G,1,1,2,5691579,6013975,11705554,1.7085906399645842e-07
WA07,5p,9,->G,5,0,5,5691672,6013971,11705643,4.2714441231464173e-07
WA07,5p,10,->G,4,1,5,5691582,6013961,11705543,4.271480613927949e-07
WA07,5p,11,->G,10,9,19,5691326,6013942,11705268,1.6232007673809775e-06
WA07,5p,12,->G,9,12,21,5691520,6013938,11705458,1.7940348852646346e-06
WA07,5p,13,->G,20,4,24,5691511,6013949,11705460,2.0503252328400595e-06
WA07,5p,14,->G,15,7,22,5691556,6013950,11705506,1.87945741089706e-06
WA07,5p,15,->G,15,3,18,5691563,6013633,11705196,1.5377786070391303e-06
WA07,5p,16,->G,25,4,29,5691534,6013925,11705459,2.477476534666432e-06
WA07,5p,17,->G,34,5,39,5691561,6013916,11705477,3.331773664584536e-06
WA07,5p,18,->G,39,22,61,5691474,6013905,11705379,5.211279361394449e-06
WA07,5p,19,->G,25,14,39,5691482,6013884,11705366,3.3318052592289726e-06
WA07,5p,20,->G,54,12,66,5691421,6013876,11705297,5.638472906753242e-06
WA07,5p,21,->G,48,21,69,5691379,6013853,11705232,5.894799863855753e-06
WA07,5p,22,->G,73,19,92,5691396,6013861,11705257,7.859716365048628e-06
WA07,5p,23,->G,56,61,117,5691314,6013795,11705109,9.995635239278848e-06
WA07,5p,24,->G,36,61,97,5691332,6013785,11705117,8.286973978987138e-06
WA07,5p,25,->G,52,82,134,5691334,6013719,11705053,1.1448047266424167e-05
WA08,3p,1,->G,0,0,0,6798117,7189085,13987202,0.0
WA08,3p,2,->G,0,0,0,6798117,7189085,13987202,0.0
WA08,3p,3,->G,0,0,0,6798117,7189085,13987202,0.0
WA08,3p,4,->G,0,1,1,6798117,7189081,13987198,7.149394753688337e-08
WA08,3p,5,->G,0,0,0,6798117,7189085,13987202,0.0
WA08,3p,6,->G,0,0,0,6798117,7189085,13987202,0.0
WA08,3p,7,->G,0,0,0,6798117,7189084,13987201,0.0
WA08,3p,8,->G,3,2,5,6798110,7189053,13987163,3.574706321789487e-07
WA08,3p,9,->G,2,2,4,6798103,7189051,13987154,2.859766897540415e-07
WA08,3p,10,->G,3,7,10,6798074,7189042,13987116,7.149436667287238e-07
WA08,3p,11,->G,0,4,4,6798109,7189046,13987155,2.8597666930837617e-07
WA08,3p,12,->G,0,12,12,6798091,7189018,13987109,8.579328294360185e-07
WA08,3p,13,->G,2,14,16,6798090,7189013,13987103,1.143910929947395e-06
WA08,3p,14,->G,12,15,27,6798067,7188981,13987048,1.9303572848252183e-06
WA08,3p,15,->G,11,35,46,6798069,7188978,13987047,3.2887570907568982e-06
WA08,3p,16,->G,15,26,41,6798049,7188961,13987010,2.931291248093767e-06
WA08,3p,17,->G,23,23,46,6798000,7188943,13986943,3.2887815443303087e-06
WA08,3p,18,->G,29,15,44,6798023,7188956,13986979,3.1457829456954216e-06
WA08,3p,19,->G,13,33,46,6798028,7188946,13986974,3.2887742552463456e-06
WA08,3p,20,->G,24,34,58,6798009,7188917,13986926,4.146729595909781e-06
WA08,3p,21,->G,21,54,75,6798010,7188926,13986936,5.362146505853748e-06
WA08,3p,22,->G,32,39,71,6798012,7188920,13986932,5.076166810562888e-06
WA08,3p,23,->G,21,52,73,6798009,7188864,13986873,5.2191794406083474e-06
WA08,3p,24,->G,15,51,66,6798015,7188867,13986882,4.718707142878592e-06
WA08,3p,25,->G,32,26,58,6797966,7188892,13986858,4.146749756092469e-06
WA08,5p,1,->G,0,0,0,6798116,7189085,13987201,0.0
WA08,5p,2,->G,0,0,0,6797941,7188997,13986938,0.0
WA08,5p,3,->G,0,0,0,6798117,7189084,13987201,0.0
WA08,5p,4,->G,0,0,0,6798115,7189085,13987200,0.0
WA08,5p,5,->G,0,0,0,6798116,7189084,13987200,0.0
WA08,5p,6,->G,0,0,0,6798112,7189085,13987197,0.0
WA08,5p,7,->G,0,0,0,6798110,7189085,13987195,0.0
WA08,5p,8,->G,0,1,1,6798069,7189064,13987133,7.149427977842207e-08
WA08,5p,9,->G,14,1,15,6798054,7189067,13987121,1.0724151167348878e-06
WA08,5p,10,->G,15,4,19,6798015,7189037,13987052,1.3583991823294858e-06
WA08,5p,11,->G,12,6,18,6797997,7189047,13987044,1.2869052245778306e-06
WA08,5p,12,->G,7,7,14,6798016,7189056,13987072,1.000924282079909e-06
WA08,5p,13,->G,11,9,20,6797995,7189043,13987038,1.4298953073552813e-06
WA08,5p,14,->G,22,13,35,6797984,7189041,13987025,2.5023191136070752e-06
WA08,5p,15,->G,20,19,39,6797997,7189013,13987010,2.788301431113583e-06
WA08,5p,16,->G,27,18,45,6797921,7188997,13986918,3.2172920438941586e-06
WA08,5p,17,->G,25,107,132,6797959,7188875,13986834,9.437446673064113e-06
WA08,5p,18,->G,24,20,44,6797991,7188972,13986963,3.145786544226935e-06
WA08,5p,19,->G,26,24,50,6797966,7188988,13986954,3.5747597368233284e-06
WA08,5p,20,->G,29,26,55,6797883,7188971,13986854,3.932263824302449e-06
WA08,5p,21,->G,43,13,56,6797885,7188979,13986864,4.0037566676847644e-06
WA08,5p,22,->G,65,66,131,6797887,7188939,13986826,9.36595622194771e-06
WA08,5p,23,->G,47,47,94,6797851,7188919,13986770,6.720636715982318e-06
WA08,5p,24,->G,47,61,108,6797841,7188876,13986717,7.721611869318583e-06
WA08,5p,25,->G,71,68,139,6797835,7188817,13986652,9.938046646188094e-06
WA09,3p,1,->G,0,0,0,4741672,4881751,9623423,0.0
WA09,3p,2,->G,0,0,0,4741672,4881751,9623423,0.0
WA09,3p,3,->G,0,0,0,4741672,4881751,9623423,0.0
WA09,3p,4,->G,0,0,0,4741672,4881748,9623420,0.0
WA09,3p,5,->G,0,0,0,4741672,4881751,9623423,0.0
WA09,3p,6,->G,0,0,0,4741672,4881751,9623423,0.0
WA09,3p,7,->G,0,1,1,4741672,4881748,9623420,1.0391316184890613e-07
WA09,3p,8,->G,3,2,5,4741663,4881718,9623381,5.195679148523788e-07
WA09,3p,9,->G,1,0,1,4741664,4881723,9623387,1.039135181823198e-07
WA09,3p,10,->G,2,4,6,4741658,4881705,9623363,6.234826640125702e-07
WA09,3p,11,->G,14,0,14,4741648,4881712,9623360,1.4547933362152097e-06
WA09,3p,12,->G,5,8,13,4741642,4881680,9623322,1.3508848607580625e-06
WA09,3p,13,->G,6,13,19,4741628,4881645,9623273,1.9743802342508625e-06
WA09,3p,14,->G,7,21,28,4741616,4881571,9623187,2.9096389792695497e-06
WA09,3p,15,->G,13,41,54,4741598,4881557,9623155,5.611465262691913e-06
WA09,3p,16,->G,21,39,60,4741586,4881546,9623132,6.234976305011716e-06
WA09,3p,17,->G,12,35,47,4741582,4881528,9623110,4.88407593802835e-06
WA09,3p,18,->G,25,81,106,4741560,4881490,9623050,1.1015218667678129e-05
WA09,3p,19,->G,23,37,60,4741552,4881442,9622994,6.235065718631852e-06
WA09,3p,20,->G,28,47,75,4741534,4881501,9623035,7.793798941809938e-06
WA09,3p,21,->G,25,40,65,4741546,4881493,9623039,6.754622941879379e-06
WA09,3p,22,->G,31,53,84,4741524,4881498,9623022,8.729066607142745e-06
WA09,3p,23,->G,50,70,120,4741501,4881486,9622987,1.2470140508347356e-05
WA09,3p,24,->G,50,76,126,4741491,4881450,9622941,1.3093710124586651e-05
WA09,3p,25,->G,46,64,110,4741451,4881469,9622920,1.1431041721223913e-05
WA09,5p,1,->G,0,0,0,4741672,4881751,9623423,0.0
WA09,5p,2,->G,0,0,0,4741495,4881667,9623162,0.0
WA09,5p,3,->G,0,0,0,4741672,4881750,9623422,0.0
WA09,5p,4,->G,0,0,0,4741672,4881751,9623423,0.0
WA09,5p,5,->G,0,0,0,4741671,4881751,9623422,0.0
WA09,5p,6,->G,0,0,0,4741669,4881751,9623420,0.0
WA09,5p,7,->G,0,0,0,4741667,4881751,9623418,0.0
WA09,5p,8,->G,1,4,5,4741639,4881744,9623383,5.19567806872074e-07
WA09,5p,9,->G,7,1,8,4741618,4881747,9623365,8.31310045914293e-07
WA09,5p,10,->G,5,4,9,4741622,4881737,9623359,9.352243847496493e-07
WA09,5p,11,->G,4,4,8,4741614,4881733,9623347,8.313116008390843e-07
WA09,5p,12,->G,11,6,17,4741580,4881734,9623314,1.7665432095429912e-06
WA09,5p,13,->G,24,9,33,4741530,4881708,9623238,3.429199194699331e-06
WA09,5p,14,->G,40,15,55,4741498,4881705,9623203,5.7153527780719164e-06
WA09,5p,15,->G,31,19,50,4741496,4881672,9623168,5.195794150117716e-06
WA09,5p,16,->G,36,25,61,4741451,4881636,9623087,6.338922219034287e-06
WA09,5p,17,->G,39,41,80,4741476,4881638,9623114,8.313317290016516e-06
WA09,5p,18,->G,45,49,94,4741455,4881610,9623065,9.76819755452135e-06
WA09,5p,19,->G,45,45,90,4741379,4881580,9622959,9.352632594610453e-06
WA09,5p,20,->G,52,47,99,4741390,4881557,9622947,1.0287908683275507e-05
WA09,5p,21,->G,58,34,92,4741379,4881587,9622966,9.560461919952746e-06
WA09,5p,22,->G,76,21,97,4741354,4881580,9622934,1.0080085761785337e-05
WA09,5p,23,->G,76,29,105,4741312,4881565,9622877,1.0911497673720656e-05
WA09,5p,24,->G,39,46,85,4741363,4881548,9622911,8.833085954967265e-06
WA09,5p,25,->G,92,55,147,4741301,4881503,9622804,1.5276212629915354e-05
WA11,3p,1,->G,0,0,0,9756642,10108269,19864911,0.0
WA11,3p,2,->G,0,0,0,9756642,10108269,19864911,0.0
WA11,3p,3,->G,0,0,0,9756642,10108269,19864911,0.0
WA11,3p,4,->G,0,0,0,9756642,10108267,19864909,0.0
WA11,3p,5,->G,0,0,0,9756642,10108269,19864911,0.0
WA11,3p,6,->G,0,0,0,9756642,10108269,19864911,0.0
WA11,3p,7,->G,0,0,0,9756642,10108265,19864907,0.0
WA11,3p,8,->G,2,31,33,9756629,10108160,19864789,1.66123083411558e-06
WA11,3p,9,->G,5,112,117,9756610,10108092,19864702,5.889844207076451e-06
WA11,3p,10,->G,2,14,16,9756615,10107969,19864584,8.054535649978877e-07
WA11,3p,11,->G,10,57,67,9756587,10107918,19864505,3.372850217007673e-06
WA11,3p,12,->G,10,50,60,9756581,10108019,19864600,3.020448435911118e-06
WA11,3p,13,->G,20,60,80,9756565,10107963,19864528,4.027279178241738e-06
WA11,3p,14,->G,26,40,66,9756515,10107914,19864429,3.322521880694381e-06
WA11,3p,15,->G,39,32,71,9756471,10107972,19864443,3.5742255647440003e-06
WA11,3p,16,->G,33,62,95,9756477,10108011,19864488,4.782403654199393e-06
WA11,3p,17,->G,50,50,100,9756469,10108044,19864513,5.034102774127914e-06
WA11,3p,18,->G,52,62,114,9756421,10108016,19864437,5.7388991190638825e-06
WA11,3p,19,->G,67,48,115,9756438,10108000,19864438,5.78924004796914e-06
WA11,3p,20,->G,36,64,100,9756433,10107963,19864396,5.0341324246657184e-06
WA11,3p,21,->G,46,100,146,9756421,10107904,19864325,7.349859610130221e-06
WA11,3p,22,->G,46,132,178,9756405,10107842,19864247,8.96082292975918e-06
WA11,3p,23,->G,66,116,182,9756375,10107816,19864191,9.162215566694864e-06
WA11,3p,24,->G,71,189,260,9756358,10107704,19864062,1.308896438200807e-05
WA11,3p,25,->G,69,199,268,9756281,10107693,19863974,1.3491761517609718e-05
WA11,5p,1,->G,0,0,0,9756641,10108269,19864910,0.0
WA11,5p,2,->G,0,0,0,9756471,10108196,19864667,0.0
WA11,5p,3,->G,0,0,0,9756642,10108269,19864911,0.0
WA11,5p,4,->G,0,0,0,9756638,10108269,19864907,0.0
WA11,5p,5,->G,1,0,1,9756638,10108267,19864905,5.034003434700544e-08
WA11,5p,6,->G,0,0,0,9756642,10108269,19864911,0.0
WA11,5p,7,->G,0,0,0,9756629,10108269,19864898,0.0
WA11,5p,8,->G,6,4,10,9756500,10108261,19864761,5.034039926279505e-07
WA11,5p,9,->G,8,11,19,9756493,10108240,19864733,9.564689341658908e-07
WA11,5p,10,->G,30,31,61,9756446,10108197,19864643,3.0707825959922864e-06
WA11,5p,11,->G,33,30,63,9756457,10108195,19864652,3.1714625556994403e-06
WA11,5p,12,->G,47,13,60,9756411,10108221,19864632,3.020443570260954e-06
WA11,5p,13,->G,56,31,87,9756334,10108178,19864512,4.379669633968355e-06
WA11,5p,14,->G,138,22,160,9756261,10108167,19864428,8.054598904131545e-06
WA11,5p,15,->G,71,31,102,9756237,10108096,19864333,5.1348313582942855e-06
WA11,5p,16,->G,61,53,114,9756275,10108079,19864354,5.738923098128436e-06
WA11,5p,17,->G,47,24,71,9756369,10108078,19864447,3.5742248450208555e-06
WA11,5p,18,->G,54,37,91,9756327,10108075,19864402,4.581059122746308e-06
WA11,5p,19,->G,60,38,98,9756284,10108088,19864372,4.933455736733081e-06
WA11,5p,20,->G,69,39,108,9756292,10108082,19864374,5.436869040021095e-06
WA11,5p,21,->G,71,56,127,9756251,10108036,19864287,6.393383261125859e-06
WA11,5p,22,->G,96,61,157,9756136,10108029,19864165,7.903679817399826e-06
WA11,5p,23,->G,122,53,175,9756095,10108016,19864111,8.809858140643697e-06
WA11,5p,24,->G,124,70,194,9756046,10108010,19864056,9.766384065771864e-06
WA11,5p,25,->G,111,60,171,9756056,10107943,19863999,8.608538492173706e-06
WA12,3p,1,->G,0,0,0,6632243,6940679,13572922,0.0
WA12,3p,2,->G,0,0,0,6632243,6940679,13572922,0.0
WA12,3p,3,->G,0,0,0,6632243,6940679,13572922,0.0
WA12,3p,4,->G,0,0,0,6632243,6940676,13572919,0.0
WA12,3p,5,->G,0,0,0,6632243,6940678,13572921,0.0
WA12,3p,6,->G,0,0,0,6632243,6940679,13572922,0.0
WA12,3p,7,->G,0,2,2,6632243,6940676,13572919,1.473522386746727e-07
WA12,3p,8,->G,0,6,6,6632240,6940664,13572904,4.420572045599085e-07
WA12,3p,9,->G,6,10,16,6632231,6940656,13572887,1.178820688627261e-06
WA12,3p,10,->G,1,4,5,6632228,6940644,13572872,3.683818723111807e-07
WA12,3p,11,->G,2,10,12,6632231,6940642,13572873,8.841164284083406e-07
WA12,3p,12,->G,8,12,20,6632223,6940615,13572838,1.4735311804355138e-06
WA12,3p,13,->G,9,37,46,6632204,6940591,13572795,3.389132452085219e-06
WA12,3p,14,->G,5,33,38,6632209,6940533,13572742,2.799729045170092e-06
WA12,3p,15,->G,14,44,58,6632188,6940474,13572662,4.27329583540797e-06
WA12,3p,16,->G,11,30,41,6632187,6940478,13572665,3.0207774228568966e-06
WA12,3p,17,->G,23,45,68,6632168,6940473,13572641,5.010078731176931e-06
WA12,3p,18,->G,24,48,72,6632160,6940482,13572642,5.304788853931312e-06
WA12,3p,19,->G,21,47,68,6632121,6940435,13572556,5.010110107484544e-06
WA12,3p,20,->G,27,68,95,6632105,6940432,13572537,6.999428330900848e-06
WA12,3p,21,->G,29,40,69,6632096,6940454,13572550,5.083790444684308e-06
WA12,3p,22,->G,30,60,90,6632039,6940438,13572477,6.6310666800172144e-06
WA12,3p,23,->G,123,50,173,6631950,6940459,13572409,1.2746447590844042e-05
WA12,3p,24,->G,102,72,174,6631933,6940411,13572344,1.2820187876169364e-05
WA12,3p,25,->G,39,58,97,6631986,6940428,13572414,7.146849484550058e-06
WA12,5p,1,->G,0,0,0,6632243,6940679,13572922,0.0
WA12,5p,2,->G,0,0,0,6631949,6940524,13572473,0.0
WA12,5p,3,->G,0,0,0,6632242,6940678,13572920,0.0
WA12,5p,4,->G,0,0,0,6632242,6940679,13572921,0.0
WA12,5p,5,->G,0,0,0,6632242,6940677,13572919,0.0
WA12,5p,6,->G,0,0,0,6632242,6940679,13572921,0.0
WA12,5p,7,->G,0,0,0,6632238,6940679,13572917,0.0
WA12,5p,8,->G,2,1,3,6632204,6940670,13572874,2.210290908174643e-07
WA12,5p,9,->G,4,0,4,6632209,6940675,13572884,2.947052372951835e-07
WA12,5p,10,->G,3,5,8,6632199,6940665,13572864,5.894113431034157e-07
WA12,5p,11,->G,10,3,13,6632166,6940667,13572833,9.577956201185115e-07
WA12,5p,12,->G,24,5,29,6632126,6940660,13572786,2.1366283974417637e-06
WA12,5p,13,->G,43,4,47,6632065,6940658,13572723,3.462827613884112e-06
WA12,5p,14,->G,41,13,54,6632026,6940638,13572664,3.978585191529091e-06
WA12,5p,15,->G,67,11,78,6631987,6940631,13572618,5.746864753726952e-06
WA12,5p,16,->G,60,18,78,6631930,6940590,13572520,5.746906248802728e-06
WA12,5p,17,->G,66,15,81,6631958,6940621,13572579,5.96791516188633e-06
WA12,5p,18,->G,72,25,97,6632019,6940577,13572596,7.146753649780779e-06
WA12,5p,19,->G,69,25,94,6631996,6940532,13572528,6.925754730437837e-06
WA12,5p,20,->G,58,24,82,6631973,6940532,13572505,6.0416260668167e-06
WA12,5p,21,->G,56,43,99,6631936,6940534,13572470,7.294177109988086e-06
WA12,5p,22,->G,81,40,121,6631921,6940529,13572450,8.915118493713368e-06
WA12,5p,23,->G,92,18,110,6631926,6940534,13572460,8.10464720470718e-06
WA12,5p,24,->G,95,28,123,6631934,6940518,13572452,9.06247448876592e-06
WA12,5p,25,->G,106,45,151,6631933,6940515,13572448,1.1125480090253431e-05
WA13,3p,1,->G,0,0,0,5896847,6081528,11978375,0.0
WA13,3p,2,->G,0,0,0,5896847,6081528,11978375,0.0
WA13,3p,3,->G,0,0,0,5896847,6081528,11978375,0.0
WA13,3p,4,->G,0,0,0,5896847,6081522,11978369,0.0
WA13,3p,5,->G,0,0,0,5896847,6081527,11978374,0.0
WA13,3p,6,->G,0,0,0,5896847,6081528,11978375,0.0
WA13,3p,7,->G,0,0,0,5896847,6081528,11978375,0.0
WA13,3p,8,->G,2,4,6,5896845,6081521,11978366,5.009030447057637e-07
WA13,3p,9,->G,1,4,5,5896842,6081517,11978359,4.174194478559209e-07
WA13,3p,10,->G,1,2,3,5896843,6081517,11978360,2.504516478048748e-07
WA13,3p,11,->G,0,23,23,5896841,6081492,11978333,1.9201336279430536e-06
WA13,3p,12,->G,5,13,18,5896836,6081505,11978341,1.5027122704220893e-06
WA13,3p,13,->G,0,11,11,5896834,6081495,11978329,9.18325085243526e-07
WA13,3p,14,->G,0,2,2,5896832,6081501,11978333,1.6696814156026552e-07
WA13,3p,15,->G,6,2,8,5896825,6081505,11978330,6.678727335112658e-07
WA13,3p,16,->G,4,2,6,5896830,6081509,11978339,5.009041737756796e-07
WA13,3p,17,->G,8,4,12,5896823,6081499,11978322,1.0018097693483275e-06
WA13,3p,18,->G,4,7,11,5896827,6081499,11978326,9.183253152402096e-07
WA13,3p,19,->G,3,5,8,5896822,6081480,11978302,6.678742947038737e-07
WA13,3p,20,->G,9,8,17,5896818,6081448,11978266,1.4192371416697543e-06
WA13,3p,21,->G,2,9,11,5896824,6081466,11978290,9.183280752093996e-07
WA13,3p,22,->G,6,15,21,5896824,6081460,11978284,1.7531726581203116e-06
WA13,3p,23,->G,5,19,24,5896819,6081454,11978273,2.003627734983165e-06
WA13,3p,24,->G,14,16,30,5896803,6081440,11978243,2.504540941438573e-06
WA13,3p,25,->G,7,18,25,5896783,6081437,11978220,2.0871214587810207e-06
WA13,5p,1,->G,0,0,0,5896847,6081528,11978375,0.0
WA13,5p,2,->G,0,0,0,5896725,6081443,11978168,0.0
WA13,5p,3,->G,0,0,0,5896847,6081528,11978375,0.0
WA13,5p,4,->G,6,0,6,5896841,6081528,11978369,5.00902919253865e-07
WA13,5p,5,->G,0,0,0,5896841,6081528,11978369,0.0
WA13,5p,6,->G,0,0,0,5896841,6081528,11978369,0.0
WA13,5p,7,->G,0,0,0,5896845,6081528,11978373,0.0
WA13,5p,8,->G,0,0,0,5896843,6081526,11978369,0.0
WA13,5p,9,->G,4,0,4,5896837,6081518,11978355,3.3393566979773097e-07
WA13,5p,10,->G,0,2,2,5896833,6081518,11978351,1.6696789065539988e-07
WA13,5p,11,->G,0,0,0,5896827,6081513,11978340,0.0
WA13,5p,12,->G,4,0,4,5896822,6081502,11978324,3.339365340259622e-07
WA13,5p,13,->G,6,14,20,5896809,6081508,11978317,1.669683645874458e-06
WA13,5p,14,->G,7,0,7,5896802,6081520,11978322,5.843890321198579e-07
WA13,5p,15,->G,15,4,19,5896798,6081508,11978306,1.5862009202302895e-06
WA13,5p,16,->G,17,6,23,5896754,6081491,11978245,1.9201477344969985e-06
WA13,5p,17,->G,14,1,15,5896805,6081514,11978319,1.2522625253176176e-06
WA13,5p,18,->G,15,8,23,5896796,6081504,11978300,1.9201389178764933e-06
WA13,5p,19,->G,11,8,19,5896797,6081472,11978269,1.5862058198893346e-06
WA13,5p,20,->G,14,2,16,5896788,6081482,11978270,1.3357521578658688e-06
WA13,5p,21,->G,11,6,17,5896782,6081484,11978266,1.4192371416697543e-06
WA13,5p,22,->G,17,10,27,5896771,6081483,11978254,2.254084777297259e-06
WA13,5p,23,->G,28,4,32,5896768,6081501,11978269,2.6715045387609845e-06
WA13,5p,24,->G,23,10,33,5896781,6081498,11978279,2.7549867556098834e-06
WA13,5p,25,->G,16,9,25,5896769,6081462,11978231,2.0871195421093484e-06
WA14,3p,1,->G,0,0,0,6684341,7140972,13825313,0.0
WA14,3p,2,->G,0,0,0,6684341,7140972,13825313,0.0
WA14,3p,3,->G,0,0,0,6684341,7140972,13825313,0.0
WA14,3p,4,->G,0,0,0,6684341,7140971,13825312,0.0
WA14,3p,5,->G,0,0,0,6684341,7140970,13825311,0.0
WA14,3p,6,->G,0,0,0,6684341,7140971,13825312,0.0
WA14,3p,7,->G,0,0,0,6684341,7140969,13825310,0.0
WA14,3p,8,->G,3,2,5,6684326,7140932,13825258,3.616569036180012e-07
WA14,3p,9,->G,2,6,8,6684323,7140920,13825243,5.786516736089196e-07
WA14,3p,10,->G,4,12,16,6684256,7140912,13825168,1.157309625459886e-06
WA14,3p,11,->G,1,9,10,6684256,7140894,13825150,7.233194576550707e-07
WA14,3p,12,->G,9,42,51,6684291,7140849,13825140,3.6889319023170832e-06
WA14,3p,13,->G,11,63,74,6684289,7140794,13825083,5.352589926584889e-06
WA14,3p,14,->G,3,80,83,6684291,7140742,13825033,6.003602306048745e-06
WA14,3p,15,->G,21,52,73,6684271,7140702,13824973,5.280299643261509e-06
WA14,3p,16,->G,24,93,117,6684263,7140648,13824911,8.462983957003413e-06
WA14,3p,17,->G,26,87,113,6684212,7140653,13824865,8.17367836864953e-06
WA14,3p,18,->G,58,111,169,6684177,7140647,13824824,1.2224387088038155e-05
WA14,3p,19,->G,62,121,183,6684172,7140542,13824714,1.3237163531918273e-05
WA14,3p,20,->G,39,52,91,6684176,7140544,13824720,6.582411795681938e-06
WA14,3p,21,->G,38,80,118,6684132,7140443,13824575,8.53552460021375e-06
WA14,3p,22,->G,52,115,167,6684105,7140560,13824665,1.2079858716287158e-05
WA14,3p,23,->G,47,124,171,6683638,7140562,13824200,1.2369612708149477e-05
WA14,3p,24,->G,58,109,167,6683623,7140532,13824155,1.2080304365800295e-05
WA14,3p,25,->G,79,153,232,6683613,7140513,13824126,1.6782254444150756e-05
WA14,5p,1,->G,0,0,0,6684341,7140972,13825313,0.0
WA14,5p,2,->G,0,0,0,6684184,7140911,13825095,0.0
WA14,5p,3,->G,0,0,0,6684338,7140972,13825310,0.0
WA14,5p,4,->G,0,0,0,6684341,7140972,13825313,0.0
WA14,5p,5,->G,0,0,0,6684341,7140972,13825313,0.0
WA14,5p,6,->G,0,0,0,6684340,7140972,13825312,0.0
WA14,5p,7,->G,0,0,0,6684336,7140972,13825308,0.0
WA14,5p,8,->G,6,0,6,6684277,7140970,13825247,4.339886296425662e-07
WA14,5p,9,->G,11,1,12,6684241,7140959,13825200,8.679802100512109e-07
WA14,5p,10,->G,10,7,17,6684210,7140628,13824838,1.2296708286925315e-06
WA14,5p,11,->G,8,3,11,6684218,7140646,13824864,7.956678633511331e-07
WA14,5p,12,->G,14,2,16,6684139,7140917,13825056,1.1573190010948238e-06
WA14,5p,13,->G,50,2,52,6684018,7140931,13824949,3.7613158645286873e-06
WA14,5p,14,->G,64,4,68,6683951,7140942,13824893,4.918663746619956e-06
WA14,5p,15,->G,42,16,58,6684030,7140908,13824938,4.19531718695592e-06
WA14,5p,16,->G,39,18,57,6683910,7140868,13824778,4.12303184904669e-06
WA14,5p,17,->G,49,19,68,6683904,7140873,13824777,4.9187050178096906e-06
WA14,5p,18,->G,57,26,83,6683891,7140646,13824537,6.003817704708664e-06
WA14,5p,19,->G,70,229,299,6683958,7140595,13824553,2.1628185735914933e-05
WA14,5p,20,->G,83,262,345,6683860,7140558,13824418,2.4955842625707643e-05
WA14,5p,21,->G,103,290,393,6683480,7140494,13823974,2.8428872913100096e-05
WA14,5p,22,->G,103,296,399,6683768,7140398,13824166,2.8862500638374855e-05
WA14,5p,23,->G,123,228,351,6683762,7140257,13824019,2.539059010263224e-05
WA14,5p,24,->G,89,294,383,6683714,7140421,13824135,2.770516925652129e-05
WA14,5p,25,->G,105,230,335,6683731,7140511,13824242,2.42327933784724e-05
WA18,3p,1,->G,0,0,0,14112928,14131239,28244167,0.0
WA18,3p,2,->G,0,0,0,14112928,14131239,28244167,0.0
WA18,3p,3,->G,0,0,0,14112928,14131239,28244167,0.0
WA18,3p,4,->G,0,0,0,14112928,14131238,28244166,0.0
WA18,3p,5,->G,0,0,0,14112928,14131239,28244167,0.0
WA18,3p,6,->G,0,0,0,14112928,14131239,28244167,0.0
WA18,3p,7,->G,0,2,2,14112928,14131237,28244165,7.081108611283075e-08
WA18,3p,8,->G,0,1,1,14112927,14131187,28244114,3.5405606987707246e-08
WA18,3p,9,->G,4,2,6,14112909,14131177,28244086,2.124338525240293e-07
WA18,3p,10,->G,4,4,8,14112909,14131197,28244106,2.832449361293291e-07
WA18,3p,11,->G,7,6,13,14112900,14131167,28244067,4.602736567647995e-07
WA18,3p,12,->G,5,27,32,14112895,14131136,28244031,1.1329827530638244e-06
WA18,3p,13,->G,3,27,30,14112898,14131061,28243959,1.0621740387032851e-06
WA18,3p,14,->G,8,35,43,14112830,14131006,28243836,1.5224560856393583e-06
WA18,3p,15,->G,26,51,77,14112809,14130957,28243766,2.726265328780872e-06
WA18,3p,16,->G,38,69,107,14112765,14130927,28243692,3.7884565516434607e-06
WA18,3p,17,->G,51,68,119,14112743,14130850,28243593,4.213344952251649e-06
WA18,3p,18,->G,54,78,132,14112708,14130769,28243477,4.673645528841934e-06
WA18,3p,19,->G,74,56,130,14112724,14130771,28243495,4.602829784345033e-06
WA18,3p,20,->G,73,89,162,14112697,14130797,28243494,5.735834242038184e-06
WA18,3p,21,->G,69,72,141,14112659,14130783,28243442,4.992309365126247e-06
WA18,3p,22,->G,71,87,158,14112575,14130715,28243290,5.594249111912954e-06
WA18,3p,23,->G,109,98,207,14112548,14130648,28243196,7.329198862621638e-06
WA18,3p,24,->G,78,91,169,14112551,14130690,28243241,5.983732532679235e-06
WA18,3p,25,->G,98,116,214,14112486,14130651,28243137,7.577061995627469e-06
WA18,5p,1,->G,0,0,0,14112926,14131239,28244165,0.0
WA18,5p,2,->G,0,0,0,14112820,14131183,28244003,0.0
WA18,5p,3,->G,0,0,0,14112928,14131239,28244167,0.0
WA18,5p,4,->G,0,0,0,14112928,14131239,28244167,0.0
WA18,5p,5,->G,0,0,0,14112925,14131239,28244164,0.0
WA18,5p,6,->G,0,0,0,14112927,14131239,28244166,0.0
WA18,5p,7,->G,0,0,0,14112921,14131239,28244160,0.0
WA18,5p,8,->G,13,1,14,14112828,14131230,28244058,4.956794806185428e-07
WA18,5p,9,->G,3,0,3,14112833,14131230,28244063,1.0621701275769e-07
WA18,5p,10,->G,4,2,6,14112791,14131213,28244004,2.1243446927708974e-07
WA18,5p,11,->G,10,0,10,14112776,14131211,28243987,3.5405766190162885e-07
WA18,5p,12,->G,40,1,41,14112682,14131223,28243905,1.4516406283054695e-06
WA18,5p,13,->G,81,10,91,14112608,14131206,28243814,3.221944458351128e-06
WA18,5p,14,->G,51,18,69,14112535,14131179,28243714,2.4430214808151648e-06
WA18,5p,15,->G,119,28,147,14112545,14131148,28243693,5.2047018072317954e-06
WA18,5p,16,->G,70,31,101,14112522,14131083,28243605,3.5760307510319594e-06
WA18,5p,17,->G,97,53,150,14112485,14130990,28243475,5.310961204313563e-06
WA18,5p,18,->G,119,69,188,14112481,14130987,28243468,6.656406359162409e-06
WA18,5p,19,->G,122,186,308,14112359,14130867,28243226,1.090526981584894e-05
WA18,5p,20,->G,91,76,167,14112397,14130866,28243263,5.9129145240760605e-06
WA18,5p,21,->G,122,286,408,14112347,14130679,28243026,1.444604413139017e-05
WA18,5p,22,->G,102,1222,1324,14112376,14129592,28241968,4.688058565890309e-05
WA18,5p,23,->G,127,386,513,14112288,14129275,28241563,1.816471701654756e-05
WA18,5p,24,->G,157,68,225,14112253,14129481,28241734,7.966932908581322e-06
WA18,5p,25,->G,165,69,234,14112273,14130551,28242824,8.28529045112486e-06
WA22,3p,1,->G,0,0,0,1513709,1653397,3167106,0.0
WA22,3p,2,->G,0,0,0,1513709,1653396,3167105,0.0
WA22,3p,3,->G,0,0,0,1513709,1653396,3167105,0.0
WA22,3p,4,->G,0,1,1,1513709,1653394,3167103,3.157459672135703e-07
WA22,3p,5,->G,0,0,0,1513709,1653397,3167106,0.0
WA22,3p,6,->G,0,0,0,1513709,1653397,3167106,0.0
WA22,3p,7,->G,0,0,0,1513709,1653397,3167106,0.0
WA22,3p,8,->G,0,1,1,1513709,1653395,3167104,3.15745867518086e-07
WA22,3p,9,->G,0,0,0,1513709,1653397,3167106,0.0
WA22,3p,10,->G,0,0,0,1513706,1653396,3167102,0.0
WA22,3p,11,->G,13,6,19,1513685,1653390,3167075,5.999226415541154e-06
WA22,3p,12,->G,9,7,16,1513662,1653379,3167041,5.052034375304898e-06
WA22,3p,13,->G,7,8,15,1513689,1653380,3167069,4.73624035346246e-06
WA22,3p,14,->G,8,27,35,1513686,1653352,3167038,1.1051335664428403e-05
WA22,3p,15,->G,4,42,46,1513677,1653343,3167020,1.4524695139279196e-05
WA22,3p,16,->G,16,21,37,1513637,1653341,3166978,1.168306189686193e-05
WA22,3p,17,->G,1,53,54,1513671,1653319,3166990,1.7050890593276265e-05
WA22,3p,18,->G,7,49,56,1513665,1653288,3166953,1.7682611645957486e-05
WA22,3p,19,->G,7,6,13,1513662,1653275,3166937,4.10491272797659e-06
WA22,3p,20,->G,2,11,13,1513684,1653304,3166988,4.104846623984682e-06
WA22,3p,21,->G,4,9,13,1513677,1653327,3167004,4.104825885916153e-06
WA22,3p,22,->G,9,24,33,1513684,1653356,3167040,1.0419824189148228e-05
WA22,3p,23,->G,0,32,32,1513676,1653329,3167005,1.0104183605646344e-05
WA22,3p,24,->G,0,52,52,1513672,1653285,3166957,1.6419547218355034e-05
WA22,3p,25,->G,8,26,34,1513669,1653296,3166965,1.073583067700464e-05
WA22,5p,1,->G,0,0,0,1513709,1653397,3167106,0.0
WA22,5p,2,->G,0,0,0,1513674,1653378,3167052,0.0
WA22,5p,3,->G,0,0,0,1513709,1653397,3167106,0.0
WA22,5p,4,->G,0,0,0,1513709,1653397,3167106,0.0
WA22,5p,5,->G,0,0,0,1513708,1653396,3167104,0.0
WA22,5p,6,->G,0,0,0,1513704,1653397,3167101,0.0
WA22,5p,7,->G,0,0,0,1513707,1653397,3167104,0.0
WA22,5p,8,->G,0,0,0,1513692,1653397,3167089,0.0
WA22,5p,9,->G,0,8,8,1513700,1653389,3167089,2.5259789036556914e-06
WA22,5p,10,->G,0,0,0,1513705,1653389,3167094,0.0
WA22,5p,11,->G,0,14,14,1513699,1653381,3167080,4.420475643179206e-06
WA22,5p,12,->G,0,14,14,1513692,1653345,3167037,4.420535661566316e-06
WA22,5p,13,->G,0,0,0,1513697,1653377,3167074,0.0
WA22,5p,14,->G,0,12,12,1513677,1653376,3167053,3.7890114248166986e-06
WA22,5p,15,->G,5,8,13,1513695,1653381,3167076,4.104732567200787e-06
WA22,5p,16,->G,21,1,22,1513668,1653368,3167036,6.946558232997667e-06
WA22,5p,17,->G,14,0,14,1513675,1653395,3167070,4.420489600798214e-06
WA22,5p,18,->G,11,5,16,1513651,1653392,3167043,5.052031184925497e-06
WA22,5p,19,->G,0,0,0,1513674,1653350,3167024,0.0
WA22,5p,20,->G,1,16,17,1513678,1653356,3167034,5.367798388018569e-06
WA22,5p,21,->G,6,8,14,1513690,1653371,3167061,4.420502162730683e-06
WA22,5p,22,->G,1,7,8,1513691,1653380,3167071,2.525993260018484e-06
WA22,5p,23,->G,9,0,9,1513634,1653393,3167027,2.841781898291363e-06
WA22,5p,24,->G,44,16,60,1513632,1653375,3167007,1.8945332296392147e-05
WA22,5p,25,->G,1,11,12,1513644,1653364,3167008,3.789065262860088e-06
WA25,3p,1,->G,0,0,0,3375244,3569089,6944333,0.0
WA25,3p,2,->G,0,0,0,3375244,3569089,6944333,0.0
WA25,3p,3,->G,0,0,0,3375244,3569089,6944333,0.0
WA25,3p,4,->G,0,0,0,3375244,3569087,6944331,0.0
WA25,3p,5,->G,0,0,0,3375244,3569089,6944333,0.0
WA25,3p,6,->G,0,0,0,3375244,3569089,6944333,0.0
WA25,3p,7,->G,0,0,0,3375244,3569089,6944333,0.0
WA25,3p,8,->G,0,6,6,3375239,3569076,6944315,8.64016105260202e-07
WA25,3p,9,->G,2,2,4,3375240,3569076,6944316,5.760106538930544e-07
WA25,3p,10,->G,0,5,5,3375240,3569075,6944315,7.200134210501684e-07
WA25,3p,11,->G,0,2,2,3375233,3569054,6944287,2.88006529684041e-07
WA25,3p,12,->G,0,5,5,3375226,3569069,6944295,7.200154947334466e-07
WA25,3p,13,->G,5,2,7,3375230,3569053,6944283,1.008023434528806e-06
WA25,3p,14,->G,4,16,20,3375223,3569037,6944260,2.8800764948317027e-06
WA25,3p,15,->G,6,12,18,3375218,3569039,6944257,2.5920699651524997e-06
WA25,3p,16,->G,4,10,14,3375196,3569030,6944226,2.0160634172908544e-06
WA25,3p,17,->G,7,7,14,3375198,3569022,6944220,2.016065159225946e-06
WA25,3p,18,->G,5,9,14,3375213,3569006,6944219,2.016065449548754e-06
WA25,3p,19,->G,14,27,41,3375204,3569005,6944209,5.904200176002767e-06
WA25,3p,20,->G,7,17,24,3375190,3568979,6944169,3.4561370842213086e-06
WA25,3p,21,->G,9,9,18,3375199,3568998,6944197,2.592092361435023e-06
WA25,3p,22,->G,19,17,36,3375179,3568994,6944173,5.1842026401127965e-06
WA25,3p,23,->G,19,15,34,3375175,3568972,6944147,4.896209714454489e-06
WA25,3p,24,->G,24,24,48,3375177,3568962,6944139,6.9123040307804895e-06
WA25,3p,25,->G,15,18,33,3375156,3568970,6944126,4.752217917704834e-06
WA25,5p,1,->G,0,0,0,3375244,3569089,6944333,0.0
WA25,5p,2,->G,0,0,0,3375147,3569045,6944192,0.0
WA25,5p,3,->G,0,0,0,3375243,3569089,6944332,0.0
WA25,5p,4,->G,0,0,0,3375243,3569089,6944332,0.0
WA25,5p,5,->G,0,0,0,3375244,3569088,6944332,0.0
WA25,5p,6,->G,0,0,0,3375244,3569089,6944333,0.0
WA25,5p,7,->G,0,0,0,3375242,3569089,6944331,0.0
WA25,5p,8,->G,0,0,0,3375221,3569088,6944309,0.0
WA25,5p,9,->G,1,0,1,3375227,3569087,6944314,1.4400270494680973e-07
WA25,5p,10,->G,1,0,1,3375217,3569085,6944302,1.440029537885881e-07
WA25,5p,11,->G,6,0,6,3375193,3569088,6944281,8.640203355826182e-07
WA25,5p,12,->G,6,2,8,3375142,3569084,6944226,1.1520362384519167e-06
WA25,5p,13,->G,16,3,19,3375133,3569081,6944214,2.7360907944369227e-06
WA25,5p,14,->G,7,1,8,3375151,3569071,6944222,1.1520369020460464e-06
WA25,5p,15,->G,18,12,30,3375137,3569055,6944192,4.320157046348949e-06
WA25,5p,16,->G,19,17,36,3375081,3569035,6944116,5.184245194060698e-06
WA25,5p,17,->G,27,188,215,3375076,3568871,6943947,3.096221788559158e-05
WA25,5p,18,->G,31,40,71,3375102,3568996,6944098,1.0224510080358887e-05
WA25,5p,19,->G,25,16,41,3375134,3569021,6944155,5.904246088976989e-06
WA25,5p,20,->G,21,12,33,3375145,3569019,6944164,4.752191912518195e-06
WA25,5p,21,->G,25,11,36,3375130,3569013,6944143,5.184225036840399e-06
WA25,5p,22,->G,32,28,60,3375139,3569001,6944140,8.640378794206337e-06
WA25,5p,23,->G,25,32,57,3375144,3569002,6944146,8.208352762168308e-06
WA25,5p,24,->G,36,23,59,3375124,3568967,6944091,8.496432434425182e-06
WA25,5p,25,->G,21,17,38,3375125,3568950,6944075,5.472291125887897e-06
WA26,3p,1,->G,0,0,0,2709623,2900126,5609749,0.0
WA26,3p,2,->G,0,0,0,2709623,2900126,5609749,0.0
WA26,3p,3,->G,0,0,0,2709623,2900126,5609749,0.0
WA26,3p,4,->G,0,0,0,2709623,2900126,5609749,0.0
WA26,3p,5,->G,0,0,0,2709623,2900126,5609749,0.0
WA26,3p,6,->G,0,0,0,2709623,2900126,5609749,0.0
WA26,3p,7,->G,0,0,0,2709623,2900126,5609749,0.0
WA26,3p,8,->G,0,2,2,2709619,2900114,5609733,3.565232070759874e-07
WA26,3p,9,->G,3,3,6,2709613,2900111,5609724,1.069571337199477e-06
WA26,3p,10,->G,0,25,25,2709609,2900074,5609683,4.456579810303007e-06
WA26,3p,11,->G,4,13,17,2709594,2900076,5609670,3.0304812939085545e-06
WA26,3p,12,->G,7,7,14,2709607,2900081,5609688,2.4956824693280626e-06
WA26,3p,13,->G,3,14,17,2709604,2900084,5609688,3.0304715698983616e-06
WA26,3p,14,->G,5,20,25,2709584,2900069,5609653,4.456603643754792e-06
WA26,3p,15,->G,8,12,20,2709593,2900082,5609675,3.565268932692179e-06
WA26,3p,16,->G,12,17,29,2709580,2900075,5609655,5.169658383626088e-06
WA26,3p,17,->G,1,13,14,2709570,2900078,5609648,2.4957002649720624e-06
WA26,3p,18,->G,4,19,23,2709582,2900059,5609641,4.100084123030333e-06
WA26,3p,19,->G,8,67,75,2709567,2900016,5609583,1.3369977768400967e-05
WA26,3p,20,->G,14,22,36,2709563,2899983,5609546,6.417631658604814e-06
WA26,3p,21,->G,17,59,76,2709562,2900021,5609583,1.3548244138646312e-05
WA26,3p,22,->G,37,61,98,2709522,2900007,5609529,1.747027245959509e-05
WA26,3p,23,->G,18,23,41,2709541,2899974,5609515,7.309009780702966e-06
WA26,3p,24,->G,28,25,53,2709558,2899951,5609509,9.448242261488483e-06
WA26,3p,25,->G,25,22,47,2709500,2900002,5609502,8.378640385545812e-06
WA26,5p,1,->G,0,0,0,2709622,2900126,5609748,0.0
WA26,5p,2,->G,0,0,0,2709554,2900092,5609646,0.0
WA26,5p,3,->G,0,0,0,2709623,2900126,5609749,0.0
WA26,5p,4,->G,0,0,0,2709623,2900126,5609749,0.0
WA26,5p,5,->G,0,0,0,2709623,2900125,5609748,0.0
WA26,5p,6,->G,0,0,0,2709621,2900126,5609747,0.0
WA26,5p,7,->G,0,0,0,2709622,2900126,5609748,0.0
WA26,5p,8,->G,3,0,3,2709609,2900124,5609733,5.34784810613981e-07
WA26,5p,9,->G,2,2,4,2709594,2900123,5609717,7.130484478985303e-07
WA26,5p,10,->G,1,3,4,2709601,2900123,5609724,7.130475581329848e-07
WA26,5p,11,->G,4,5,9,2709605,2900103,5609708,1.6043615817436489e-06
WA26,5p,12,->G,8,7,15,2709595,2900107,5609702,2.6739388295492344e-06
WA26,5p,13,->G,4,1,5,2709592,2900104,5609696,8.91313896510613e-07
WA26,5p,14,->G,2,5,7,2709563,2900089,5609652,1.247849242698121e-06
WA26,5p,15,->G,16,15,31,2709545,2900085,5609630,5.526211176138177e-06
WA26,5p,16,->G,15,8,23,2709540,2900076,5609616,4.100102395600697e-06
WA26,5p,17,->G,6,30,36,2709554,2900055,5609609,6.41755958392109e-06
WA26,5p,18,->G,16,14,30,2709554,2900082,5609636,5.347940579388752e-06
WA26,5p,19,->G,9,8,17,2709570,2900086,5609656,3.0304888570707367e-06
WA26,5p,20,->G,8,12,20,2709563,2900082,5609645,3.5652879995079904e-06
WA26,5p,21,->G,10,7,17,2709545,2900061,5609606,3.0305158686724167e-06
WA26,5p,22,->G,15,8,23,2709542,2900059,5609601,4.100113359221092e-06
WA26,5p,23,->G,19,2,21,2709528,2900065,5609593,3.743587101595428e-06
WA26,5p,24,->G,23,11,34,2709495,2900057,5609552,6.061090083486168e-06
WA26,5p,25,->G,6,3,9,2709506,2900041,5609547,1.604407628637393e-06
