Sample,End,Position,Substitution,Pos_Count,Neg_Count,Combined_Count,Pos_Total,Neg_Total,Combined_Total,Frequency
DAL192,3p,1,G>T,2,12,14,6350003,6167708,12517711,1.1184153396735231e-06
DAL192,3p,2,G>T,40,29,69,6350003,6167706,12517709,5.51219076909361e-06
DAL192,3p,3,G>T,81,52,133,6350003,6167708,12517711,1.0624945726898471e-05
DAL192,3p,4,G>T,62,87,149,6350003,6167708,12517711,1.1903134686525356e-05
DAL192,3p,5,G>T,174,134,308,6350003,6167708,12517711,2.4605137472817515e-05
DAL192,3p,6,G>T,263,155,418,6350003,6167708,12517711,3.339268657025234e-05
DAL192,3p,7,G>T,203,127,330,6350003,6167708,12517711,2.636264729230448e-05
DAL192,3p,8,G>T,273,176,449,6350003,6167618,12517621,3.586943557405996e-05
DAL192,3p,9,G>T,219,237,456,6350003,6167637,12517640,3.642859197101051e-05
DAL192,3p,10,G>T,361,434,795,6350003,6167645,12517648,6.351033357065162e-05
DAL192,3p,11,G>T,307,289,596,6349987,6167644,12517631,4.761284303715296e-05
DAL192,3p,12,G>T,275,526,801,6349997,6167646,12517643,6.398968240266958e-05
DAL192,3p,13,G>T,290,368,658,6349992,6167621,12517613,5.256593249847236e-05
DAL192,3p,14,G>T,235,278,513,6349967,6167610,12517577,4.0982372227468624e-05
DAL192,3p,15,G>T,281,318,599,6349968,6167615,12517583,4.785268849425644e-05
DAL192,3p,16,G>T,313,272,585,6349943,6167587,12517530,4.6734459593865566e-05
DAL192,3p,17,G>T,369,310,679,6349922,6167606,12517528,5.424393698180663e-05
DAL192,3p,18,G>T,340,353,693,6349922,6167564,12517486,5.536255442985916e-05
DAL192,3p,19,G>T,359,420,779,6349921,6167519,12517440,6.223317227803769e-05
DAL192,3p,20,G>T,378,347,725,6349910,6167516,12517426,5.791925592370189e-05
DAL192,3p,21,G>T,391,521,912,6349882,6167507,12517389,7.285864488193184e-05
DAL192,3p,22,G>T,327,512,839,6349894,6167488,12517382,6.702679521963938e-05
DAL192,3p,23,G>T,413,457,870,6349902,6167465,12517367,6.950343470795415e-05
DAL192,3p,24,G>T,436,527,963,6349899,6167465,12517364,7.69331306495521e-05
DAL192,3p,25,G>T,543,348,891,6349856,6167384,12517240,7.118182602554557e-05
DAL192,5p,1,G>T,8,5,13,6350003,6167708,12517711,1.0385285296968431e-06
DAL192,5p,2,G>T,168,22,190,6349992,6167694,12517686,1.5178524209666227e-05
DAL192,5p,3,G>T,43,17,60,6350003,6167707,12517710,4.79320898151499e-06
DAL192,5p,4,G>T,135,141,276,6350003,6167708,12517711,2.2048759553563745e-05
DAL192,5p,5,G>T,173,179,352,6350003,6167707,12517710,2.8120159358221272e-05
DAL192,5p,6,G>T,262,168,430,6350002,6167707,12517709,3.435133377840945e-05
DAL192,5p,7,G>T,388,279,667,6350002,6167708,12517710,5.328450651117497e-05
DAL192,5p,8,G>T,330,474,804,6349926,6167708,12517634,6.422939031449554e-05
DAL192,5p,9,G>T,296,269,565,6349914,6167708,12517622,4.513636855306863e-05
DAL192,5p,10,G>T,308,300,608,6349896,6167708,12517604,4.857159565041361e-05
DAL192,5p,11,G>T,275,279,554,6349942,6167706,12517648,4.425751546935974e-05
DAL192,5p,12,G>T,336,383,719,6349906,6167700,12517606,5.743909817899685e-05
DAL192,5p,13,G>T,373,283,656,6349906,6167705,12517611,5.240616600084473e-05
DAL192,5p,14,G>T,360,374,734,6349889,6167679,12517568,5.863758838777628e-05
DAL192,5p,15,G>T,487,317,804,6349890,6167649,12517539,6.422987777389789e-05
DAL192,5p,16,G>T,514,432,946,6349904,6167639,12517543,7.557393651453804e-05
DAL192,5p,17,G>T,397,347,744,6349778,6167623,12517401,5.943725858107446e-05
DAL192,5p,18,G>T,366,295,661,6349859,6167631,12517490,5.280611368573092e-05
DAL192,5p,19,G>T,425,388,813,6349822,6167638,12517460,6.494927884730608e-05
DAL192,5p,20,G>T,441,370,811,6349836,6167621,12517457,6.478951755136847e-05
DAL192,5p,21,G>T,368,444,812,6349784,6167624,12517408,6.486965991681345e-05
DAL192,5p,22,G>T,543,417,960,6349783,6167584,12517367,7.66934451949839e-05
DAL192,5p,23,G>T,505,426,931,6349801,6167567,12517368,7.437665809617485e-05
DAL192,5p,24,G>T,486,426,912,6349759,6167564,12517323,7.285902904319079e-05
DAL192,5p,25,G>T,418,487,905,6349777,6167551,12517328,7.229977515968264e-05
DAL193,3p,1,G>T,38,7,45,6484405,6362696,12847101,3.502735753381249e-06
DAL193,3p,2,G>T,59,94,153,6484402,6362696,12847098,1.1909304342505987e-05
DAL193,3p,3,G>T,229,114,343,6484405,6362696,12847101,2.6698630297994852e-05
DAL193,3p,4,G>T,218,234,452,6484405,6362696,12847101,3.518303467840721e-05
DAL193,3p,5,G>T,952,848,1800,6484405,6362696,12847101,0.0001401094301352
DAL193,3p,6,G>T,912,1009,1921,6484405,6362696,12847101,0.0001495278973832
DAL193,3p,7,G>T,876,773,1649,6484405,6362696,12847101,0.0001283558057183
DAL193,3p,8,G>T,885,757,1642,6484400,6362644,12847044,0.0001278115027861
DAL193,3p,9,G>T,1078,1362,2440,6484400,6362631,12847031,0.0001899271512616
DAL193,3p,10,G>T,1710,1146,2856,6484393,6362640,12847033,0.0002223081391633
DAL193,3p,11,G>T,1153,1351,2504,6484398,6362639,12847037,0.0001949087560034
DAL193,3p,12,G>T,1372,1518,2890,6484368,6362594,12846962,0.0002249559078636
DAL193,3p,13,G>T,1362,1291,2653,6484385,6362543,12846928,0.0002065085131636
DAL193,3p,14,G>T,1274,1239,2513,6484363,6362486,12846849,0.0001956121691786
DAL193,3p,15,G>T,1398,1212,2610,6484332,6362438,12846770,0.0002031639081263
DAL193,3p,16,G>T,1129,1178,2307,6484341,6362460,12846801,0.0001795777797134
DAL193,3p,17,G>T,1406,972,2378,6484294,6362445,12846739,0.0001851053407405
DAL193,3p,18,G>T,1146,1544,2690,6484244,6362380,12846624,0.0002093935340522
DAL193,3p,19,G>T,1024,1178,2202,6484265,6362400,12846665,0.000171406353322
DAL193,3p,20,G>T,1151,1294,2445,6484261,6362382,12846643,0.0001903220942622
DAL193,3p,21,G>T,1238,1599,2837,6484248,6362443,12846691,0.0002208350772973
DAL193,3p,22,G>T,1085,1103,2188,6484224,6362407,12846631,0.0001703170270867
DAL193,3p,23,G>T,1059,1091,2150,6484218,6362399,12846617,0.0001673592355092
DAL193,3p,24,G>T,1320,1195,2515,6484164,6362319,12846483,0.0001957734268593
DAL193,3p,25,G>T,1007,1309,2316,6484128,6362355,12846483,0.0001802828058076
DAL193,5p,1,G>T,7,19,26,6484405,6362696,12847101,2.0238028797313884e-06
DAL193,5p,2,G>T,249,129,378,6484386,6362681,12847067,2.9423058196863143e-05
DAL193,5p,3,G>T,105,54,159,6484400,6362696,12847096,1.237633781206274e-05
DAL193,5p,4,G>T,223,180,403,6484403,6362696,12847099,3.136894951926501e-05
DAL193,5p,5,G>T,700,744,1444,6484403,6362696,12847099,0.0001123989158953
DAL193,5p,6,G>T,721,843,1564,6484404,6362696,12847100,0.0001217395365491
DAL193,5p,7,G>T,1409,1670,3079,6484404,6362696,12847100,0.0002396649827587
DAL193,5p,8,G>T,1380,1349,2729,6484314,6362693,12847007,0.0002124230180617
DAL193,5p,9,G>T,1296,1277,2573,6484295,6362695,12846990,0.0002002803769598
DAL193,5p,10,G>T,1087,919,2006,6484284,6362694,12846978,0.0001561456709897
DAL193,5p,11,G>T,916,1143,2059,6484315,6362677,12846992,0.000160270980164
DAL193,5p,12,G>T,1459,1458,2917,6484218,6362670,12846888,0.0002270588799404
DAL193,5p,13,G>T,1154,1462,2616,6484143,6362652,12846795,0.0002036305553252
DAL193,5p,14,G>T,1299,1430,2729,6484145,6362627,12846772,0.0002124269038167
DAL193,5p,15,G>T,1311,1562,2873,6484166,6362534,12846700,0.000223637198658
DAL193,5p,16,G>T,1238,1111,2349,6484111,6362519,12846630,0.0001828495099493
DAL193,5p,17,G>T,979,1399,2378,6484043,6362598,12846641,0.0001851067528079
DAL193,5p,18,G>T,1586,1361,2947,6483967,6362571,12846538,0.0002294003255974
DAL193,5p,19,G>T,1185,1220,2405,6483980,6362593,12846573,0.0001872094604529
DAL193,5p,20,G>T,1349,1243,2592,6483952,6362554,12846506,0.000201766924018
DAL193,5p,21,G>T,1248,1551,2799,6484003,6362532,12846535,0.0002178797629088
DAL193,5p,22,G>T,1076,1432,2508,6484010,6362499,12846509,0.0001952281355191
DAL193,5p,23,G>T,1608,1238,2846,6483966,6362463,12846429,0.000221540164975
DAL193,5p,24,G>T,1525,1552,3077,6483905,6362426,12846331,0.0002395236429763
DAL193,5p,25,G>T,1479,1591,3070,6483942,6362403,12846345,0.0002389784798711
DAL195,3p,1,G>T,2,3,5,2363278,2267461,4630739,1.079741268078378e-06
DAL195,3p,2,G>T,21,5,26,2363278,2267460,4630738,5.6146558064826815e-06
DAL195,3p,3,G>T,52,24,76,2363278,2267461,4630739,1.6412067274791347e-05
DAL195,3p,4,G>T,131,43,174,2363278,2267461,4630739,3.757499612912755e-05
DAL195,3p,5,G>T,206,260,466,2363278,2267461,4630739,0.0001006318861849
DAL195,3p,6,G>T,204,220,424,2363278,2267461,4630739,9.156205953304644e-05
DAL195,3p,7,G>T,206,206,412,2363278,2267461,4630739,8.897068048965834e-05
DAL195,3p,8,G>T,346,198,544,2363278,2267413,4630691,0.0001174770676773
DAL195,3p,9,G>T,279,234,513,2363276,2267438,4630714,0.0001107820521846
DAL195,3p,10,G>T,432,385,817,2363274,2267432,4630706,0.0001764309805027
DAL195,3p,11,G>T,382,283,665,2363274,2267431,4630705,0.0001436066430489
DAL195,3p,12,G>T,255,354,609,2363273,2267414,4630687,0.0001315139632629
DAL195,3p,13,G>T,231,300,531,2363269,2267412,4630681,0.000114669958911
DAL195,3p,14,G>T,337,273,610,2363250,2267410,4630660,0.0001317306820194
DAL195,3p,15,G>T,418,329,747,2363254,2267411,4630665,0.0001613159233069
DAL195,3p,16,G>T,274,306,580,2363259,2267394,4630653,0.0001252523132266
DAL195,3p,17,G>T,265,307,572,2363234,2267398,4630632,0.0001235252552999
DAL195,3p,18,G>T,279,303,582,2363236,2267374,4630610,0.0001256853848629
DAL195,3p,19,G>T,310,253,563,2363215,2267369,4630584,0.0001215829364071
DAL195,3p,20,G>T,263,391,654,2363222,2267380,4630602,0.0001412343362698
DAL195,3p,21,G>T,312,741,1053,2363235,2267382,4630617,0.0002273995020533
DAL195,3p,22,G>T,287,302,589,2363231,2267383,4630614,0.0001271969548746
DAL195,3p,23,G>T,262,313,575,2363219,2267370,4630589,0.0001241742681114
DAL195,3p,24,G>T,268,313,581,2363198,2267373,4630571,0.0001254704873329
DAL195,3p,25,G>T,379,357,736,2363180,2267377,4630557,0.0001589441615771
DAL195,5p,1,G>T,2,27,29,2363278,2267461,4630739,6.2624993548545925e-06
DAL195,5p,2,G>T,42,45,87,2363264,2267447,4630711,1.878761166481778e-05
DAL195,5p,3,G>T,12,33,45,2363278,2267459,4630737,9.717675609735556e-06
DAL195,5p,4,G>T,28,45,73,2363278,2267461,4630739,1.576422251394432e-05
DAL195,5p,5,G>T,153,157,310,2363277,2267461,4630738,6.69439730772935e-05
DAL195,5p,6,G>T,148,165,313,2363277,2267461,4630738,6.759181797804151e-05
DAL195,5p,7,G>T,283,331,614,2363277,2267461,4630738,0.000132592256353
DAL195,5p,8,G>T,285,262,547,2363212,2267460,4630672,0.000118125403829
DAL195,5p,9,G>T,317,289,606,2363181,2267461,4630642,0.0001308673829676
DAL195,5p,10,G>T,279,399,678,2363146,2267458,4630604,0.0001464171844536
DAL195,5p,11,G>T,200,241,441,2362948,2267450,4630398,9.524019317561905e-05
DAL195,5p,12,G>T,354,359,713,2362864,2267454,4630318,0.0001539851042628
DAL195,5p,13,G>T,417,321,738,2363073,2267445,4630518,0.0001593774173861
DAL195,5p,14,G>T,370,300,670,2363094,2267434,4630528,0.0001446919228217
DAL195,5p,15,G>T,303,337,640,2363178,2267432,4630610,0.0001382107324952
DAL195,5p,16,G>T,378,311,689,2363170,2267429,4630599,0.0001487928451589
DAL195,5p,17,G>T,356,323,679,2363159,2267431,4630590,0.0001466335823296
DAL195,5p,18,G>T,633,338,971,2363182,2267420,4630602,0.0002096919579786
DAL195,5p,19,G>T,365,386,751,2363138,2267420,4630558,0.0001621834776715
DAL195,5p,20,G>T,314,337,651,2363110,2267401,4630511,0.0001405892351837
DAL195,5p,21,G>T,344,289,633,2363086,2267400,4630486,0.0001367027132789
DAL195,5p,22,G>T,350,288,638,2363094,2267388,4630482,0.0001377826325639
DAL195,5p,23,G>T,307,326,633,2363068,2267398,4630466,0.0001367033037279
DAL195,5p,24,G>T,322,340,662,2363067,2267402,4630469,0.0001429660796778
DAL195,5p,25,G>T,427,291,718,2363135,2267374,4630509,0.0001550585475592
DAL212,3p,1,G>T,10,1,11,4131322,4008153,8139475,1.3514385141547826e-06
DAL212,3p,2,G>T,56,25,81,4131322,4008153,8139475,9.951501786048854e-06
DAL212,3p,3,G>T,46,44,90,4131322,4008153,8139475,1.105722420672095e-05
DAL212,3p,4,G>T,78,44,122,4131322,4008153,8139475,1.4988681702443951e-05
DAL212,3p,5,G>T,346,352,698,4131322,4008151,8139473,8.575493769682632e-05
DAL212,3p,6,G>T,322,316,638,4131322,4008151,8139473,7.838345308105328e-05
DAL212,3p,7,G>T,440,322,762,4131322,4008153,8139475,9.361783161690404e-05
DAL212,3p,8,G>T,487,359,846,4131319,4008093,8139412,0.0001039387120347
DAL212,3p,9,G>T,492,445,937,4131316,4008115,8139431,0.0001151186120995
DAL212,3p,10,G>T,577,427,1004,4131317,4008102,8139419,0.0001233503275848
DAL212,3p,11,G>T,643,409,1052,4131313,4008105,8139418,0.0001292475702808
DAL212,3p,12,G>T,564,464,1028,4131314,4008034,8139348,0.0001263000427061
DAL212,3p,13,G>T,470,485,955,4131307,4007923,8139230,0.0001173329663862
DAL212,3p,14,G>T,453,473,926,4131271,4007904,8139175,0.0001137707445779
DAL212,3p,15,G>T,514,497,1011,4131254,4007935,8139189,0.0001242138498073
DAL212,3p,16,G>T,535,466,1001,4131236,4007982,8139218,0.0001229847879734
DAL212,3p,17,G>T,459,526,985,4131249,4007981,8139230,0.0001210188187334
DAL212,3p,18,G>T,510,457,967,4131222,4007954,8139176,0.0001188080955615
DAL212,3p,19,G>T,519,492,1011,4131233,4007956,8139189,0.0001242138498073
DAL212,3p,20,G>T,439,430,869,4131221,4007928,8139149,0.0001067679188573
DAL212,3p,21,G>T,480,530,1010,4131228,4007917,8139145,0.0001240916582761
DAL212,3p,22,G>T,546,531,1077,4131183,4007898,8139081,0.0001323245216505
DAL212,3p,23,G>T,580,481,1061,4131172,4007904,8139076,0.0001303587778268
DAL212,3p,24,G>T,589,484,1073,4131124,4007904,8139028,0.0001318339241491
DAL212,3p,25,G>T,600,420,1020,4131071,4007924,8138995,0.0001253225981831
DAL212,5p,1,G>T,2,7,9,4131322,4008153,8139475,1.1057224206720949e-06
DAL212,5p,2,G>T,125,82,207,4131307,4008143,8139450,2.5431693787663785e-05
DAL212,5p,3,G>T,80,117,197,4131321,4008153,8139474,2.420303818158274e-05
DAL212,5p,4,G>T,100,117,217,4131322,4008153,8139475,2.6660196142871624e-05
DAL212,5p,5,G>T,302,323,625,4131322,4008153,8139475,7.678627921333993e-05
DAL212,5p,6,G>T,501,285,786,4131322,4008153,8139475,9.656642473869628e-05
DAL212,5p,7,G>T,554,637,1191,4131322,4008153,8139475,0.0001463239336689
DAL212,5p,8,G>T,423,434,857,4131248,4008153,8139401,0.0001052903033036
DAL212,5p,9,G>T,759,530,1289,4131243,4008153,8139396,0.0001583655593117
DAL212,5p,10,G>T,480,470,950,4131179,4008148,8139327,0.0001167172666732
DAL212,5p,11,G>T,505,411,916,4131234,4008143,8139377,0.0001125393257985
DAL212,5p,12,G>T,514,460,974,4131187,4008141,8139328,0.000119665898708
DAL212,5p,13,G>T,580,471,1051,4131181,4008142,8139323,0.0001291262184827
DAL212,5p,14,G>T,519,737,1256,4131134,4008108,8139242,0.0001543141240916
DAL212,5p,15,G>T,641,721,1362,4131156,4008091,8139247,0.0001673373470543
DAL212,5p,16,G>T,513,510,1023,4131154,4008081,8139235,0.000125687487829
DAL212,5p,17,G>T,649,436,1085,4131159,4008081,8139240,0.0001333048294435
DAL212,5p,18,G>T,741,613,1354,4131113,4008066,8139179,0.0001663558449814
DAL212,5p,19,G>T,690,619,1309,4131040,4008052,8139092,0.000160828750922
DAL212,5p,20,G>T,573,476,1049,4131020,4008040,8139060,0.0001288846623565
DAL212,5p,21,G>T,760,507,1267,4130973,4008040,8139013,0.0001556699811144
DAL212,5p,22,G>T,531,442,973,4131015,4007967,8138982,0.0001195481203914
DAL212,5p,23,G>T,447,497,944,4131005,4007962,8138967,0.0001159852349812
DAL212,5p,24,G>T,563,646,1209,4131060,4007918,8138978,0.000148544448701
DAL212,5p,25,G>T,605,519,1124,4131016,4007614,8138630,0.0001381067820996
DAL218,3p,1,G>T,34,13,47,6952891,6658031,13610922,3.453109201566213e-06
DAL218,3p,2,G>T,168,47,215,6952891,6658031,13610922,1.5796137836951826e-05
DAL218,3p,3,G>T,90,58,148,6952891,6658030,13610921,1.0873621263395769e-05
DAL218,3p,4,G>T,126,196,322,6952891,6658031,13610922,2.365747155115576e-05
DAL218,3p,5,G>T,619,870,1489,6952891,6658031,13610922,0.0001093974383219
DAL218,3p,6,G>T,1171,794,1965,6952891,6658030,13610921,0.0001443693633957
DAL218,3p,7,G>T,981,1065,2046,6952891,6658026,13610917,0.0001503205111014
DAL218,3p,8,G>T,816,1081,1897,6952887,6657945,13610832,0.0001393742865976
DAL218,3p,9,G>T,1303,1236,2539,6952882,6657945,13610827,0.0001865426693029
DAL218,3p,10,G>T,990,1397,2387,6952881,6657960,13610841,0.0001753749088685
DAL218,3p,11,G>T,1065,1160,2225,6952866,6657905,13610771,0.0001634734725902
DAL218,3p,12,G>T,1033,1241,2274,6952858,6657882,13610740,0.0001670739430773
DAL218,3p,13,G>T,1023,1179,2202,6952870,6657811,13610681,0.0001617847042333
DAL218,3p,14,G>T,965,1563,2528,6952816,6657779,13610595,0.0001857376551135
DAL218,3p,15,G>T,1259,1587,2846,6952788,6657738,13610526,0.0002091028664138
DAL218,3p,16,G>T,1306,1829,3135,6952760,6657689,13610449,0.0002303377353678
DAL218,3p,17,G>T,1417,2192,3609,6952737,6657651,13610388,0.0002651651077103
DAL218,3p,18,G>T,1164,1503,2667,6952711,6657672,13610383,0.0001959533394468
DAL218,3p,19,G>T,1507,1673,3180,6952716,6657697,13610413,0.0002336446366469
DAL218,3p,20,G>T,1278,1183,2461,6952697,6657752,13610449,0.0001808169590878
DAL218,3p,21,G>T,1129,1707,2836,6952660,6657692,13610352,0.0002083708048109
DAL218,3p,22,G>T,1143,1428,2571,6952654,6657637,13610291,0.0001889011777925
DAL218,3p,23,G>T,1160,1219,2379,6952651,6657632,13610283,0.0001747943080977
DAL218,3p,24,G>T,1510,1384,2894,6952669,6657588,13610257,0.0002126337511481
DAL218,3p,25,G>T,1070,1369,2439,6952605,6657566,13610171,0.00017920421426
DAL218,5p,1,G>T,5,33,38,6952891,6658031,13610922,2.791875524670555e-06
DAL218,5p,2,G>T,133,129,262,6952874,6658014,13610888,1.9249295123139653e-05
DAL218,5p,3,G>T,35,68,103,6952891,6658031,13610922,7.567452080028083e-06
DAL218,5p,4,G>T,97,160,257,6952891,6658031,13610922,1.8881894995798228e-05
DAL218,5p,5,G>T,572,702,1274,6952891,6658031,13610922,9.360130048500756e-05
DAL218,5p,6,G>T,582,648,1230,6952891,6658031,13610922,9.036860250907325e-05
DAL218,5p,7,G>T,1569,1876,3445,6952888,6658031,13610919,0.0002531056132212
DAL218,5p,8,G>T,1271,939,2210,6952719,6658029,13610748,0.0001623716786175
DAL218,5p,9,G>T,1151,1422,2573,6952736,6658029,13610765,0.0001890415417502
DAL218,5p,10,G>T,1164,1504,2668,6952716,6658028,13610744,0.0001960216135135
DAL218,5p,11,G>T,943,1443,2386,6952715,6658016,13610731,0.0001753028547842
DAL218,5p,12,G>T,1924,1328,3252,6952625,6658005,13610630,0.0002389308944552
DAL218,5p,13,G>T,1203,1832,3035,6952475,6658005,13610480,0.0002229899312882
DAL218,5p,14,G>T,1049,1464,2513,6952554,6657955,13610509,0.000184636739155
DAL218,5p,15,G>T,1060,1575,2635,6952449,6657923,13610372,0.0001936023497373
DAL218,5p,16,G>T,1077,1434,2511,6952253,6657920,13610173,0.0001844943484553
DAL218,5p,17,G>T,1105,1294,2399,6952350,6657874,13610224,0.0001762645493564
DAL218,5p,18,G>T,1223,1205,2428,6952457,6657843,13610300,0.0001783943043136
DAL218,5p,19,G>T,1148,1274,2422,6952296,6657770,13610066,0.0001779565212982
DAL218,5p,20,G>T,1280,1286,2566,6952289,6657772,13610061,0.0001885369948011
DAL218,5p,21,G>T,1063,1533,2596,6952371,6657729,13610100,0.0001907406999213
DAL218,5p,22,G>T,1123,2425,3548,6952322,6657786,13610108,0.0002606885999729
DAL218,5p,23,G>T,1298,1105,2403,6952288,6657745,13610033,0.0001765609238419
DAL218,5p,24,G>T,1189,1646,2835,6952375,6657772,13610147,0.0002083004687605
DAL218,5p,25,G>T,1203,1216,2419,6952272,6657720,13609992,0.0001777370625934
DAL224,3p,1,G>T,6,11,17,4609472,4586477,9195949,1.848640091414165e-06
DAL224,3p,2,G>T,99,24,123,4609471,4586476,9195947,1.3375457688044526e-05
DAL224,3p,3,G>T,67,56,123,4609472,4586477,9195949,1.337545477905543e-05
DAL224,3p,4,G>T,156,232,388,4609472,4586477,9195949,4.219249149815859e-05
DAL224,3p,5,G>T,379,1143,1522,4609472,4586477,9195949,0.0001655076599489
DAL224,3p,6,G>T,348,379,727,4609472,4586477,9195949,7.905654979165282e-05
DAL224,3p,7,G>T,304,590,894,4609472,4586476,9195948,9.72167306731182e-05
DAL224,3p,8,G>T,327,1281,1608,4609469,4586423,9195892,0.000174860687794
DAL224,3p,9,G>T,510,656,1166,4609466,4586431,9195897,0.0001267956785509
DAL224,3p,10,G>T,495,571,1066,4609461,4586371,9195832,0.000115922082961
DAL224,3p,11,G>T,916,711,1627,4609461,4586382,9195843,0.0001769277705154
DAL224,3p,12,G>T,748,871,1619,4609458,4586384,9195842,0.0001760578313546
DAL224,3p,13,G>T,623,985,1608,4609454,4586364,9195818,0.0001748620949218
DAL224,3p,14,G>T,658,847,1505,4609412,4586293,9195705,0.0001636633624066
DAL224,3p,15,G>T,561,824,1385,4609400,4586272,9195672,0.0001506143324816
DAL224,3p,16,G>T,1289,610,1899,4609379,4586240,9195619,0.0002065113833011
DAL224,3p,17,G>T,1203,926,2129,4609381,4586216,9195597,0.0002315238477719
DAL224,3p,18,G>T,650,1539,2189,4609363,4586282,9195645,0.0002380474670346
DAL224,3p,19,G>T,546,1619,2165,4609353,4586195,9195548,0.0002354400194528
DAL224,3p,20,G>T,1060,1063,2123,4609344,4586225,9195569,0.000230872064578
DAL224,3p,21,G>T,780,1207,1987,4609343,4586223,9195566,0.000216082403193
DAL224,3p,22,G>T,1177,1269,2446,4609324,4586172,9195496,0.0002659997894621
DAL224,3p,23,G>T,616,876,1492,4609323,4586083,9195406,0.0001622549346923
DAL224,3p,24,G>T,635,827,1462,4609325,4586202,9195527,0.0001589903438921
DAL224,3p,25,G>T,673,613,1286,4609265,4586173,9195438,0.0001398519570247
DAL224,5p,1,G>T,1,3,4,4609472,4586477,9195949,4.349741391562742e-07
DAL224,5p,2,G>T,109,69,178,4609461,4586469,9195930,1.9356389185215632e-05
DAL224,5p,3,G>T,52,49,101,4609468,4586477,9195945,1.0983101791061169e-05
DAL224,5p,4,G>T,239,113,352,4609471,4586477,9195948,3.827772840820762e-05
DAL224,5p,5,G>T,378,323,701,4609471,4586477,9195948,7.622922617657255e-05
DAL224,5p,6,G>T,337,374,711,4609472,4586477,9195949,7.731665323502773e-05
DAL224,5p,7,G>T,1047,572,1619,4609471,4586477,9195948,0.0001760558019684
DAL224,5p,8,G>T,1052,334,1386,4609397,4586477,9195874,0.0001507197684526
DAL224,5p,9,G>T,656,627,1283,4609357,4586473,9195830,0.0001395197605871
DAL224,5p,10,G>T,696,372,1068,4609338,4586470,9195808,0.0001161398759086
DAL224,5p,11,G>T,599,343,942,4609388,4586469,9195857,0.0001024374345969
DAL224,5p,12,G>T,1375,562,1937,4609357,4586464,9195821,0.0002106391588092
DAL224,5p,13,G>T,613,604,1217,4609320,4586461,9195781,0.0001323432996066
DAL224,5p,14,G>T,423,536,959,4609270,4586428,9195698,0.0001042878963619
DAL224,5p,15,G>T,550,398,948,4609299,4586416,9195715,0.0001030914942448
DAL224,5p,16,G>T,662,459,1121,4609292,4586373,9195665,0.0001219052673188
DAL224,5p,17,G>T,842,626,1468,4609285,4586385,9195670,0.0001596403524702
DAL224,5p,18,G>T,1503,514,2017,4609226,4586351,9195577,0.0002193445827271
DAL224,5p,19,G>T,634,695,1329,4609203,4586337,9195540,0.0001445265857143
DAL224,5p,20,G>T,952,636,1588,4609148,4586313,9195461,0.0001726938975653
DAL224,5p,21,G>T,529,506,1035,4609195,4586347,9195542,0.0001125545400151
DAL224,5p,22,G>T,888,722,1610,4609138,4586312,9195450,0.0001750865917383
DAL224,5p,23,G>T,1150,586,1736,4609100,4586313,9195413,0.0001887897802958
DAL224,5p,24,G>T,814,661,1475,4609109,4586316,9195425,0.000160405853998
DAL224,5p,25,G>T,1565,519,2084,4609125,4586257,9195382,0.0002266355002978
DAL227,3p,1,G>T,9,3,12,3765386,3771243,7536629,1.5922237912997971e-06
DAL227,3p,2,G>T,12,5,17,3765386,3771243,7536629,2.2556503710080463e-06
DAL227,3p,3,G>T,34,20,54,3765386,3771243,7536629,7.165007060849088e-06
DAL227,3p,4,G>T,40,55,95,3765386,3771243,7536629,1.2605105014456727e-05
DAL227,3p,5,G>T,294,169,463,3765386,3771243,7536629,6.143330128098385e-05
DAL227,3p,6,G>T,243,147,390,3765386,3771243,7536629,5.174727321724341e-05
DAL227,3p,7,G>T,182,157,339,3765386,3771243,7536629,4.498032210421927e-05
DAL227,3p,8,G>T,184,233,417,3765386,3771207,7536593,5.533004104109111e-05
DAL227,3p,9,G>T,256,233,489,3765384,3771218,7536602,6.488335194030414e-05
DAL227,3p,10,G>T,274,351,625,3765382,3771209,7536591,8.292874059372467e-05
DAL227,3p,11,G>T,297,370,667,3765378,3771214,7536592,8.850154021870893e-05
DAL227,3p,12,G>T,365,211,576,3765377,3771173,7536550,7.642754310659387e-05
DAL227,3p,13,G>T,253,234,487,3765373,3771183,7536556,6.461837475897479e-05
DAL227,3p,14,G>T,188,268,456,3765341,3771166,7536507,6.050548350847415e-05
DAL227,3p,15,G>T,433,271,704,3765341,3771186,7536527,9.341172664809666e-05
DAL227,3p,16,G>T,333,234,567,3765340,3771079,7536419,7.52346704714799e-05
DAL227,3p,17,G>T,374,228,602,3765328,3771049,7536377,7.987923109472894e-05
DAL227,3p,18,G>T,561,347,908,3765321,3771036,7536357,0.0001204826151415
DAL227,3p,19,G>T,385,248,633,3765313,3771111,7536424,8.399208961703853e-05
DAL227,3p,20,G>T,338,287,625,3765308,3771082,7536390,8.293095235251892e-05
DAL227,3p,21,G>T,368,309,677,3765307,3771104,7536411,8.983055727719733e-05
DAL227,3p,22,G>T,317,347,664,3765309,3771137,7536446,8.810518910372343e-05
DAL227,3p,23,G>T,373,439,812,3765319,3771112,7536431,0.0001077433071436
DAL227,3p,24,G>T,401,331,732,3765312,3771081,7536393,9.71286927313902e-05
DAL227,3p,25,G>T,352,409,761,3765249,3771100,7536349,0.0001009772769281
DAL227,5p,1,G>T,2,7,9,3765386,3771243,7536629,1.194167843474848e-06
DAL227,5p,2,G>T,66,55,121,3765373,3771238,7536611,1.6054961573577303e-05
DAL227,5p,3,G>T,68,21,89,3765386,3771243,7536629,1.1808993118806827e-05
DAL227,5p,4,G>T,184,157,341,3765385,3771243,7536628,4.524569873954241e-05
DAL227,5p,5,G>T,139,311,450,3765386,3771242,7536628,5.970840009617033e-05
DAL227,5p,6,G>T,341,210,551,3765386,3771243,7536629,7.310960908384902e-05
DAL227,5p,7,G>T,387,455,842,3765386,3771243,7536629,0.0001117210360228
DAL227,5p,8,G>T,251,610,861,3765342,3771242,7536584,0.0001142427391507
DAL227,5p,9,G>T,394,429,823,3765324,3771243,7536567,0.0001092009133601
DAL227,5p,10,G>T,345,397,742,3765318,3771238,7536556,9.84534580516618e-05
DAL227,5p,11,G>T,322,443,765,3765365,3771237,7536602,0.000101504630336
DAL227,5p,12,G>T,310,470,780,3765326,3771232,7536558,0.0001034955214303
DAL227,5p,13,G>T,237,612,849,3765325,3771231,7536556,0.0001126509243744
DAL227,5p,14,G>T,246,553,799,3765297,3771226,7536523,0.0001060170585295
DAL227,5p,15,G>T,302,693,995,3765318,3771201,7536519,0.0001320238163003
DAL227,5p,16,G>T,427,545,972,3765316,3771188,7536504,0.000128972266186
DAL227,5p,17,G>T,244,577,821,3765326,3771175,7536501,0.000108936494535
DAL227,5p,18,G>T,435,511,946,3765280,3771169,7536449,0.0001255233067987
DAL227,5p,19,G>T,251,521,772,3765279,3771164,7536443,0.0001024355919629
DAL227,5p,20,G>T,424,464,888,3765254,3771167,7536421,0.0001178278124324
DAL227,5p,21,G>T,841,589,1430,3765270,3771169,7536439,0.0001897447853024
DAL227,5p,22,G>T,405,537,942,3765253,3771158,7536411,0.0001249931830947
DAL227,5p,23,G>T,516,635,1151,3765254,3771157,7536411,0.0001527252162866
DAL227,5p,24,G>T,381,540,921,3765270,3771180,7536450,0.0001222060784586
DAL227,5p,25,G>T,312,511,823,3765247,3771148,7536395,0.000109203405607
WA02,3p,1,G>T,25,29,54,6552698,6754258,13306956,4.058027996786042e-06
WA02,3p,2,G>T,83,33,116,6552698,6754258,13306956,8.717245326429274e-06
WA02,3p,3,G>T,62,41,103,6552698,6754258,13306956,7.740312660536339e-06
WA02,3p,4,G>T,94,80,174,6552698,6754256,13306954,1.3075869954912297e-05
WA02,3p,5,G>T,430,596,1026,6552698,6754256,13306954,7.710254352724147e-05
WA02,3p,6,G>T,407,459,866,6552698,6754257,13306955,6.507875017237226e-05
WA02,3p,7,G>T,389,569,958,6552698,6754257,13306955,7.199242801978364e-05
WA02,3p,8,G>T,467,662,1129,6552692,6754207,13306899,8.484320802314649e-05
WA02,3p,9,G>T,516,682,1198,6552688,6754191,13306879,9.00286235412526e-05
WA02,3p,10,G>T,608,789,1397,6552680,6754207,13306887,0.0001049832316153
WA02,3p,11,G>T,634,791,1425,6552667,6754202,13306869,0.0001070875500465
WA02,3p,12,G>T,591,852,1443,6552670,6754189,13306859,0.0001084403163811
WA02,3p,13,G>T,606,716,1322,6552675,6754177,13306852,9.934731369973905e-05
WA02,3p,14,G>T,684,722,1406,6552653,6754155,13306808,0.0001056602004026
WA02,3p,15,G>T,700,790,1490,6552632,6754146,13306778,0.0001119730110474
WA02,3p,16,G>T,593,756,1349,6552629,6754119,13306748,0.0001013771358712
WA02,3p,17,G>T,641,843,1484,6552608,6754116,13306724,0.0001115225655841
WA02,3p,18,G>T,668,786,1454,6552611,6754085,13306696,0.0001092682962021
WA02,3p,19,G>T,723,795,1518,6552605,6754056,13306661,0.000114078204893
WA02,3p,20,G>T,679,862,1541,6552618,6754033,13306651,0.000115806749572
WA02,3p,21,G>T,641,686,1327,6552597,6754089,13306686,9.972430400777472e-05
WA02,3p,22,G>T,665,759,1424,6552593,6754062,13306655,0.0001070141218811
WA02,3p,23,G>T,638,696,1334,6552585,6754052,13306637,0.0001002507245068
WA02,3p,24,G>T,740,869,1609,6552556,6754026,13306582,0.0001209176030328
WA02,3p,25,G>T,734,786,1520,6552517,6754038,13306555,0.0001142294155023
WA02,5p,1,G>T,24,35,59,6552698,6754258,13306956,4.433771329821787e-06
WA02,5p,2,G>T,183,80,263,6552562,6754179,13306741,1.976441865066736e-05
WA02,5p,3,G>T,137,97,234,6552698,6754258,13306956,1.758478798607285e-05
WA02,5p,4,G>T,195,232,427,6552698,6754258,13306956,3.208848064125259e-05
WA02,5p,5,G>T,358,484,842,6552698,6754258,13306956,6.327517728321939e-05
WA02,5p,6,G>T,508,499,1007,6552697,6754258,13306955,7.567471296025275e-05
WA02,5p,7,G>T,920,741,1661,6552685,6754258,13306943,0.0001248220571772
WA02,5p,8,G>T,799,959,1758,6552655,6754257,13306912,0.0001321117927284
WA02,5p,9,G>T,775,783,1558,6552662,6754226,13306888,0.0001170822208768
WA02,5p,10,G>T,698,683,1381,6552618,6754222,13306840,0.0001037812132707
WA02,5p,11,G>T,470,492,962,6552625,6754225,13306850,7.229359314939299e-05
WA02,5p,12,G>T,603,720,1323,6552628,6754236,13306864,9.942237329546616e-05
WA02,5p,13,G>T,748,749,1497,6552614,6754205,13306819,0.0001124987121264
WA02,5p,14,G>T,714,740,1454,6552607,6754183,13306790,0.000109267524324
WA02,5p,15,G>T,646,763,1409,6552586,6754168,13306754,0.0001058860786033
WA02,5p,16,G>T,711,630,1341,6552525,6754178,13306703,0.0001007762779405
WA02,5p,17,G>T,671,758,1429,6552567,6754148,13306715,0.0001073893894924
WA02,5p,18,G>T,818,811,1629,6552548,6754087,13306635,0.0001224201310098
WA02,5p,19,G>T,855,812,1667,6552516,6754124,13306640,0.0001252758021559
WA02,5p,20,G>T,755,888,1643,6552507,6754132,13306639,0.000123472200606
WA02,5p,21,G>T,752,1046,1798,6552521,6754152,13306673,0.0001351201761702
WA02,5p,22,G>T,743,747,1490,6552516,6754117,13306633,0.0001119742311973
WA02,5p,23,G>T,669,815,1484,6552465,6754131,13306596,0.0001115236383519
WA02,5p,24,G>T,699,772,1471,6552457,6754135,13306592,0.0001105467124865
WA02,5p,25,G>T,710,824,1534,6552470,6754083,13306553,0.0001152815458669
WA03,3p,1,G>T,45,27,72,5399458,5543742,10943200,6.579428320783683e-06
WA03,3p,2,G>T,88,45,133,5399458,5543742,10943200,1.215366620366986e-05
WA03,3p,3,G>T,132,101,233,5399458,5543742,10943200,2.1291761093647195e-05
WA03,3p,4,G>T,214,266,480,5399458,5543736,10943194,4.386287952128053e-05
WA03,3p,5,G>T,908,1215,2123,5399458,5543740,10943198,0.0001940017899703
WA03,3p,6,G>T,1059,1140,2199,5399458,5543741,10943199,0.0002009467249933
WA03,3p,7,G>T,1022,1317,2339,5399458,5543739,10943197,0.0002137400980718
WA03,3p,8,G>T,980,1533,2513,5399449,5543673,10943122,0.0002296419614073
WA03,3p,9,G>T,1010,1768,2778,5399436,5543670,10943106,0.0002538584566392
WA03,3p,10,G>T,1215,1760,2975,5399438,5543654,10943092,0.0002718610060118
WA03,3p,11,G>T,1178,1596,2774,5399404,5543644,10943048,0.0002534942732591
WA03,3p,12,G>T,1121,1920,3041,5399397,5543595,10942992,0.0002778947476156
WA03,3p,13,G>T,1184,1772,2956,5399378,5543551,10942929,0.0002701287744807
WA03,3p,14,G>T,1298,1482,2780,5399356,5543493,10942849,0.0002540471864319
WA03,3p,15,G>T,1201,2060,3261,5399349,5543505,10942854,0.0002980026965542
WA03,3p,16,G>T,1231,1905,3136,5399342,5543495,10942837,0.0002865801619817
WA03,3p,17,G>T,1282,1754,3036,5399346,5543438,10942784,0.0002774431077137
WA03,3p,18,G>T,1220,1897,3117,5399325,5543443,10942768,0.0002848456624503
WA03,3p,19,G>T,1270,1562,2832,5399297,5543425,10942722,0.0002588021517863
WA03,3p,20,G>T,1308,1957,3265,5399252,5543409,10942661,0.0002983734943447
WA03,3p,21,G>T,1265,1715,2980,5399248,5543303,10942551,0.0002723313786702
WA03,3p,22,G>T,1136,1918,3054,5399256,5543263,10942519,0.0002790947861273
WA03,3p,23,G>T,1167,1802,2969,5399255,5543267,10942522,0.0002713268476864
WA03,3p,24,G>T,1398,1833,3231,5399198,5543130,10942328,0.0002952753746734
WA03,3p,25,G>T,1320,1845,3165,5399050,5543142,10942192,0.0002892473464183
WA03,5p,1,G>T,28,53,81,5399457,5543742,10943199,7.401857537270409e-06
WA03,5p,2,G>T,610,241,851,5399258,5543638,10942896,7.7767347875736e-05
WA03,5p,3,G>T,260,224,484,5399457,5543742,10943199,4.422838330912195e-05
WA03,5p,4,G>T,242,440,682,5399458,5543742,10943200,6.232180714964544e-05
WA03,5p,5,G>T,813,1113,1926,5399456,5543740,10943196,0.000175999771913
WA03,5p,6,G>T,1227,1176,2403,5399452,5543742,10943194,0.0002195885406034
WA03,5p,7,G>T,2134,2143,4277,5399453,5543742,10943195,0.0003908364970193
WA03,5p,8,G>T,1328,1413,2741,5399403,5543732,10943135,0.0002504766687059
WA03,5p,9,G>T,1778,1981,3759,5399319,5543732,10943051,0.0003435056640054
WA03,5p,10,G>T,1539,2034,3573,5399344,5543717,10943061,0.0003265082777113
WA03,5p,11,G>T,1191,1307,2498,5399321,5543705,10943026,0.0002282732399612
WA03,5p,12,G>T,1968,1664,3632,5399213,5543665,10942878,0.0003319053726085
WA03,5p,13,G>T,1565,1707,3272,5399156,5543662,10942818,0.00029900890246
WA03,5p,14,G>T,1483,1830,3313,5399124,5543629,10942753,0.0003027574505245
WA03,5p,15,G>T,1601,1871,3472,5399092,5543505,10942597,0.0003172921382373
WA03,5p,16,G>T,1578,2030,3608,5399083,5543501,10942584,0.0003297210238459
WA03,5p,17,G>T,1705,1859,3564,5399113,5543491,10942604,0.0003256994404622
WA03,5p,18,G>T,1741,1759,3500,5399074,5543600,10942674,0.0003198486951178
WA03,5p,19,G>T,1822,1847,3669,5399071,5543546,10942617,0.0003352945643624
WA03,5p,20,G>T,1355,2030,3385,5399050,5543533,10942583,0.0003093419533578
WA03,5p,21,G>T,1762,1753,3515,5399034,5543509,10942543,0.0003212233207582
WA03,5p,22,G>T,1628,2438,4066,5398989,5543454,10942443,0.0003715806424579
WA03,5p,23,G>T,1796,2248,4044,5398935,5543457,10942392,0.0003695718449859
WA03,5p,24,G>T,1743,1905,3648,5398952,5543428,10942380,0.0003333826827436
WA03,5p,25,G>T,1917,2349,4266,5398991,5543444,10942435,0.0003898583816125
WA07,3p,1,G>T,31,37,68,5691729,6013979,11705708,5.809131750082951e-06
WA07,3p,2,G>T,75,56,131,5691729,6013979,11705708,1.1191121459718626e-05
WA07,3p,3,G>T,70,81,151,5691729,6013979,11705708,1.289968962150773e-05
WA07,3p,4,G>T,129,157,286,5691729,6013979,11705708,2.4432524713584176e-05
WA07,3p,5,G>T,447,292,739,5691729,6013979,11705708,6.313159357810736e-05
WA07,3p,6,G>T,898,279,1177,5691729,6013979,11705708,0.0001005492363212
WA07,3p,7,G>T,494,275,769,5691729,6013979,11705708,6.569444582079102e-05
WA07,3p,8,G>T,641,425,1066,5691713,6013800,11705513,9.10682000865746e-05
WA07,3p,9,G>T,554,652,1206,5691720,6013901,11705621,0.0001030274258836
WA07,3p,10,G>T,698,550,1248,5691718,6013892,11705610,0.0001066155458792
WA07,3p,11,G>T,590,478,1068,5691711,6013883,11705594,9.123842839585928e-05
WA07,3p,12,G>T,646,637,1283,5691705,6013884,11705589,0.0001096057618288
WA07,3p,13,G>T,582,516,1098,5691711,6013848,11705559,9.380158606692769e-05
WA07,3p,14,G>T,463,538,1001,5691695,6013877,11705572,8.55148300313731e-05
WA07,3p,15,G>T,725,668,1393,5691211,6013856,11705067,0.000119008289316
WA07,3p,16,G>T,569,638,1207,5691636,6013850,11705486,0.0001031140441328
WA07,3p,17,G>T,566,446,1012,5691662,6013813,11705475,8.645526986303418e-05
WA07,3p,18,G>T,648,617,1265,5691639,6013769,11705408,0.0001080697059
WA07,3p,19,G>T,630,439,1069,5691628,6013742,11705370,9.132560525639088e-05
WA07,3p,20,G>T,633,522,1155,5691604,6013772,11705376,9.867260991872451e-05
WA07,3p,21,G>T,583,812,1395,5691611,6013735,11705346,0.0001191763148223
WA07,3p,22,G>T,722,790,1512,5691577,6013736,11705313,0.0001291721118435
WA07,3p,23,G>T,769,712,1481,5691568,6013670,11705238,0.0001265245525123
WA07,3p,24,G>T,850,508,1358,5691554,6013661,11705215,0.0001160166643671
WA07,3p,25,G>T,798,652,1450,5691455,6013662,11705117,0.0001238774460776
WA07,5p,1,G>T,18,29,47,5691729,6013979,11705708,4.0151351802043925e-06
WA07,5p,2,G>T,180,25,205,5691636,6013923,11705559,1.7513046578980124e-05
WA07,5p,3,G>T,175,75,250,5691729,6013979,11705708,2.135710202236379e-05
WA07,5p,4,G>T,166,188,354,5691728,6013979,11705707,3.024165904716392e-05
WA07,5p,5,G>T,451,511,962,5691729,6013978,11705707,8.218213560274489e-05
WA07,5p,6,G>T,506,517,1023,5691728,6013979,11705707,8.739326894138047e-05
WA07,5p,7,G>T,759,876,1635,5691728,6013979,11705707,0.0001396754591585
WA07,5p,8,G>T,721,681,1402,5691579,6013975,11705554,0.0001197722038615
WA07,5p,9,G>T,731,968,1699,5691672,6013971,11705643,0.0001451436713045
WA07,5p,10,G>T,572,639,1211,5691582,6013961,11705543,0.0001034552604693
WA07,5p,11,G>T,450,949,1399,5691326,6013942,11705268,0.0001195188354508
WA07,5p,12,G>T,601,490,1091,5691520,6013938,11705458,9.320438380112936e-05
WA07,5p,13,G>T,549,795,1344,5691511,6013949,11705460,0.000114818213039
WA07,5p,14,G>T,668,509,1177,5691556,6013950,11705506,0.0001005509714829
WA07,5p,15,G>T,654,456,1110,5691563,6013633,11705196,9.482968076741305e-05
WA07,5p,16,G>T,777,597,1374,5691534,6013925,11705459,0.0001173811296079
WA07,5p,17,G>T,493,571,1064,5691561,6013916,11705477,9.089761997738324e-05
WA07,5p,18,G>T,575,612,1187,5691474,6013905,11705379,0.0001014063705241
WA07,5p,19,G>T,830,1934,2764,5691482,6013884,11705366,0.0002361310188848
WA07,5p,20,G>T,672,590,1262,5691421,6013876,11705297,0.0001078144364897
WA07,5p,21,G>T,569,2097,2666,5691379,6013853,11705232,0.0002277613976382
WA07,5p,22,G>T,581,637,1218,5691396,6013861,11705257,0.0001040558101372
WA07,5p,23,G>T,660,498,1158,5691314,6013795,11705109,9.893115903491372e-05
WA07,5p,24,G>T,816,895,1711,5691332,6013785,11705117,0.0001461753863716
WA07,5p,25,G>T,493,615,1108,5691334,6013719,11705053,9.465997291938788e-05
WA08,3p,1,G>T,55,34,89,6798117,7189085,13987202,6.362959511130246e-06
WA08,3p,2,G>T,53,136,189,6798117,7189085,13987202,1.3512352220265356e-05
WA08,3p,3,G>T,85,92,177,6798117,7189085,13987202,1.265442509516914e-05
WA08,3p,4,G>T,133,92,225,6798117,7189081,13987198,1.608613819579876e-05
WA08,3p,5,G>T,368,673,1041,6798117,7189085,13987202,7.442517810209647e-05
WA08,3p,6,G>T,397,543,940,6798117,7189085,13987202,6.720429146587001e-05
WA08,3p,7,G>T,415,557,972,6798117,7189084,13987201,6.949210210105654e-05
WA08,3p,8,G>T,512,712,1224,6798110,7189053,13987163,8.750881075740663e-05
WA08,3p,9,G>T,527,867,1394,6798103,7189051,13987154,9.966287637928344e-05
WA08,3p,10,G>T,619,839,1458,6798074,7189042,13987116,0.000104238786609
WA08,3p,11,G>T,578,873,1451,6798109,7189046,13987155,0.0001037380367916
WA08,3p,12,G>T,627,877,1504,6798091,7189018,13987109,0.0001075275812893
WA08,3p,13,G>T,504,716,1220,6798090,7189013,13987103,8.722320840848887e-05
WA08,3p,14,G>T,576,672,1248,6798067,7188981,13987048,8.922540338747676e-05
WA08,3p,15,G>T,603,810,1413,6798069,7188978,13987047,0.0001010220384617
WA08,3p,16,G>T,469,841,1310,6798049,7188961,13987010,9.365833012202035e-05
WA08,3p,17,G>T,726,837,1563,6798000,7188943,13986943,0.0001117470772562
WA08,3p,18,G>T,589,1019,1608,6798023,7188956,13986979,0.0001149640676517
WA08,3p,19,G>T,510,1138,1648,6798028,7188946,13986974,0.0001178239124488
WA08,3p,20,G>T,609,1044,1653,6798009,7188917,13986926,0.0001181817934834
WA08,3p,21,G>T,598,800,1398,6798010,7188926,13986936,9.995041086911388e-05
WA08,3p,22,G>T,693,794,1487,6798012,7188920,13986932,0.000106313521793
WA08,3p,23,G>T,610,832,1442,6798009,7188864,13986873,0.0001030966678542
WA08,3p,24,G>T,536,917,1453,6798015,7188867,13986882,0.000103883052706
WA08,3p,25,G>T,657,830,1487,6797966,7188892,13986858,0.0001063140842639
WA08,5p,1,G>T,66,44,110,6798116,7189085,13987201,7.864332542300636e-06
WA08,5p,2,G>T,341,65,406,6797941,7188997,13986938,2.902708226775581e-05
WA08,5p,3,G>T,142,95,237,6798117,7189084,13987201,1.6944061932047736e-05
WA08,5p,4,G>T,177,154,331,6798115,7189085,13987200,2.366449325097232e-05
WA08,5p,5,G>T,464,490,954,6798116,7189084,13987200,6.820521619766643e-05
WA08,5p,6,G>T,480,598,1078,6798112,7189085,13987197,7.707048095483319e-05
WA08,5p,7,G>T,795,901,1696,6798110,7189085,13987195,0.0001212537610292
WA08,5p,8,G>T,719,1004,1723,6798069,7189064,13987133,0.0001231846440582
WA08,5p,9,G>T,967,1148,2115,6798054,7189067,13987121,0.0001512105314596
WA08,5p,10,G>T,755,870,1625,6798015,7189037,13987052,0.000116178877436
WA08,5p,11,G>T,761,629,1390,6797997,7189047,13987044,9.937768123128804e-05
WA08,5p,12,G>T,759,747,1506,6798016,7189056,13987072,0.0001076708549151
WA08,5p,13,G>T,623,760,1383,6797995,7189043,13987038,9.887726050361772e-05
WA08,5p,14,G>T,690,968,1658,6797984,7189041,13987025,0.0001185384311531
WA08,5p,15,G>T,681,826,1507,6797997,7189013,13987010,0.0001077428270945
WA08,5p,16,G>T,649,768,1417,6797921,7188997,13986918,0.0001013089516932
WA08,5p,17,G>T,735,805,1540,6797959,7188875,13986834,0.000110103544519
WA08,5p,18,G>T,768,804,1572,6797991,7188972,13986963,0.0001123903738073
WA08,5p,19,G>T,880,1002,1882,6797966,7188988,13986954,0.000134553956494
WA08,5p,20,G>T,699,1037,1736,6797883,7188971,13986854,0.0001241165454361
WA08,5p,21,G>T,764,940,1704,6797885,7188979,13986864,0.0001218285957452
WA08,5p,22,G>T,777,746,1523,6797887,7188939,13986826,0.0001088881780612
WA08,5p,23,G>T,618,760,1378,6797851,7188919,13986770,9.852167441088972e-05
WA08,5p,24,G>T,657,1016,1673,6797841,7188876,13986717,0.0001196134875682
WA08,5p,25,G>T,797,979,1776,6797835,7188817,13986652,0.0001269782075081
WA09,3p,1,G>T,47,23,70,4741672,4881751,9623423,7.273919061855641e-06
WA09,3p,2,G>T,84,49,133,4741672,4881751,9623423,1.3820446217525718e-05
WA09,3p,3,G>T,79,120,199,4741672,4881751,9623423,2.067871276156104e-05
WA09,3p,4,G>T,196,110,306,4741672,4881748,9623420,3.1797427525765265e-05
WA09,3p,5,G>T,841,1240,2081,4741672,4881751,9623423,0.000216243222396
WA09,3p,6,G>T,804,1239,2043,4741672,4881751,9623423,0.0002122945234767
WA09,3p,7,G>T,889,1315,2204,4741672,4881748,9623420,0.0002290246087149
WA09,3p,8,G>T,1190,1207,2397,4741663,4881718,9623381,0.0002490808583802
WA09,3p,9,G>T,1304,1338,2642,4741664,4881723,9623387,0.0002745395150376
WA09,3p,10,G>T,1143,1444,2587,4741658,4881705,9623363,0.0002688249419667
WA09,3p,11,G>T,1242,1489,2731,4741648,4881712,9623360,0.0002837886143716
WA09,3p,12,G>T,1253,1608,2861,4741642,4881680,9623322,0.0002972985835868
WA09,3p,13,G>T,1383,3268,4651,4741628,4881645,9623273,0.0004833074983947
WA09,3p,14,G>T,1211,1448,2659,4741616,4881571,9623187,0.0002763117873527
WA09,3p,15,G>T,1266,1540,2806,4741598,4881557,9623155,0.0002915883616132
WA09,3p,16,G>T,1330,1677,3007,4741586,4881546,9623132,0.0003124762291528
WA09,3p,17,G>T,1328,1530,2858,4741582,4881528,9623110,0.0002969933836358
WA09,3p,18,G>T,1521,1825,3346,4741560,4881490,9623050,0.0003477068081325
WA09,3p,19,G>T,1356,2203,3559,4741552,4881442,9622994,0.0003698433148768
WA09,3p,20,G>T,1432,1309,2741,4741534,4881501,9623035,0.0002848373719933
WA09,3p,21,G>T,1358,1765,3123,4741546,4881493,9623039,0.0003245336530382
WA09,3p,22,G>T,1241,1851,3092,4741524,4881498,9623022,0.0003213127851105
WA09,3p,23,G>T,1402,1246,2648,4741501,4881486,9622987,0.0002751744338841
WA09,3p,24,G>T,1387,1639,3026,4741491,4881450,9622941,0.0003144568796587
WA09,3p,25,G>T,1405,1510,2915,4741451,4881469,9622920,0.0003029226056124
WA09,5p,1,G>T,15,45,60,4741672,4881751,9623423,6.234787767304836e-06
WA09,5p,2,G>T,246,84,330,4741495,4881667,9623162,3.429226277184152e-05
WA09,5p,3,G>T,188,152,340,4741672,4881750,9623422,3.5330467686026864e-05
WA09,5p,4,G>T,241,207,448,4741672,4881751,9623423,4.6553081995876106e-05
WA09,5p,5,G>T,989,1369,2358,4741671,4881751,9623422,0.0002450271847166
WA09,5p,6,G>T,1003,711,1714,4741669,4881751,9623420,0.000178107159409
WA09,5p,7,G>T,1538,1673,3211,4741667,4881751,9623418,0.0003336652320412
WA09,5p,8,G>T,1363,1697,3060,4741639,4881744,9623383,0.0003179754978057
WA09,5p,9,G>T,1800,1550,3350,4741618,4881747,9623365,0.0003481110817266
WA09,5p,10,G>T,1371,1932,3303,4741622,4881737,9623359,0.0003432273492031
WA09,5p,11,G>T,1103,1114,2217,4741614,4881733,9623347,0.0002303772273825
WA09,5p,12,G>T,1470,1803,3273,4741580,4881734,9623314,0.0003401115249902
WA09,5p,13,G>T,1527,1740,3267,4741530,4881708,9623238,0.0003394907202752
WA09,5p,14,G>T,1477,1389,2866,4741498,4881705,9623203,0.00029782183749
WA09,5p,15,G>T,1634,1802,3436,4741496,4881672,9623168,0.000357054973996
WA09,5p,16,G>T,1501,1297,2798,4741451,4881636,9623087,0.000290759088014
WA09,5p,17,G>T,1398,1985,3383,4741476,4881638,9623114,0.0003515494049015
WA09,5p,18,G>T,1459,1452,2911,4741455,4881610,9623065,0.0003025023732043
WA09,5p,19,G>T,1569,1360,2929,4741379,4881580,9622959,0.0003043762318846
WA09,5p,20,G>T,1512,1346,2858,4741390,4881557,9622947,0.0002969984143111
WA09,5p,21,G>T,1709,1430,3139,4741379,4881587,9622966,0.0003261988039862
WA09,5p,22,G>T,1502,1581,3083,4741354,4881580,9622934,0.0003203804577689
WA09,5p,23,G>T,1441,1638,3079,4741312,4881565,9622877,0.0003199666794036
WA09,5p,24,G>T,1593,1895,3488,4741363,4881548,9622911,0.0003624682801285
WA09,5p,25,G>T,1692,1360,3052,4741301,4881503,9622804,0.0003171632717449
WA11,3p,1,G>T,57,61,118,9756642,10108269,19864911,5.94012225879089e-06
WA11,3p,2,G>T,167,46,213,9756642,10108269,19864911,1.072242407730898e-05
WA11,3p,3,G>T,139,98,237,9756642,10108269,19864911,1.1930584536724076e-05
WA11,3p,4,G>T,231,164,395,9756642,10108267,19864909,1.988430956315984e-05
WA11,3p,5,G>T,895,1313,2208,9756642,10108269,19864911,0.0001111507622661
WA11,3p,6,G>T,847,1057,1904,9756642,10108269,19864911,9.584739644693095e-05
WA11,3p,7,G>T,912,1177,2089,9756642,10108265,19864907,0.0001051603211633
WA11,3p,8,G>T,1191,1234,2425,9756629,10108160,19864789,0.0001220752961433
WA11,3p,9,G>T,1102,1933,3035,9756610,10108092,19864702,0.0001527835655425
WA11,3p,10,G>T,1351,1945,3296,9756615,10107969,19864584,0.0001659234343895
WA11,3p,11,G>T,1785,1928,3713,9756587,10107918,19864505,0.0001869163112798
WA11,3p,12,G>T,1154,2188,3342,9756581,10108019,19864600,0.0001682389778802
WA11,3p,13,G>T,1019,1715,2734,9756565,10107963,19864528,0.0001376322659164
WA11,3p,14,G>T,1225,1829,3054,9756515,10107914,19864429,0.000153742148843
WA11,3p,15,G>T,1252,2557,3809,9756471,10107972,19864443,0.0001917496503677
WA11,3p,16,G>T,1199,1865,3064,9756477,10108011,19864488,0.0001542451031207
WA11,3p,17,G>T,1205,1712,2917,9756469,10108044,19864513,0.0001468447779213
WA11,3p,18,G>T,1219,2253,3472,9756421,10108016,19864437,0.0001747847170297
WA11,3p,19,G>T,1278,1594,2872,9756438,10108000,19864438,0.0001445799775458
WA11,3p,20,G>T,1361,1587,2948,9756433,10107963,19864396,0.0001484062238791
WA11,3p,21,G>T,1384,1701,3085,9756421,10107904,19864325,0.0001553035403921
WA11,3p,22,G>T,1364,1883,3247,9756405,10107842,19864247,0.0001634595059153
WA11,3p,23,G>T,1445,1527,2972,9756375,10107816,19864191,0.0001496159596935
WA11,3p,24,G>T,1363,1842,3205,9756358,10107704,19864062,0.0001613466570935
WA11,3p,25,G>T,1264,1612,2876,9756281,10107693,19863974,0.0001447847243456
WA11,5p,1,G>T,47,45,92,9756641,10108269,19864910,4.631281994230027e-06
WA11,5p,2,G>T,787,100,887,9756471,10108196,19864667,4.4652145439941176e-05
WA11,5p,3,G>T,254,136,390,9756642,10108269,19864911,1.963260746549532e-05
WA11,5p,4,G>T,523,362,885,9756638,10108269,19864907,4.4550925911709526e-05
WA11,5p,5,G>T,987,1227,2214,9756638,10108267,19864905,0.0001114528360442
WA11,5p,6,G>T,1326,1092,2418,9756642,10108269,19864911,0.000121722166286
WA11,5p,7,G>T,2054,2199,4253,9756629,10108269,19864898,0.000214096241521
WA11,5p,8,G>T,1712,1786,3498,9756500,10108261,19864761,0.0001760907166212
WA11,5p,9,G>T,2685,1919,4604,9756493,10108240,19864733,0.0002317675248894
WA11,5p,10,G>T,1730,1825,3555,9756446,10108197,19864643,0.0001789611824385
WA11,5p,11,G>T,1681,1225,2906,9756457,10108195,19864652,0.000146290002966
WA11,5p,12,G>T,1746,1617,3363,9756411,10108221,19864632,0.0001692958621131
WA11,5p,13,G>T,1674,2110,3784,9756334,10108178,19864512,0.0001904904585624
WA11,5p,14,G>T,1639,1859,3498,9756261,10108167,19864428,0.0001760936685415
WA11,5p,15,G>T,1650,1950,3600,9756237,10108096,19864333,0.0001812293420574
WA11,5p,16,G>T,1527,1945,3472,9756275,10108079,19864354,0.0001747854473394
WA11,5p,17,G>T,1779,1589,3368,9756369,10108078,19864447,0.0001695491447609
WA11,5p,18,G>T,1564,2417,3981,9756327,10108075,19864402,0.0002004087512928
WA11,5p,19,G>T,1603,2327,3930,9756284,10108088,19864372,0.00019784164332
WA11,5p,20,G>T,1414,2200,3614,9756292,10108082,19864374,0.0001819337473207
WA11,5p,21,G>T,1880,2191,4071,9756251,10108036,19864287,0.0002049406555593
WA11,5p,22,G>T,2171,1661,3832,9756136,10108029,19864165,0.0001929101978361
WA11,5p,23,G>T,1799,2501,4300,9756095,10108016,19864111,0.0002164708000272
WA11,5p,24,G>T,1501,1910,3411,9756046,10108010,19864056,0.0001717171961255
WA11,5p,25,G>T,1734,4881,6615,9756056,10107943,19863999,0.0003330145153551
WA12,3p,1,G>T,31,27,58,6632243,6940679,13572922,4.273213977064039e-06
WA12,3p,2,G>T,68,107,175,6632243,6940679,13572922,1.2893318034244947e-05
WA12,3p,3,G>T,71,129,200,6632243,6940679,13572922,1.4735220610565654e-05
WA12,3p,4,G>T,124,125,249,6632243,6940676,13572919,1.834535371499675e-05
WA12,3p,5,G>T,791,903,1694,6632243,6940678,13572921,0.0001248073277668
WA12,3p,6,G>T,792,1011,1803,6632243,6940679,13572922,0.0001328380138042
WA12,3p,7,G>T,806,1007,1813,6632243,6940676,13572919,0.0001335748043585
WA12,3p,8,G>T,922,1036,1958,6632240,6940664,13572904,0.000144258001088
WA12,3p,9,G>T,1080,1457,2537,6632231,6940656,13572887,0.0001869167554404
WA12,3p,10,G>T,1179,1149,2328,6632228,6940644,13572872,0.000171518599748
WA12,3p,11,G>T,964,1131,2095,6632231,6940642,13572873,0.0001543519931262
WA12,3p,12,G>T,1089,1312,2401,6632223,6940615,13572838,0.0001768974182112
WA12,3p,13,G>T,965,1288,2253,6632204,6940591,13572795,0.0001659938133597
WA12,3p,14,G>T,1044,1355,2399,6632209,6940533,13572742,0.0001767513152463
WA12,3p,15,G>T,1038,1383,2421,6632188,6940474,13572662,0.000178373262371
WA12,3p,16,G>T,1049,1345,2394,6632187,6940478,13572665,0.0001763839304955
WA12,3p,17,G>T,1009,1258,2267,6632168,6940473,13572641,0.000167027183582
WA12,3p,18,G>T,1085,1678,2763,6632160,6940482,13572642,0.0002035712722696
WA12,3p,19,G>T,1106,1439,2545,6632121,6940435,13572556,0.0001875107385815
WA12,3p,20,G>T,949,1399,2348,6632105,6940432,13572537,0.0001729963970626
WA12,3p,21,G>T,1141,1183,2324,6632096,6940454,13572550,0.0001712279564267
WA12,3p,22,G>T,1185,1201,2386,6632039,6940438,13572477,0.0001757969455391
WA12,3p,23,G>T,1074,1167,2241,6631950,6940459,13572409,0.0001651143875785
WA12,3p,24,G>T,1061,1562,2623,6631933,6940411,13572344,0.0001932606482712
WA12,3p,25,G>T,1130,1225,2355,6631986,6940428,13572414,0.0001735137168671
WA12,5p,1,G>T,27,28,55,6632243,6940679,13572922,4.052185667905555e-06
WA12,5p,2,G>T,175,56,231,6631949,6940524,13572473,1.701974282800194e-05
WA12,5p,3,G>T,130,89,219,6632242,6940678,13572920,1.6135068946107396e-05
WA12,5p,4,G>T,174,157,331,6632242,6940679,13572921,2.4386791907209956e-05
WA12,5p,5,G>T,680,1004,1684,6632242,6940677,13572919,0.000124070584964
WA12,5p,6,G>T,801,920,1721,6632242,6940679,13572921,0.0001267965826957
WA12,5p,7,G>T,1342,1836,3178,6632238,6940679,13572917,0.0002341427417555
WA12,5p,8,G>T,978,1350,2328,6632204,6940670,13572874,0.0001715185744743
WA12,5p,9,G>T,1193,1435,2628,6632209,6940675,13572884,0.0001936213409029
WA12,5p,10,G>T,1192,1368,2560,6632199,6940665,13572864,0.000188611629793
WA12,5p,11,G>T,774,1024,1798,6632166,6940667,13572833,0.000132470501921
WA12,5p,12,G>T,1172,1972,3144,6632126,6940660,13572786,0.0002316399890192
WA12,5p,13,G>T,1147,1726,2873,6632065,6940658,13572723,0.0002116745475465
WA12,5p,14,G>T,950,1706,2656,6632026,6940638,13572664,0.0001956874494203
WA12,5p,15,G>T,1104,1256,2360,6631987,6940631,13572618,0.0001738794976768
WA12,5p,16,G>T,1149,1531,2680,6631930,6940590,13572520,0.000197457804446
WA12,5p,17,G>T,1032,1359,2391,6631958,6940621,13572579,0.000176164014223
WA12,5p,18,G>T,1209,1652,2861,6632019,6940577,13572596,0.0002107923937321
WA12,5p,19,G>T,1041,1440,2481,6631996,6940532,13572528,0.0001827957179384
WA12,5p,20,G>T,1026,1394,2420,6631973,6940532,13572505,0.0001783016473377
WA12,5p,21,G>T,1078,1456,2534,6631936,6940534,13572470,0.000186701462593
WA12,5p,22,G>T,1211,1434,2645,6631921,6940529,13572450,0.0001948800695526
WA12,5p,23,G>T,1162,1598,2760,6631926,6940534,13572460,0.0002033529662271
WA12,5p,24,G>T,1134,1518,2652,6631934,6940518,13572452,0.0001953957914163
WA12,5p,25,G>T,1117,1412,2529,6631933,6940515,13572448,0.0001863333718427
WA13,3p,1,G>T,27,20,47,5896847,6081528,11978375,3.923737568743674e-06
WA13,3p,2,G>T,24,26,50,5896847,6081528,11978375,4.174188902918802e-06
WA13,3p,3,G>T,25,29,54,5896847,6081528,11978375,4.5081240151523055e-06
WA13,3p,4,G>T,223,49,272,5896847,6081522,11978369,2.2707599006175216e-05
WA13,3p,5,G>T,288,121,409,5896847,6081527,11978374,3.414486807641838e-05
WA13,3p,6,G>T,96,60,156,5896847,6081528,11978375,1.302346937710666e-05
WA13,3p,7,G>T,132,82,214,5896847,6081528,11978375,1.786552850449247e-05
WA13,3p,8,G>T,129,71,200,5896845,6081521,11978366,1.669676815685879e-05
WA13,3p,9,G>T,108,165,273,5896842,6081517,11978359,2.279110185293328e-05
WA13,3p,10,G>T,163,109,272,5896843,6081517,11978360,2.270761606764198e-05
WA13,3p,11,G>T,109,141,250,5896841,6081492,11978333,2.087101769503319e-05
WA13,3p,12,G>T,117,120,237,5896836,6081505,11978341,1.978571156055751e-05
WA13,3p,13,G>T,159,101,260,5896834,6081495,11978329,2.170586565121061e-05
WA13,3p,14,G>T,284,99,383,5896832,6081501,11978333,3.1974399108790846e-05
WA13,3p,15,G>T,203,142,345,5896825,6081505,11978330,2.8802011632673337e-05
WA13,3p,16,G>T,163,145,308,5896830,6081509,11978339,2.5713080920484885e-05
WA13,3p,17,G>T,145,164,309,5896823,6081499,11978322,2.579660156071944e-05
WA13,3p,18,G>T,146,132,278,5896827,6081499,11978326,2.320858523970712e-05
WA13,3p,19,G>T,155,103,258,5896822,6081480,11978302,2.153894600419993e-05
WA13,3p,20,G>T,214,119,333,5896818,6081448,11978266,2.7800351069178128e-05
WA13,3p,21,G>T,153,148,301,5896824,6081466,11978290,2.512879551254812e-05
WA13,3p,22,G>T,168,161,329,5896824,6081460,11978284,2.7466371643884884e-05
WA13,3p,23,G>T,183,121,304,5896819,6081454,11978273,2.5379284643120088e-05
WA13,3p,24,G>T,169,137,306,5896803,6081440,11978243,2.554631760267345e-05
WA13,3p,25,G>T,150,231,381,5896783,6081437,11978220,3.180773103182276e-05
WA13,5p,1,G>T,39,24,63,5896847,6081528,11978375,5.25947801767769e-06
WA13,5p,2,G>T,148,79,227,5896725,6081443,11978168,1.8951145116682284e-05
WA13,5p,3,G>T,98,21,119,5896847,6081528,11978375,9.934569588946748e-06
WA13,5p,4,G>T,84,32,116,5896841,6081528,11978369,9.684123105574724e-06
WA13,5p,5,G>T,141,82,223,5896841,6081528,11978369,1.861689183226865e-05
WA13,5p,6,G>T,232,8687,8919,5896841,6081528,11978369,0.0007445921894708
WA13,5p,7,G>T,241,201,442,5896845,6081528,11978373,3.6899836062877655e-05
WA13,5p,8,G>T,296,270,566,5896843,6081526,11978369,4.72518420496146e-05
WA13,5p,9,G>T,283,149,432,5896837,6081518,11978355,3.606505233815495e-05
WA13,5p,10,G>T,259,209,468,5896833,6081518,11978351,3.907048641336358e-05
WA13,5p,11,G>T,140,125,265,5896827,6081513,11978340,2.212326582815315e-05
WA13,5p,12,G>T,152,153,305,5896822,6081502,11978324,2.546266071947962e-05
WA13,5p,13,G>T,168,121,289,5896809,6081508,11978317,2.412692868288592e-05
WA13,5p,14,G>T,150,146,296,5896802,6081520,11978322,2.4711307643925415e-05
WA13,5p,15,G>T,162,184,346,5896798,6081508,11978306,2.888555359998317e-05
WA13,5p,16,G>T,185,154,339,5896754,6081491,11978245,2.8301307912803587e-05
WA13,5p,17,G>T,175,155,330,5896805,6081514,11978319,2.754977555698759e-05
WA13,5p,18,G>T,218,135,353,5896796,6081504,11978300,2.946995817436531e-05
WA13,5p,19,G>T,164,158,322,5896797,6081472,11978269,2.6882014421282407e-05
WA13,5p,20,G>T,206,116,322,5896788,6081482,11978270,2.688201217705061e-05
WA13,5p,21,G>T,196,234,430,5896782,6081484,11978266,3.589835123047025e-05
WA13,5p,22,G>T,174,142,316,5896771,6081483,11978254,2.6381140356516062e-05
WA13,5p,23,G>T,138,218,356,5896768,6081501,11978269,2.9720487993715952e-05
WA13,5p,24,G>T,236,228,464,5896781,6081498,11978279,3.873678347281776e-05
WA13,5p,25,G>T,123,213,336,5896769,6081462,11978231,2.805088664594964e-05
WA14,3p,1,G>T,35,23,58,6684341,7140972,13825313,4.195203392501855e-06
WA14,3p,2,G>T,77,49,126,6684341,7140972,13825313,9.113717714745409e-06
WA14,3p,3,G>T,100,83,183,6684341,7140972,13825313,1.3236590014273095e-05
WA14,3p,4,G>T,210,121,331,6684341,7140971,13825312,2.394159350617187e-05
WA14,3p,5,G>T,923,837,1760,6684341,7140970,13825311,0.0001273027420504
WA14,3p,6,G>T,1083,699,1782,6684341,7140971,13825312,0.000128894017003
WA14,3p,7,G>T,910,753,1663,6684341,7140969,13825310,0.0001202866337174
WA14,3p,8,G>T,863,1123,1986,6684326,7140932,13825258,0.000143650122117
WA14,3p,9,G>T,976,1028,2004,6684323,7140920,13825243,0.000144952244239
WA14,3p,10,G>T,1419,1148,2567,6684256,7140912,13825168,0.0001856758630347
WA14,3p,11,G>T,1059,1291,2350,6684256,7140894,13825150,0.0001699800725489
WA14,3p,12,G>T,1212,1080,2292,6684291,7140849,13825140,0.00016578493961
WA14,3p,13,G>T,1020,965,1985,6684289,7140794,13825083,0.0001435796081658
WA14,3p,14,G>T,1064,961,2025,6684291,7140742,13825033,0.000146473429756
WA14,3p,15,G>T,848,1358,2206,6684271,7140702,13824973,0.000159566315247
WA14,3p,16,G>T,1023,1351,2374,6684263,7140648,13824911,0.0001717190078113
WA14,3p,17,G>T,1138,1370,2508,6684212,7140653,13824865,0.0001814122597218
WA14,3p,18,G>T,1182,1320,2502,6684177,7140647,13824824,0.000180978795824
WA14,3p,19,G>T,1250,1121,2371,6684172,7140542,13824714,0.0001715044520993
WA14,3p,20,G>T,1437,1016,2453,6684176,7140544,13824720,0.0001774357817011
WA14,3p,21,G>T,1028,937,1965,6684132,7140443,13824575,0.0001421381850798
WA14,3p,22,G>T,1123,1089,2212,6684105,7140560,13824665,0.0001600038771283
WA14,3p,23,G>T,926,1495,2421,6683638,7140562,13824200,0.0001751276746574
WA14,3p,24,G>T,1092,1127,2219,6683623,7140532,13824155,0.0001605161400461
WA14,3p,25,G>T,1301,1042,2343,6683613,7140513,13824126,0.0001694863024251
WA14,5p,1,G>T,18,61,79,6684341,7140972,13825313,5.714156344959424e-06
WA14,5p,2,G>T,598,289,887,6684184,7140911,13825095,6.415869113376798e-05
WA14,5p,3,G>T,162,155,317,6684338,7140972,13825310,2.292896144824239e-05
WA14,5p,4,G>T,379,417,796,6684341,7140972,13825313,5.7575550007439255e-05
WA14,5p,5,G>T,542,888,1430,6684341,7140972,13825313,0.000103433462953
WA14,5p,6,G>T,902,1165,2067,6684340,7140972,13825312,0.0001495083799917
WA14,5p,7,G>T,1428,2610,4038,6684336,7140972,13825308,0.0002920730590595
WA14,5p,8,G>T,1081,1498,2579,6684277,7140970,13825247,0.000186542779308
WA14,5p,9,G>T,1117,1857,2974,6684241,7140959,13825200,0.0002151144287243
WA14,5p,10,G>T,1039,1563,2602,6684210,7140628,13824838,0.0001882119703681
WA14,5p,11,G>T,1076,1227,2303,6684218,7140646,13824864,0.0001665839172088
WA14,5p,12,G>T,1187,1337,2524,6684139,7140917,13825056,0.0001825670724227
WA14,5p,13,G>T,1383,1809,3192,6684018,7140931,13824949,0.0002308869276841
WA14,5p,14,G>T,1161,1613,2774,6683951,7140942,13824893,0.0002006525475459
WA14,5p,15,G>T,1312,1425,2737,6684030,7140908,13824938,0.0001979755713913
WA14,5p,16,G>T,1103,1170,2273,6683910,7140868,13824778,0.0001644149367172
WA14,5p,17,G>T,1051,1252,2303,6683904,7140873,13824777,0.0001665849655296
WA14,5p,18,G>T,1234,1119,2353,6683891,7140646,13824537,0.0001702046151708
WA14,5p,19,G>T,1070,1017,2087,6683958,7140595,13824553,0.0001509632897352
WA14,5p,20,G>T,1089,1901,2990,6683860,7140558,13824418,0.0002162839694227
WA14,5p,21,G>T,1145,1379,2524,6683480,7140494,13823974,0.0001825813619151
WA14,5p,22,G>T,1007,2516,3523,6683768,7140398,13824166,0.0002548435833308
WA14,5p,23,G>T,1041,2371,3412,6683762,7140257,13824019,0.0002468167903993
WA14,5p,24,G>T,1139,2334,3473,6683714,7140421,13824135,0.0002512272919788
WA14,5p,25,G>T,1499,2908,4407,6683731,7140511,13824242,0.000318787822146
WA18,3p,1,G>T,97,39,136,14112928,14131239,28244167,4.81515351470624e-06
WA18,3p,2,G>T,415,42,457,14112928,14131239,28244167,1.618033203103494e-05
WA18,3p,3,G>T,296,124,420,14112928,14131239,28244167,1.4870327030710448e-05
WA18,3p,4,G>T,375,384,759,14112928,14131238,28244166,2.687280622837297e-05
WA18,3p,5,G>T,1362,1364,2726,14112928,14131239,28244167,9.651550353742068e-05
WA18,3p,6,G>T,1776,2077,3853,14112928,14131239,28244167,0.0001364175477364
WA18,3p,7,G>T,1849,1710,3559,14112928,14131237,28244165,0.0001260083277377
WA18,3p,8,G>T,1584,1563,3147,14112927,14131187,28244114,0.0001114214451903
WA18,3p,9,G>T,1877,2659,4536,14112909,14131177,28244086,0.0001605999925081
WA18,3p,10,G>T,1630,2024,3654,14112909,14131197,28244106,0.000129372124577
WA18,3p,11,G>T,1645,2052,3697,14112900,14131167,28244067,0.0001308947468507
WA18,3p,12,G>T,2081,2129,4210,14112895,14131136,28244031,0.0001490580434499
WA18,3p,13,G>T,1955,2659,4614,14112898,14131061,28243959,0.0001633623671525
WA18,3p,14,G>T,2461,2536,4997,14112830,14131006,28243836,0.0001769235595334
WA18,3p,15,G>T,1702,2293,3995,14112809,14130957,28243766,0.0001414471427075
WA18,3p,16,G>T,1955,2005,3960,14112765,14130927,28243692,0.0001402082985468
WA18,3p,17,G>T,2128,2025,4153,14112743,14130850,28243593,0.0001470421982075
WA18,3p,18,G>T,1996,2610,4606,14112708,14130769,28243477,0.0001630819038321
WA18,3p,19,G>T,2217,2499,4716,14112724,14130771,28243495,0.0001669765020228
WA18,3p,20,G>T,1745,2500,4245,14112697,14130797,28243494,0.0001503001009719
WA18,3p,21,G>T,1867,2359,4226,14112659,14130783,28243442,0.0001496276551561
WA18,3p,22,G>T,2207,2316,4523,14112575,14130715,28243290,0.0001601442324884
WA18,3p,23,G>T,2238,2440,4678,14112548,14130648,28243196,0.0001656328129436
WA18,3p,24,G>T,2427,2901,5328,14112551,14130690,28243241,0.0001886469049355
WA18,3p,25,G>T,2178,2883,5061,14112486,14130651,28243137,0.0001791939755134
WA18,5p,1,G>T,56,83,139,14112926,14131239,28244165,4.9213704848417365e-06
WA18,5p,2,G>T,1647,490,2137,14112820,14131183,28244003,7.566207948639575e-05
WA18,5p,3,G>T,492,243,735,14112928,14131239,28244167,2.602307230374328e-05
WA18,5p,4,G>T,980,1252,2232,14112928,14131239,28244167,7.902516650606123e-05
WA18,5p,5,G>T,1295,1550,2845,14112925,14131239,28244164,0.0001007287735618
WA18,5p,6,G>T,1884,1521,3405,14112927,14131239,28244166,0.0001205558698387
WA18,5p,7,G>T,2745,2356,5101,14112921,14131239,28244160,0.0001806037071026
WA18,5p,8,G>T,2125,2231,4356,14112828,14131230,28244058,0.0001542271298267
WA18,5p,9,G>T,2321,2698,5019,14112833,14131230,28244063,0.0001777010623436
WA18,5p,10,G>T,2260,2132,4392,14112791,14131213,28244004,0.0001555020315108
WA18,5p,11,G>T,1502,1600,3102,14112776,14131211,28243987,0.0001098286867218
WA18,5p,12,G>T,2158,2315,4473,14112682,14131223,28243905,0.0001583704519612
WA18,5p,13,G>T,2198,3322,5520,14112608,14131206,28243814,0.0001954410264845
WA18,5p,14,G>T,1980,2268,4248,14112535,14131179,28243714,0.000150405148558
WA18,5p,15,G>T,2342,2769,5111,14112545,14131148,28243693,0.0001809607546718
WA18,5p,16,G>T,2106,2435,4541,14112522,14131083,28243605,0.0001607797588161
WA18,5p,17,G>T,2081,2855,4936,14112485,14130990,28243475,0.0001747660300299
WA18,5p,18,G>T,2408,2121,4529,14112481,14130987,28243468,0.0001603556617055
WA18,5p,19,G>T,2309,2815,5124,14112359,14130867,28243226,0.0001814240342091
WA18,5p,20,G>T,2069,3714,5783,14112397,14130866,28243263,0.0002047567945672
WA18,5p,21,G>T,2500,3343,5843,14112347,14130679,28243026,0.0002068829310287
WA18,5p,22,G>T,2245,2105,4350,14112376,14129592,28241968,0.0001540260933657
WA18,5p,23,G>T,2168,2308,4476,14112288,14129275,28241563,0.0001584898116297
WA18,5p,24,G>T,2349,2622,4971,14112253,14129481,28241734,0.0001760161043935
WA18,5p,25,G>T,2508,2746,5254,14112273,14130551,28242824,0.0001860295556846
WA22,3p,1,G>T,4,5,9,1513709,1653397,3167106,2.841711013145755e-06
WA22,3p,2,G>T,5,20,25,1513709,1653396,3167105,7.893644195566613e-06
WA22,3p,3,G>T,19,27,46,1513709,1653396,3167105,1.452430531984257e-05
WA22,3p,4,G>T,12,17,29,1513709,1653394,3167103,9.156633049193536e-06
WA22,3p,5,G>T,107,97,204,1513709,1653397,3167106,6.441211629797045e-05
WA22,3p,6,G>T,81,87,168,1513709,1653397,3167106,5.304527224538743e-05
WA22,3p,7,G>T,90,54,144,1513709,1653397,3167106,4.546737621033208e-05
WA22,3p,8,G>T,165,69,234,1513709,1653395,3167104,7.388453299923211e-05
WA22,3p,9,G>T,170,76,246,1513709,1653397,3167106,7.767343435931731e-05
WA22,3p,10,G>T,166,105,271,1513706,1653396,3167102,8.556718413237085e-05
WA22,3p,11,G>T,249,94,343,1513685,1653390,3167075,0.0001083018242384
WA22,3p,12,G>T,116,80,196,1513662,1653379,3167041,6.1887421097485e-05
WA22,3p,13,G>T,189,78,267,1513689,1653380,3167069,8.430507829163179e-05
WA22,3p,14,G>T,155,114,269,1513686,1653352,3167038,8.493740839232116e-05
WA22,3p,15,G>T,217,162,379,1513677,1653343,3167020,0.0001196708577779
WA22,3p,16,G>T,179,73,252,1513637,1653341,3166978,7.957112427051909e-05
WA22,3p,17,G>T,212,96,308,1513671,1653319,3166990,9.725322782831647e-05
WA22,3p,18,G>T,212,182,394,1513665,1653288,3166953,0.0001244098033662
WA22,3p,19,G>T,307,104,411,1513662,1653275,3166937,0.0001297783947075
WA22,3p,20,G>T,210,140,350,1513684,1653304,3166988,0.0001105151014149
WA22,3p,21,G>T,259,139,398,1513677,1653327,3167004,0.0001256708232765
WA22,3p,22,G>T,240,120,360,1513684,1653356,3167040,0.0001136708093361
WA22,3p,23,G>T,264,151,415,1513676,1653329,3167005,0.0001310386311357
WA22,3p,24,G>T,120,186,306,1513672,1653285,3166957,9.662272016955075e-05
WA22,3p,25,G>T,208,166,374,1513669,1653296,3166965,0.000118094137447
WA22,5p,1,G>T,6,6,12,1513709,1653397,3167106,3.7889480175276734e-06
WA22,5p,2,G>T,91,3,94,1513674,1653378,3167052,2.9680598866074823e-05
WA22,5p,3,G>T,27,20,47,1513709,1653397,3167106,1.4840046401983388e-05
WA22,5p,4,G>T,61,61,122,1513709,1653397,3167106,3.852097151153135e-05
WA22,5p,5,G>T,51,94,145,1513708,1653396,3167104,4.578315079012246e-05
WA22,5p,6,G>T,191,116,307,1513704,1653397,3167101,9.693407314765145e-05
WA22,5p,7,G>T,224,116,340,1513707,1653397,3167104,0.0001073535949561
WA22,5p,8,G>T,236,195,431,1513692,1653397,3167089,0.0001360871134344
WA22,5p,9,G>T,224,97,321,1513700,1653389,3167089,0.0001013549035091
WA22,5p,10,G>T,204,179,383,1513705,1653389,3167094,0.0001209310490942
WA22,5p,11,G>T,146,86,232,1513699,1653381,3167080,7.325359637268398e-05
WA22,5p,12,G>T,192,73,265,1513692,1653345,3167037,8.367442502250527e-05
WA22,5p,13,G>T,193,58,251,1513697,1653377,3167074,7.925296346091061e-05
WA22,5p,14,G>T,144,82,226,1513677,1653376,3167053,7.135971516738116e-05
WA22,5p,15,G>T,229,164,393,1513695,1653381,3167076,0.000124089222993
WA22,5p,16,G>T,192,172,364,1513668,1653368,3167036,0.0001149339634914
WA22,5p,17,G>T,314,74,388,1513675,1653395,3167070,0.0001225107117935
WA22,5p,18,G>T,277,127,404,1513651,1653392,3167043,0.0001275637874193
WA22,5p,19,G>T,177,121,298,1513674,1653350,3167024,9.409464532002284e-05
WA22,5p,20,G>T,228,87,315,1513678,1653356,3167034,9.946214660152056e-05
WA22,5p,21,G>T,488,194,682,1513690,1653371,3167061,0.0002153416053558
WA22,5p,22,G>T,195,124,319,1513691,1653380,3167071,0.0001007239812432
WA22,5p,23,G>T,190,139,329,1513634,1653393,3167027,0.0001038829160597
WA22,5p,24,G>T,204,168,372,1513632,1653375,3167007,0.0001174610602376
WA22,5p,25,G>T,176,211,387,1513644,1653364,3167008,0.0001221973547272
WA25,3p,1,G>T,20,10,30,3375244,3569089,6944333,4.320069328472584e-06
WA25,3p,2,G>T,174,24,198,3375244,3569089,6944333,2.851245756791905e-05
WA25,3p,3,G>T,46,39,85,3375244,3569089,6944333,1.224019643067232e-05
WA25,3p,4,G>T,156,107,263,3375244,3569087,6944331,3.787261868709887e-05
WA25,3p,5,G>T,253,155,408,3375244,3569089,6944333,5.8752942867227134e-05
WA25,3p,6,G>T,360,239,599,3375244,3569089,6944333,8.625738425850258e-05
WA25,3p,7,G>T,441,259,700,3375244,3569089,6944333,0.0001008016176643
WA25,3p,8,G>T,611,445,1056,3375239,3569076,6944315,0.0001520668345257
WA25,3p,9,G>T,374,332,706,3375240,3569076,6944316,0.0001016658804121
WA25,3p,10,G>T,559,359,918,3375240,3569075,6944315,0.0001321944641048
WA25,3p,11,G>T,357,381,738,3375233,3569054,6944287,0.0001062744094534
WA25,3p,12,G>T,778,433,1211,3375226,3569069,6944295,0.0001743877528244
WA25,3p,13,G>T,443,549,992,3375230,3569053,6944283,0.0001428513210075
WA25,3p,14,G>T,416,490,906,3375223,3569037,6944260,0.0001304674652158
WA25,3p,15,G>T,352,387,739,3375218,3569039,6944257,0.0001064188724582
WA25,3p,16,G>T,327,382,709,3375196,3569030,6944226,0.0001020992116328
WA25,3p,17,G>T,362,406,768,3375198,3569022,6944220,0.0001105955744489
WA25,3p,18,G>T,318,475,793,3375213,3569006,6944219,0.0001141957072494
WA25,3p,19,G>T,418,591,1009,3375204,3569005,6944209,0.0001453009262826
WA25,3p,20,G>T,395,336,731,3375190,3568979,6944169,0.0001052681753569
WA25,3p,21,G>T,499,444,943,3375199,3568998,6944197,0.0001357968387129
WA25,3p,22,G>T,517,527,1044,3375179,3568994,6944173,0.0001503418765632
WA25,3p,23,G>T,616,832,1448,3375175,3568972,6944147,0.0002085209313685
WA25,3p,24,G>T,584,543,1127,3375177,3568962,6944139,0.0001622951383893
WA25,3p,25,G>T,532,613,1145,3375156,3568970,6944126,0.000164887561084
WA25,5p,1,G>T,32,16,48,3375244,3569089,6944333,6.912110925556133e-06
WA25,5p,2,G>T,215,40,255,3375147,3569045,6944192,3.6721334893966064e-05
WA25,5p,3,G>T,136,33,169,3375243,3569089,6944332,2.4336394054892536e-05
WA25,5p,4,G>T,228,154,382,3375243,3569089,6944332,5.500889070395828e-05
WA25,5p,5,G>T,421,264,685,3375244,3569088,6944332,9.864159720474194e-05
WA25,5p,6,G>T,694,282,976,3375244,3569089,6944333,0.0001405462554863
WA25,5p,7,G>T,769,426,1195,3375242,3569089,6944331,0.0001720828111448
WA25,5p,8,G>T,601,392,993,3375221,3569088,6944309,0.0001429947889703
WA25,5p,9,G>T,581,418,999,3375227,3569087,6944314,0.0001438587022418
WA25,5p,10,G>T,687,671,1358,3375217,3569085,6944302,0.0001955560112449
WA25,5p,11,G>T,298,323,621,3375193,3569088,6944281,8.942610473280098e-05
WA25,5p,12,G>T,343,652,995,3375142,3569084,6944226,0.0001432845071574
WA25,5p,13,G>T,386,746,1132,3375133,3569081,6944214,0.0001630134094369
WA25,5p,14,G>T,401,557,958,3375151,3569071,6944222,0.00013795641902
WA25,5p,15,G>T,446,456,902,3375137,3569055,6944192,0.0001298927218602
WA25,5p,16,G>T,388,474,862,3375081,3569035,6944116,0.0001241338710355
WA25,5p,17,G>T,548,465,1013,3375076,3568871,6943947,0.0001458824498516
WA25,5p,18,G>T,810,326,1136,3375102,3568996,6944098,0.0001635921612857
WA25,5p,19,G>T,522,495,1017,3375134,3569021,6944155,0.000146454104207
WA25,5p,20,G>T,615,525,1140,3375145,3569019,6944164,0.0001641666297051
WA25,5p,21,G>T,475,641,1116,3375130,3569013,6944143,0.000160710976142
WA25,5p,22,G>T,433,581,1014,3375139,3569001,6944140,0.000146022401622
WA25,5p,23,G>T,536,353,889,3375144,3569002,6944146,0.000128021501852
WA25,5p,24,G>T,566,378,944,3375124,3568967,6944091,0.0001359429189508
WA25,5p,25,G>T,448,429,877,3375125,3568950,6944075,0.000126294718879
WA26,3p,1,G>T,11,6,17,2709623,2900126,5609749,3.030438616772337e-06
WA26,3p,2,G>T,29,8,37,2709623,2900126,5609749,6.595660518857439e-06
WA26,3p,3,G>T,25,22,47,2709623,2900126,5609749,8.37827146989999e-06
WA26,3p,4,G>T,70,75,145,2709623,2900126,5609749,2.584785879011699e-05
WA26,3p,5,G>T,278,146,424,2709623,2900126,5609749,7.558270432420417e-05
WA26,3p,6,G>T,398,153,551,2709623,2900126,5609749,9.822186340244456e-05
WA26,3p,7,G>T,482,219,701,2709623,2900126,5609749,0.000124961027668
WA26,3p,8,G>T,348,229,577,2709619,2900114,5609733,0.0001028569452414
WA26,3p,9,G>T,351,232,583,2709613,2900111,5609724,0.0001039266815978
WA26,3p,10,G>T,326,274,600,2709609,2900074,5609683,0.0001069579154472
WA26,3p,11,G>T,607,297,904,2709594,2900076,5609670,0.0001611502993937
WA26,3p,12,G>T,305,376,681,2709607,2900081,5609688,0.0001213971258294
WA26,3p,13,G>T,265,253,518,2709604,2900084,5609688,9.234025136513833e-05
WA26,3p,14,G>T,295,238,533,2709584,2900069,5609653,9.501478968485216e-05
WA26,3p,15,G>T,282,289,571,2709593,2900082,5609675,0.0001017884280283
WA26,3p,16,G>T,288,422,710,2709580,2900075,5609655,0.0001265674983577
WA26,3p,17,G>T,338,310,648,2709570,2900078,5609648,0.0001155152694072
WA26,3p,18,G>T,357,284,641,2709582,2900059,5609641,0.0001142675618635
WA26,3p,19,G>T,401,337,738,2709567,2900016,5609583,0.000131560581241
WA26,3p,20,G>T,498,389,887,2709563,2899983,5609546,0.0001581233133661
WA26,3p,21,G>T,500,573,1073,2709562,2900021,5609583,0.0001912798152732
WA26,3p,22,G>T,367,370,737,2709522,2900007,5609529,0.0001313835796196
WA26,3p,23,G>T,486,368,854,2709541,2899974,5609515,0.0001522413256761
WA26,3p,24,G>T,403,367,770,2709558,2899951,5609509,0.0001372669158744
WA26,3p,25,G>T,376,313,689,2709500,2900002,5609502,0.0001228273026732
WA26,5p,1,G>T,34,14,48,2709622,2900126,5609748,8.556534090301383e-06
WA26,5p,2,G>T,161,25,186,2709554,2900092,5609646,3.315717248468085e-05
WA26,5p,3,G>T,97,52,149,2709623,2900126,5609749,2.656090317053401e-05
WA26,5p,4,G>T,122,47,169,2709623,2900126,5609749,3.0126125072619117e-05
WA26,5p,5,G>T,241,203,444,2709623,2900125,5609748,7.914794033528779e-05
WA26,5p,6,G>T,302,248,550,2709621,2900126,5609747,9.80436372620726e-05
WA26,5p,7,G>T,409,381,790,2709622,2900126,5609748,0.0001408262902362
WA26,5p,8,G>T,371,297,668,2709609,2900124,5609733,0.0001190787511633
WA26,5p,9,G>T,507,384,891,2709594,2900123,5609717,0.0001588315417693
WA26,5p,10,G>T,404,315,719,2709601,2900123,5609724,0.0001281702985744
WA26,5p,11,G>T,346,189,535,2709605,2900103,5609708,9.537038291476134e-05
WA26,5p,12,G>T,489,289,778,2709595,2900107,5609702,0.0001386882939592
WA26,5p,13,G>T,333,452,785,2709592,2900104,5609696,0.0001399362817521
WA26,5p,14,G>T,268,344,612,2709563,2900089,5609652,0.0001090976766473
WA26,5p,15,G>T,336,280,616,2709545,2900085,5609630,0.0001098111640161
WA26,5p,16,G>T,390,386,776,2709540,2900076,5609616,0.0001383338895211
WA26,5p,17,G>T,435,314,749,2709554,2900055,5609609,0.0001335208924543
WA26,5p,18,G>T,373,317,690,2709554,2900082,5609636,0.0001230026333259
WA26,5p,19,G>T,404,342,746,2709570,2900086,5609656,0.0001329849816102
WA26,5p,20,G>T,330,369,699,2709563,2900082,5609645,0.0001246068155828
WA26,5p,21,G>T,289,360,649,2709545,2900061,5609606,0.0001156943999275
WA26,5p,22,G>T,322,266,588,2709542,2900059,5609601,0.0001048202893574
WA26,5p,23,G>T,419,230,649,2709528,2900065,5609593,0.0001156946680445
WA26,5p,24,G>T,250,418,668,2709495,2900057,5609552,0.0001190825934049
WA26,5p,25,G>T,275,283,558,2709506,2900041,5609547,9.947327297551834e-05
