Sample,End,Position,Substitution,Pos_Count,Neg_Count,Combined_Count,Pos_Total,Neg_Total,Combined_Total,Frequency
DAL192,3p,1,G>C,21,4,25,6350003,6167708,12517711,1.997170249417006e-06
DAL192,3p,2,G>C,54,7,61,6350003,6167706,12517709,4.873096187169713e-06
DAL192,3p,3,G>C,37,23,60,6350003,6167708,12517711,4.793208598600814e-06
DAL192,3p,4,G>C,95,39,134,6350003,6167708,12517711,1.0704832536875153e-05
DAL192,3p,5,G>C,159,108,267,6350003,6167708,12517711,2.1329778263773626e-05
DAL192,3p,6,G>C,211,164,375,6350003,6167708,12517711,2.995755374125509e-05
DAL192,3p,7,G>C,252,135,387,6350003,6167708,12517711,3.091619546097525e-05
DAL192,3p,8,G>C,228,260,488,6350003,6167618,12517621,3.8985043563789e-05
DAL192,3p,9,G>C,284,343,627,6350003,6167637,12517640,5.008931396013945e-05
DAL192,3p,10,G>C,236,330,566,6350003,6167645,12517648,4.52161620138224e-05
DAL192,3p,11,G>C,249,261,510,6349987,6167644,12517631,4.0742533471389273e-05
DAL192,3p,12,G>C,420,288,708,6349997,6167646,12517643,5.656016871546824e-05
DAL192,3p,13,G>C,301,337,638,6349992,6167621,12517613,5.09681837903121e-05
DAL192,3p,14,G>C,419,369,788,6349967,6167610,12517577,6.295148014667695e-05
DAL192,3p,15,G>C,378,532,910,6349968,6167615,12517583,7.269774045037289e-05
DAL192,3p,16,G>C,392,729,1121,6349943,6167587,12517530,8.95544088969629e-05
DAL192,3p,17,G>C,338,284,622,6349922,6167606,12517528,4.969032224253862e-05
DAL192,3p,18,G>C,498,310,808,6349922,6167564,12517486,6.454970271187042e-05
DAL192,3p,19,G>C,506,295,801,6349921,6167519,12517440,6.399072014725055e-05
DAL192,3p,20,G>C,485,304,789,6349910,6167516,12517426,6.30321281707597e-05
DAL192,3p,21,G>C,617,496,1113,6349882,6167507,12517389,8.891630674735762e-05
DAL192,3p,22,G>C,553,404,957,6349894,6167488,12517382,7.645368656161489e-05
DAL192,3p,23,G>C,427,360,787,6349902,6167465,12517367,6.287264725880451e-05
DAL192,3p,24,G>C,514,429,943,6349899,6167465,12517364,7.533535015838799e-05
DAL192,3p,25,G>C,450,450,900,6349856,6167384,12517240,7.190083436923795e-05
DAL192,5p,1,G>C,5,8,13,6350003,6167708,12517711,1.0385285296968431e-06
DAL192,5p,2,G>C,154,36,190,6349992,6167694,12517686,1.5178524209666227e-05
DAL192,5p,3,G>C,38,30,68,6350003,6167707,12517710,5.432303512383655e-06
DAL192,5p,4,G>C,108,114,222,6350003,6167708,12517711,1.7734871814823014e-05
DAL192,5p,5,G>C,167,153,320,6350003,6167707,12517710,2.556378123474661e-05
DAL192,5p,6,G>C,190,146,336,6350002,6167707,12517709,2.6841972440803666e-05
DAL192,5p,7,G>C,141,149,290,6350002,6167708,12517710,2.316717674398912e-05
DAL192,5p,8,G>C,331,387,718,6349926,6167708,12517634,5.735908239528333e-05
DAL192,5p,9,G>C,294,453,747,6349914,6167708,12517622,5.967587134361463e-05
DAL192,5p,10,G>C,324,359,683,6349896,6167708,12517604,5.4563157613869234e-05
DAL192,5p,11,G>C,379,412,791,6349942,6167706,12517648,6.319078472249739e-05
DAL192,5p,12,G>C,332,364,696,6349906,6167700,12517606,5.56016861371096e-05
DAL192,5p,13,G>C,275,507,782,6349906,6167705,12517611,6.247198447051918e-05
DAL192,5p,14,G>C,322,254,576,6349889,6167679,12517568,4.601532821711055e-05
DAL192,5p,15,G>C,335,289,624,6349890,6167649,12517539,4.9850054391681946e-05
DAL192,5p,16,G>C,317,296,613,6349904,6167639,12517543,4.897127175836344e-05
DAL192,5p,17,G>C,407,286,693,6349778,6167623,12517401,5.536293037188791e-05
DAL192,5p,18,G>C,523,270,793,6349859,6167631,12517490,6.335135877879671e-05
DAL192,5p,19,G>C,352,257,609,6349822,6167638,12517460,4.865204282657984e-05
DAL192,5p,20,G>C,371,222,593,6349836,6167621,12517457,4.737383959058138e-05
DAL192,5p,21,G>C,344,306,650,6349784,6167624,12517408,5.192768343094673e-05
DAL192,5p,22,G>C,386,374,760,6349783,6167584,12517367,6.0715644112695584e-05
DAL192,5p,23,G>C,380,521,901,6349801,6167567,12517368,7.197998812529919e-05
DAL192,5p,24,G>C,386,528,914,6349759,6167564,12517323,7.301880761565392e-05
DAL192,5p,25,G>C,403,419,822,6349777,6167551,12517328,6.566896705111506e-05
DAL193,3p,1,G>C,25,15,40,6484405,6362696,12847101,3.113542891894444e-06
DAL193,3p,2,G>C,60,102,162,6484402,6362696,12847098,1.2609851656771048e-05
DAL193,3p,3,G>C,177,68,245,6484405,6362696,12847101,1.9070450212853467e-05
DAL193,3p,4,G>C,280,135,415,6484405,6362696,12847101,3.230300750340485e-05
DAL193,3p,5,G>C,930,971,1901,6484405,6362696,12847101,0.0001479711259372
DAL193,3p,6,G>C,941,1044,1985,6484405,6362696,12847101,0.0001545095660102
DAL193,3p,7,G>C,1278,1107,2385,6484405,6362696,12847101,0.0001856449949292
DAL193,3p,8,G>C,963,1050,2013,6484400,6362644,12847044,0.0001566897412354
DAL193,3p,9,G>C,1721,1575,3296,6484400,6362631,12847031,0.000256557332196
DAL193,3p,10,G>C,1416,1585,3001,6484393,6362640,12847033,0.0002335947918869
DAL193,3p,11,G>C,1111,1096,2207,6484398,6362639,12847037,0.000171790584864
DAL193,3p,12,G>C,1339,1399,2738,6484368,6362594,12846962,0.0002131243168618
DAL193,3p,13,G>C,1376,1293,2669,6484385,6362543,12846928,0.0002077539470914
DAL193,3p,14,G>C,1607,1279,2886,6484363,6362486,12846849,0.0002246465261637
DAL193,3p,15,G>C,1697,1336,3033,6484332,6362438,12846770,0.0002360904725467
DAL193,3p,16,G>C,1266,1329,2595,6484341,6362460,12846801,0.0002019958120313
DAL193,3p,17,G>C,1512,1342,2854,6484294,6362445,12846739,0.0002221575451949
DAL193,3p,18,G>C,1662,1477,3139,6484244,6362380,12846624,0.0002443443507025
DAL193,3p,19,G>C,1564,1377,2941,6484265,6362400,12846665,0.0002289310104996
DAL193,3p,20,G>C,1214,1213,2427,6484261,6362382,12846643,0.00018892095001
DAL193,3p,21,G>C,1615,1384,2999,6484248,6362443,12846691,0.0002334453284507
DAL193,3p,22,G>C,1230,1399,2629,6484224,6362407,12846631,0.0002046450933322
DAL193,3p,23,G>C,1556,1327,2883,6484218,6362399,12846617,0.0002244170585921
DAL193,3p,24,G>C,1466,1341,2807,6484164,6362319,12846483,0.0002185033833773
DAL193,3p,25,G>C,1367,1279,2646,6484128,6362355,12846483,0.0002059707703657
DAL193,5p,1,G>C,30,28,58,6484405,6362696,12847101,4.514637193246944e-06
DAL193,5p,2,G>C,632,55,687,6484386,6362681,12847067,5.347524069112429e-05
DAL193,5p,3,G>C,129,200,329,6484400,6362696,12847096,2.560890025263297e-05
DAL193,5p,4,G>C,263,142,405,6484403,6362696,12847099,3.152462668809511e-05
DAL193,5p,5,G>C,753,663,1416,6484403,6362696,12847099,0.0001102194355317
DAL193,5p,6,G>C,746,694,1440,6484404,6362696,12847100,0.0001120875528329
DAL193,5p,7,G>C,1386,1301,2687,6484404,6362696,12847100,0.0002091522600431
DAL193,5p,8,G>C,1757,1322,3079,6484314,6362693,12847007,0.0002396667177031
DAL193,5p,9,G>C,1657,1281,2938,6484295,6362695,12846990,0.0002286917013245
DAL193,5p,10,G>C,1307,1091,2398,6484284,6362694,12846978,0.0001866586834662
DAL193,5p,11,G>C,1341,1130,2471,6484315,6362677,12846992,0.0001923407440434
DAL193,5p,12,G>C,1939,1327,3266,6484218,6362670,12846888,0.0002542249920759
DAL193,5p,13,G>C,1169,1136,2305,6484143,6362652,12846795,0.0001794221827311
DAL193,5p,14,G>C,1306,1175,2481,6484145,6362627,12846772,0.0001931224435212
DAL193,5p,15,G>C,1638,1590,3228,6484166,6362534,12846700,0.0002512707543571
DAL193,5p,16,G>C,1223,1686,2909,6484111,6362519,12846630,0.0002264407085749
DAL193,5p,17,G>C,1460,1536,2996,6484043,6362598,12846641,0.0002332127129574
DAL193,5p,18,G>C,1245,1316,2561,6483967,6362571,12846538,0.0001993533199372
DAL193,5p,19,G>C,1523,1298,2821,6483980,6362593,12846573,0.0002195916373962
DAL193,5p,20,G>C,1193,1226,2419,6483952,6362554,12846506,0.0001883002273147
DAL193,5p,21,G>C,1942,1630,3572,6484003,6362532,12846535,0.0002780516302645
DAL193,5p,22,G>C,1581,1681,3262,6484010,6362499,12846509,0.0002539211236297
DAL193,5p,23,G>C,1409,1412,2821,6483966,6362463,12846429,0.0002195940988737
DAL193,5p,24,G>C,1508,1707,3215,6483905,6362426,12846331,0.0002502660098046
DAL193,5p,25,G>C,1213,1481,2694,6483942,6362403,12846345,0.0002097094543233
DAL195,3p,1,G>C,6,3,9,2363278,2267461,4630739,1.943534282541081e-06
DAL195,3p,2,G>C,17,0,17,2363278,2267460,4630738,3.671121104238676e-06
DAL195,3p,3,G>C,38,15,53,2363278,2267461,4630739,1.1445257441630806e-05
DAL195,3p,4,G>C,24,33,57,2363278,2267461,4630739,1.2309050456093508e-05
DAL195,3p,5,G>C,339,269,608,2363278,2267461,4630739,0.0001312965381983
DAL195,3p,6,G>C,221,348,569,2363278,2267461,4630739,0.0001228745563073
DAL195,3p,7,G>C,148,270,418,2363278,2267461,4630739,9.02663700113524e-05
DAL195,3p,8,G>C,203,313,516,2363278,2267413,4630691,0.0001114304538998
DAL195,3p,9,G>C,256,265,521,2363276,2267438,4630714,0.0001125096475403
DAL195,3p,10,G>C,177,305,482,2363274,2267432,4630706,0.0001040878000028
DAL195,3p,11,G>C,308,223,531,2363274,2267431,4630705,0.0001146693645999
DAL195,3p,12,G>C,453,247,700,2363273,2267414,4630687,0.0001511654750148
DAL195,3p,13,G>C,419,348,767,2363269,2267412,4630681,0.0001656343850936
DAL195,3p,14,G>C,194,286,480,2363250,2267410,4630660,0.0001036569301136
DAL195,3p,15,G>C,196,273,469,2363254,2267411,4630665,0.000101281349439
DAL195,3p,16,G>C,168,242,410,2363259,2267394,4630653,8.854042831540173e-05
DAL195,3p,17,G>C,210,302,512,2363234,2267398,4630632,0.000110568060688
DAL195,3p,18,G>C,254,299,553,2363236,2267374,4630610,0.0001194227110467
DAL195,3p,19,G>C,265,256,521,2363215,2267369,4630584,0.00011251280616
DAL195,3p,20,G>C,314,564,878,2363222,2267380,4630602,0.0001896081762155
DAL195,3p,21,G>C,244,286,530,2363235,2267382,4630617,0.0001144555898274
DAL195,3p,22,G>C,354,292,646,2363231,2267383,4630614,0.0001395063376044
DAL195,3p,23,G>C,288,379,667,2363219,2267370,4630589,0.0001440421510092
DAL195,3p,24,G>C,273,333,606,2363198,2267373,4630571,0.0001308693895418
DAL195,3p,25,G>C,258,337,595,2363180,2267377,4630557,0.0001284942610575
DAL195,5p,1,G>C,5,18,23,2363278,2267461,4630739,4.966809833160539e-06
DAL195,5p,2,G>C,34,30,64,2363264,2267447,4630711,1.3820771799406184e-05
DAL195,5p,3,G>C,15,8,23,2363278,2267459,4630737,4.966811978309284e-06
DAL195,5p,4,G>C,44,14,58,2363278,2267461,4630739,1.2524998709709183e-05
DAL195,5p,5,G>C,152,101,253,2363277,2267461,4630738,5.463491996308148e-05
DAL195,5p,6,G>C,131,145,276,2363277,2267461,4630738,5.960173086881616e-05
DAL195,5p,7,G>C,189,164,353,2363277,2267461,4630738,7.622974998801487e-05
DAL195,5p,8,G>C,246,226,472,2363212,2267460,4630672,0.0001019290504704
DAL195,5p,9,G>C,295,261,556,2363181,2267461,4630642,0.0001200697441089
DAL195,5p,10,G>C,199,167,366,2363146,2267458,4630604,7.90393650590722e-05
DAL195,5p,11,G>C,282,219,501,2362948,2267450,4630398,0.0001081980425872
DAL195,5p,12,G>C,209,192,401,2362864,2267454,4630318,8.660312315482436e-05
DAL195,5p,13,G>C,206,208,414,2363073,2267445,4630518,8.94068438995378e-05
DAL195,5p,14,G>C,272,217,489,2363094,2267434,4630528,0.0001056035078505
DAL195,5p,15,G>C,208,199,407,2363178,2267432,4630610,8.789338769622145e-05
DAL195,5p,16,G>C,233,178,411,2363170,2267429,4630599,8.875741561728839e-05
DAL195,5p,17,G>C,195,184,379,2363159,2267431,4630590,8.184702165382814e-05
DAL195,5p,18,G>C,341,206,547,2363182,2267420,4630602,0.0001181271895101
DAL195,5p,19,G>C,303,194,497,2363138,2267420,4630558,0.000107330477234
DAL195,5p,20,G>C,243,262,505,2363110,2267401,4630511,0.0001090592377385
DAL195,5p,21,G>C,236,249,485,2363086,2267400,4630486,0.000104740625498
DAL195,5p,22,G>C,242,164,406,2363094,2267388,4630482,8.767985708615216e-05
DAL195,5p,23,G>C,258,280,538,2363068,2267398,4630466,0.0001161870101194
DAL195,5p,24,G>C,226,217,443,2363067,2267402,4630469,9.567065452765152e-05
DAL195,5p,25,G>C,207,199,406,2363135,2267374,4630509,8.767934583433484e-05
DAL212,3p,1,G>C,13,28,41,4131322,4008153,8139475,5.0371799163951e-06
DAL212,3p,2,G>C,13,34,47,4131322,4008153,8139475,5.774328196843162e-06
DAL212,3p,3,G>C,34,17,51,4131322,4008153,8139475,6.265760383808538e-06
DAL212,3p,4,G>C,145,52,197,4131322,4008153,8139475,2.4203035208044744e-05
DAL212,3p,5,G>C,359,259,618,4131322,4008151,8139473,7.592629154246227e-05
DAL212,3p,6,G>C,361,259,620,4131322,4008151,8139473,7.617200769632137e-05
DAL212,3p,7,G>C,332,285,617,4131322,4008153,8139475,7.580341483940918e-05
DAL212,3p,8,G>C,503,313,816,4131319,4008093,8139412,0.0001002529421044
DAL212,3p,9,G>C,555,334,889,4131316,4008115,8139431,0.000109221393977
DAL212,3p,10,G>C,596,388,984,4131317,4008102,8139419,0.0001208931497444
DAL212,3p,11,G>C,584,364,948,4131313,4008105,8139418,0.0001164702439412
DAL212,3p,12,G>C,456,351,807,4131314,4008034,8139348,9.91479907235813e-05
DAL212,3p,13,G>C,679,322,1001,4131307,4007923,8139230,0.0001229846066519
DAL212,3p,14,G>C,451,371,822,4131271,4007904,8139175,0.0001009930367635
DAL212,3p,15,G>C,611,422,1033,4131254,4007935,8139189,0.0001269168218111
DAL212,3p,16,G>C,501,365,866,4131236,4007982,8139218,0.000106398427957
DAL212,3p,17,G>C,389,447,836,4131249,4007981,8139230,0.0001027124187423
DAL212,3p,18,G>C,428,441,869,4131222,4007954,8139176,0.0001067675646773
DAL212,3p,19,G>C,450,473,923,4131233,4007956,8139189,0.0001134019617925
DAL212,3p,20,G>C,526,415,941,4131221,4007928,8139149,0.0001156140525256
DAL212,3p,21,G>C,527,546,1073,4131228,4007917,8139145,0.0001318320290399
DAL212,3p,22,G>C,544,367,911,4131183,4007898,8139081,0.0001119290986291
DAL212,3p,23,G>C,476,358,834,4131172,4007904,8139076,0.0001024686340316
DAL212,3p,24,G>C,453,406,859,4131124,4007904,8139028,0.0001055408581958
DAL212,3p,25,G>C,507,429,936,4131071,4007924,8138995,0.0001150019136269
DAL212,5p,1,G>C,2,8,10,4131322,4008153,8139475,1.2285804674134389e-06
DAL212,5p,2,G>C,63,81,144,4131307,4008143,8139450,1.7691613069679154e-05
DAL212,5p,3,G>C,17,9,26,4131321,4008153,8139474,3.19430960772158e-06
DAL212,5p,4,G>C,75,138,213,4131322,4008153,8139475,2.6168763955906247e-05
DAL212,5p,5,G>C,240,287,527,4131322,4008153,8139475,6.474619063268823e-05
DAL212,5p,6,G>C,305,374,679,4131322,4008153,8139475,8.34206137373725e-05
DAL212,5p,7,G>C,475,287,762,4131322,4008153,8139475,9.361783161690404e-05
DAL212,5p,8,G>C,574,359,933,4131248,4008153,8139401,0.0001146275997459
DAL212,5p,9,G>C,779,450,1229,4131243,4008153,8139396,0.0001509940049605
DAL212,5p,10,G>C,446,404,850,4131179,4008148,8139327,0.0001044312386024
DAL212,5p,11,G>C,464,373,837,4131234,4008143,8139377,0.000102833423246
DAL212,5p,12,G>C,624,419,1043,4131187,4008141,8139328,0.0001281432570354
DAL212,5p,13,G>C,439,392,831,4131181,4008142,8139323,0.0001020969434435
DAL212,5p,14,G>C,462,429,891,4131134,4008108,8139242,0.0001094696533166
DAL212,5p,15,G>C,479,398,877,4131156,4008091,8139247,0.0001077495252324
DAL212,5p,16,G>C,690,465,1155,4131154,4008081,8139235,0.000141905228194
DAL212,5p,17,G>C,442,388,830,4131159,4008081,8139240,0.0001019751229844
DAL212,5p,18,G>C,355,407,762,4131113,4008066,8139179,9.362123624508074e-05
DAL212,5p,19,G>C,433,489,922,4131040,4008052,8139092,0.0001132804494653
DAL212,5p,20,G>C,526,405,931,4131020,4008040,8139060,0.0001143866736453
DAL212,5p,21,G>C,580,693,1273,4130973,4008040,8139013,0.000156407171238
DAL212,5p,22,G>C,469,344,813,4131015,4007967,8138982,9.988964221815456e-05
DAL212,5p,23,G>C,547,462,1009,4131005,4007962,8138967,0.0001239715064577
DAL212,5p,24,G>C,468,423,891,4131060,4007918,8138978,0.0001094732041295
DAL212,5p,25,G>C,552,431,983,4131016,4007614,8138630,0.0001207819989359
DAL218,3p,1,G>C,14,9,23,6952891,6658031,13610922,1.6898193965111257e-06
DAL218,3p,2,G>C,31,43,74,6952891,6658031,13610922,5.436810232253186e-06
DAL218,3p,3,G>C,336,133,469,6952891,6658030,13610921,3.4457624138733886e-05
DAL218,3p,4,G>C,214,186,400,6952891,6658031,13610922,2.938816341758479e-05
DAL218,3p,5,G>C,844,1049,1893,6952891,6658031,13610922,0.0001390794833737
DAL218,3p,6,G>C,1699,1170,2869,6952891,6658030,13610921,0.0002107866175992
DAL218,3p,7,G>C,871,1201,2072,6952891,6658026,13610917,0.0001522307424253
DAL218,3p,8,G>C,1099,1307,2406,6952887,6657945,13610832,0.0001767709718259
DAL218,3p,9,G>C,1089,1106,2195,6952882,6657945,13610827,0.0001612686723591
DAL218,3p,10,G>C,1314,967,2281,6952881,6657960,13610841,0.0001675869992162
DAL218,3p,11,G>C,970,1131,2101,6952866,6657905,13610771,0.0001543630408593
DAL218,3p,12,G>C,1040,1043,2083,6952858,6657882,13610740,0.000153040907401
DAL218,3p,13,G>C,1211,2190,3401,6952870,6657811,13610681,0.0002498772838772
DAL218,3p,14,G>C,1542,2379,3921,6952816,6657779,13610595,0.0002880843930775
DAL218,3p,15,G>C,1555,1208,2763,6952788,6657738,13610526,0.0002030046450813
DAL218,3p,16,G>C,1070,1089,2159,6952760,6657689,13610449,0.0001586281246122
DAL218,3p,17,G>C,1236,1887,3123,6952737,6657651,13610388,0.0002294570882182
DAL218,3p,18,G>C,1251,1704,2955,6952711,6657672,13610383,0.0002171136550676
DAL218,3p,19,G>C,1266,1616,2882,6952716,6657697,13610413,0.0002117496361058
DAL218,3p,20,G>C,1089,1527,2616,6952697,6657752,13610449,0.000192205268173
DAL218,3p,21,G>C,1179,1349,2528,6952660,6657692,13610352,0.0001857409712842
DAL218,3p,22,G>C,1139,1252,2391,6952654,6657637,13610291,0.0001756758911326
DAL218,3p,23,G>C,1463,1341,2804,6952651,6657632,13610283,0.0002060206977327
DAL218,3p,24,G>C,2273,2304,4577,6952669,6657588,13610257,0.0003362904903265
DAL218,3p,25,G>C,1570,2279,3849,6952605,6657566,13610171,0.0002828032065137
DAL218,5p,1,G>C,13,29,42,6952891,6658031,13610922,3.0857571588464027e-06
DAL218,5p,2,G>C,168,92,260,6952874,6658014,13610888,1.9102353938993542e-05
DAL218,5p,3,G>C,129,62,191,6952891,6658031,13610922,1.4032848031896737e-05
DAL218,5p,4,G>C,259,320,579,6952891,6658031,13610922,4.2539366546953984e-05
DAL218,5p,5,G>C,891,819,1710,6952891,6658031,13610922,0.0001256343986101
DAL218,5p,6,G>C,767,995,1762,6952891,6658031,13610922,0.0001294548598544
DAL218,5p,7,G>C,1802,1010,2812,6952888,6658031,13610919,0.0002065988343623
DAL218,5p,8,G>C,3230,1438,4668,6952719,6658029,13610748,0.0003429642514871
DAL218,5p,9,G>C,1846,1586,3432,6952736,6658029,13610765,0.0002521533506749
DAL218,5p,10,G>C,1794,1401,3195,6952716,6658028,13610744,0.0002347410251783
DAL218,5p,11,G>C,1672,1526,3198,6952715,6658016,13610731,0.0002349616637049
DAL218,5p,12,G>C,2090,1228,3318,6952625,6658005,13610630,0.0002437800454497
DAL218,5p,13,G>C,2521,1166,3687,6952475,6658005,13610480,0.0002708941932981
DAL218,5p,14,G>C,1812,1281,3093,6952554,6657955,13610509,0.0002272508691629
DAL218,5p,15,G>C,1573,1281,2854,6952449,6657923,13610372,0.0002096930194119
DAL218,5p,16,G>C,1390,1191,2581,6952253,6657920,13610173,0.0001896375600809
DAL218,5p,17,G>C,1745,1248,2993,6952350,6657874,13610224,0.0002199082101808
DAL218,5p,18,G>C,3480,1145,4625,6952457,6657843,13610300,0.0003398161686369
DAL218,5p,19,G>C,1204,1286,2490,6952296,6657770,13610066,0.0001829528233
DAL218,5p,20,G>C,1573,1438,3011,6952289,6657772,13610061,0.0002212333949127
DAL218,5p,21,G>C,1966,1215,3181,6952371,6657729,13610100,0.0002337234847649
DAL218,5p,22,G>C,1353,1261,2614,6952322,6657786,13610108,0.0001920631342528
DAL218,5p,23,G>C,1302,913,2215,6952288,6657745,13610033,0.0001627475848148
DAL218,5p,24,G>C,1564,1266,2830,6952375,6657772,13610147,0.0002079330957997
DAL218,5p,25,G>C,1489,1272,2761,6952272,6657720,13609992,0.0002028656592891
DAL224,3p,1,G>C,7,8,15,4609472,4586477,9195949,1.631153021836028e-06
DAL224,3p,2,G>C,61,129,190,4609471,4586476,9195947,2.0661276103483414e-05
DAL224,3p,3,G>C,137,641,778,4609472,4586477,9195949,8.460247006589532e-05
DAL224,3p,4,G>C,94,56,150,4609472,4586477,9195949,1.631153021836028e-05
DAL224,3p,5,G>C,239,461,700,4609472,4586477,9195949,7.612047435234798e-05
DAL224,3p,6,G>C,221,669,890,4609472,4586477,9195949,9.6781745962271e-05
DAL224,3p,7,G>C,244,530,774,4609472,4586476,9195948,8.416750507941106e-05
DAL224,3p,8,G>C,342,365,707,4609469,4586423,9195892,7.688215564080135e-05
DAL224,3p,9,G>C,337,299,636,4609466,4586431,9195897,6.916127920963012e-05
DAL224,3p,10,G>C,814,1158,1972,4609461,4586371,9195832,0.0002144449789861
DAL224,3p,11,G>C,760,1066,1826,4609461,4586382,9195843,0.0001985679833811
DAL224,3p,12,G>C,884,948,1832,4609458,4586384,9195842,0.0001992204737749
DAL224,3p,13,G>C,1063,1008,2071,4609454,4586364,9195818,0.0002252110687706
DAL224,3p,14,G>C,528,506,1034,4609412,4586293,9195705,0.0001124437984907
DAL224,3p,15,G>C,661,571,1232,4609400,4586272,9195672,0.0001339760704818
DAL224,3p,16,G>C,1132,692,1824,4609379,4586240,9195619,0.0001983553255088
DAL224,3p,17,G>C,797,878,1675,4609381,4586216,9195597,0.0001821523931507
DAL224,3p,18,G>C,1142,825,1967,4609363,4586282,9195645,0.0002139056042289
DAL224,3p,19,G>C,1726,862,2588,4609353,4586195,9195548,0.0002814405405746
DAL224,3p,20,G>C,1286,1676,2962,4609344,4586225,9195569,0.0003221116605182
DAL224,3p,21,G>C,1079,1029,2108,4609343,4586223,9195566,0.0002292409189385
DAL224,3p,22,G>C,976,1704,2680,4609324,4586172,9195496,0.0002914470301547
DAL224,3p,23,G>C,907,1024,1931,4609323,4586083,9195406,0.0002099961654765
DAL224,3p,24,G>C,1087,1352,2439,4609325,4586202,9195527,0.0002652376530458
DAL224,3p,25,G>C,1263,1133,2396,4609265,4586173,9195438,0.0002605639883603
DAL224,5p,1,G>C,4,13,17,4609472,4586477,9195949,1.848640091414165e-06
DAL224,5p,2,G>C,132,40,172,4609461,4586469,9195930,1.8703926628410613e-05
DAL224,5p,3,G>C,35,23,58,4609468,4586477,9195945,6.307127761203443e-06
DAL224,5p,4,G>C,94,67,161,4609471,4586477,9195948,1.7507711004890414e-05
DAL224,5p,5,G>C,271,272,543,4609471,4586477,9195948,5.9047745811524815e-05
DAL224,5p,6,G>C,511,311,822,4609472,4586477,9195949,8.938718559661433e-05
DAL224,5p,7,G>C,371,416,787,4609471,4586477,9195948,8.5581171185396e-05
DAL224,5p,8,G>C,514,580,1094,4609397,4586477,9195874,0.0001189663973212
DAL224,5p,9,G>C,637,501,1138,4609357,4586473,9195830,0.000123751743997
DAL224,5p,10,G>C,403,548,951,4609338,4586470,9195808,0.0001034166872557
DAL224,5p,11,G>C,541,1067,1608,4609388,4586469,9195857,0.0001748613533246
DAL224,5p,12,G>C,1630,1046,2676,4609357,4586464,9195821,0.000291001749599
DAL224,5p,13,G>C,534,6384,6918,4609320,4586461,9195781,0.0007523015174023
DAL224,5p,14,G>C,552,541,1093,4609270,4586428,9195698,0.0001188599277618
DAL224,5p,15,G>C,584,335,919,4609299,4586416,9195715,9.993785148843784e-05
DAL224,5p,16,G>C,375,445,820,4609292,4586373,9195665,8.917245245449894e-05
DAL224,5p,17,G>C,964,443,1407,4609285,4586385,9195670,0.0001530067955896
DAL224,5p,18,G>C,589,863,1452,4609226,4586351,9195577,0.0001579020000593
DAL224,5p,19,G>C,699,534,1233,4609203,4586337,9195540,0.000134086742051
DAL224,5p,20,G>C,679,482,1161,4609148,4586313,9195461,0.0001262579440008
DAL224,5p,21,G>C,2236,448,2684,4609195,4586347,9195542,0.0002918805656045
DAL224,5p,22,G>C,1523,804,2327,4609138,4586312,9195450,0.0002530599372515
DAL224,5p,23,G>C,888,753,1641,4609100,4586313,9195413,0.0001784585423188
DAL224,5p,24,G>C,1105,924,2029,4609109,4586316,9195425,0.0002206532052623
DAL224,5p,25,G>C,1827,675,2502,4609125,4586257,9195382,0.0002720931006455
DAL227,3p,1,G>C,10,4,14,3765386,3771243,7536629,1.8575944231830968e-06
DAL227,3p,2,G>C,23,6,29,3765386,3771243,7536629,3.847874162307843e-06
DAL227,3p,3,G>C,38,16,54,3765386,3771243,7536629,7.165007060849088e-06
DAL227,3p,4,G>C,39,50,89,3765386,3771243,7536629,1.1808993118806827e-05
DAL227,3p,5,G>C,134,178,312,3765386,3771243,7536629,4.139781857379473e-05
DAL227,3p,6,G>C,76,189,265,3765386,3771243,7536629,3.516160872453719e-05
DAL227,3p,7,G>C,194,138,332,3765386,3771243,7536629,4.405152489262772e-05
DAL227,3p,8,G>C,177,161,338,3765386,3771207,7536593,4.484785101172373e-05
DAL227,3p,9,G>C,224,229,453,3765384,3771218,7536602,6.010666345390137e-05
DAL227,3p,10,G>C,226,164,390,3765382,3771209,7536591,5.174753413048419e-05
DAL227,3p,11,G>C,191,149,340,3765378,3771214,7536592,4.511322889709301e-05
DAL227,3p,12,G>C,293,310,603,3765377,3771173,7536550,8.001008418971545e-05
DAL227,3p,13,G>C,254,237,491,3765373,3771183,7536556,6.514912116356595e-05
DAL227,3p,14,G>C,273,373,646,3765341,3771166,7536507,8.571610163700505e-05
DAL227,3p,15,G>C,338,308,646,3765341,3771186,7536527,8.571587416856597e-05
DAL227,3p,16,G>C,265,264,529,3765340,3771079,7536419,7.019248797074578e-05
DAL227,3p,17,G>C,292,223,515,3765328,3771049,7536377,6.833522261426147e-05
DAL227,3p,18,G>C,475,362,837,3765321,3771036,7536357,0.000111061617702
DAL227,3p,19,G>C,243,258,501,3765313,3771111,7536424,6.647715149784566e-05
DAL227,3p,20,G>C,256,421,677,3765308,3771082,7536390,8.983080758824848e-05
DAL227,3p,21,G>C,489,279,768,3765307,3771104,7536411,0.0001019052702937
DAL227,3p,22,G>C,319,228,547,3765309,3771137,7536446,7.258063018032638e-05
DAL227,3p,23,G>C,210,223,433,3765319,3771112,7536431,5.745425122315855e-05
DAL227,3p,24,G>C,302,356,658,3765312,3771081,7536393,8.730967188149556e-05
DAL227,3p,25,G>C,261,460,721,3765249,3771100,7536349,9.566966710273104e-05
DAL227,5p,1,G>C,1,5,6,3765386,3771243,7536629,7.961118956498987e-07
DAL227,5p,2,G>C,47,10,57,3765373,3771238,7536611,7.563081071850464e-06
DAL227,5p,3,G>C,26,4,30,3765386,3771243,7536629,3.980559478249493e-06
DAL227,5p,4,G>C,51,24,75,3765385,3771243,7536628,9.951400016028388e-06
DAL227,5p,5,G>C,149,105,254,3765386,3771242,7536628,3.370207472094948e-05
DAL227,5p,6,G>C,128,101,229,3765386,3771243,7536629,3.03849373506378e-05
DAL227,5p,7,G>C,189,195,384,3765386,3771243,7536629,5.095116132159352e-05
DAL227,5p,8,G>C,231,231,462,3765342,3771242,7536584,6.130098198334948e-05
DAL227,5p,9,G>C,335,398,733,3765324,3771243,7536567,9.725913668650462e-05
DAL227,5p,10,G>C,189,123,312,3765318,3771238,7536556,4.139821955811116e-05
DAL227,5p,11,G>C,272,113,385,3765365,3771237,7536602,5.108402964625172e-05
DAL227,5p,12,G>C,208,199,407,3765326,3771232,7536558,5.400343233608764e-05
DAL227,5p,13,G>C,151,149,300,3765325,3771231,7536556,3.980598034433765e-05
DAL227,5p,14,G>C,234,274,508,3765297,3771226,7536523,6.740508852689761e-05
DAL227,5p,15,G>C,422,164,586,3765318,3771201,7536519,7.775473000200756e-05
DAL227,5p,16,G>C,258,213,471,3765316,3771188,7536504,6.249582034322546e-05
DAL227,5p,17,G>C,370,253,623,3765326,3771175,7536501,8.266435577995677e-05
DAL227,5p,18,G>C,300,267,567,3765280,3771169,7536449,7.523437098824658e-05
DAL227,5p,19,G>C,402,246,648,3765279,3771164,7536443,8.598220672537429e-05
DAL227,5p,20,G>C,425,328,753,3765254,3771167,7536421,9.991480040724902e-05
DAL227,5p,21,G>C,256,250,506,3765270,3771169,7536439,6.714046249163564e-05
DAL227,5p,22,G>C,280,164,444,3765253,3771158,7536411,5.891398438859027e-05
DAL227,5p,23,G>C,483,208,691,3765254,3771157,7536411,9.168820543359432e-05
DAL227,5p,24,G>C,376,315,691,3765270,3771180,7536450,9.168773096086354e-05
DAL227,5p,25,G>C,269,211,480,3765247,3771148,7536395,6.369092915113924e-05
WA02,3p,1,G>C,19,0,19,6552698,6754258,13306956,1.4278246655358296e-06
WA02,3p,2,G>C,32,8,40,6552698,6754258,13306956,3.005946664285957e-06
WA02,3p,3,G>C,40,35,75,6552698,6754258,13306956,5.636149995536169e-06
WA02,3p,4,G>C,151,48,199,6552698,6754256,13306954,1.4954586902457168e-05
WA02,3p,5,G>C,403,267,670,6552698,6754256,13306954,5.034961419420252e-05
WA02,3p,6,G>C,285,324,609,6552698,6754257,13306955,4.576554140297311e-05
WA02,3p,7,G>C,345,217,562,6552698,6754257,13306955,4.223355380701295e-05
WA02,3p,8,G>C,305,356,661,6552692,6754207,13306899,4.967348140239135e-05
WA02,3p,9,G>C,358,383,741,6552688,6754191,13306879,5.568548417701852e-05
WA02,3p,10,G>C,347,309,656,6552680,6754207,13306887,4.929778091600237e-05
WA02,3p,11,G>C,389,337,726,6552667,6754202,13306869,5.4558288655280215e-05
WA02,3p,12,G>C,417,507,924,6552670,6754189,13306859,6.943787410687977e-05
WA02,3p,13,G>C,499,436,935,6552675,6754177,13306852,7.026455242757641e-05
WA02,3p,14,G>C,416,384,800,6552653,6754155,13306808,6.011960193609166e-05
WA02,3p,15,G>C,392,415,807,6552632,6754146,13306778,6.064578517804986e-05
WA02,3p,16,G>C,403,502,905,6552629,6754119,13306748,6.801060634799728e-05
WA02,3p,17,G>C,535,379,914,6552608,6754116,13306724,6.868707880316748e-05
WA02,3p,18,G>C,391,433,824,6552611,6754085,13306696,6.192371119021582e-05
WA02,3p,19,G>C,434,566,1000,6552605,6754056,13306661,7.515033260409956e-05
WA02,3p,20,G>C,405,417,822,6552618,6754033,13306651,6.17736198236506e-05
WA02,3p,21,G>C,560,488,1048,6552597,6754089,13306686,7.875740060297507e-05
WA02,3p,22,G>C,393,437,830,6552593,6754062,13306655,6.237480418632632e-05
WA02,3p,23,G>C,518,497,1015,6552585,6754052,13306637,7.627772516827505e-05
WA02,3p,24,G>C,440,403,843,6552556,6754026,13306582,6.335210649887401e-05
WA02,3p,25,G>C,525,421,946,6552517,6754038,13306555,7.10927809639685e-05
WA02,5p,1,G>C,9,31,40,6552698,6754258,13306956,3.005946664285957e-06
WA02,5p,2,G>C,144,36,180,6552562,6754179,13306741,1.3526978544182982e-05
WA02,5p,3,G>C,52,57,109,6552698,6754258,13306956,8.191204660179232e-06
WA02,5p,4,G>C,106,85,191,6552698,6754258,13306956,1.4353395321965445e-05
WA02,5p,5,G>C,231,217,448,6552698,6754258,13306956,3.366660264000272e-05
WA02,5p,6,G>C,298,171,469,6552697,6754258,13306955,3.52447272873471e-05
WA02,5p,7,G>C,312,202,514,6552685,6754258,13306943,3.862645237151764e-05
WA02,5p,8,G>C,631,257,888,6552655,6754257,13306912,6.673223660004665e-05
WA02,5p,9,G>C,372,256,628,6552662,6754226,13306888,4.719360379376455e-05
WA02,5p,10,G>C,361,255,616,6552618,6754222,13306840,4.629198216856895e-05
WA02,5p,11,G>C,463,296,759,6552625,6754225,13306850,5.703829230809696e-05
WA02,5p,12,G>C,573,288,861,6552628,6754236,13306864,6.47034492875256e-05
WA02,5p,13,G>C,381,197,578,6552614,6754205,13306819,4.343637649238334e-05
WA02,5p,14,G>C,576,304,880,6552607,6754183,13306790,6.613165158539363e-05
WA02,5p,15,G>C,520,417,937,6552586,6754168,13306754,7.041536951836638e-05
WA02,5p,16,G>C,402,374,776,6552525,6754178,13306703,5.8316474035679615e-05
WA02,5p,17,G>C,566,414,980,6552567,6754148,13306715,7.364702708369421e-05
WA02,5p,18,G>C,473,376,849,6552548,6754087,13306635,6.380275704563927e-05
WA02,5p,19,G>C,478,381,859,6552516,6754124,13306640,6.455423758364245e-05
WA02,5p,20,G>C,447,444,891,6552507,6754132,13306639,6.69590570541517e-05
WA02,5p,21,G>C,583,428,1011,6552521,6754152,13306673,7.597691774645699e-05
WA02,5p,22,G>C,471,459,930,6552516,6754117,13306633,6.98899563849097e-05
WA02,5p,23,G>C,568,593,1161,6552465,6754131,13306596,8.724996234949945e-05
WA02,5p,24,G>C,501,374,875,6552457,6754135,13306592,6.575688200254431e-05
WA02,5p,25,G>C,480,429,909,6552470,6754083,13306553,6.831220677511299e-05
WA03,3p,1,G>C,13,104,117,5399458,5543742,10943200,1.0691571021273483e-05
WA03,3p,2,G>C,38,75,113,5399458,5543742,10943200,1.0326047225674393e-05
WA03,3p,3,G>C,77,310,387,5399458,5543742,10943200,3.5364427224212295e-05
WA03,3p,4,G>C,161,182,343,5399458,5543736,10943194,3.134368265791505e-05
WA03,3p,5,G>C,666,616,1282,5399458,5543740,10943198,0.0001171503979001
WA03,3p,6,G>C,748,627,1375,5399458,5543741,10943199,0.000125648816219
WA03,3p,7,G>C,542,801,1343,5399458,5543739,10943197,0.0001227246480164
WA03,3p,8,G>C,589,828,1417,5399449,5543673,10943122,0.0001294877275424
WA03,3p,9,G>C,889,1103,1992,5399436,5543670,10943106,0.000182032413832
WA03,3p,10,G>C,682,961,1643,5399438,5543654,10943092,0.0001501403807991
WA03,3p,11,G>C,823,882,1705,5399404,5543644,10943048,0.000155806682014
WA03,3p,12,G>C,799,884,1683,5399397,5543595,10942992,0.0001537970602555
WA03,3p,13,G>C,773,935,1708,5399378,5543551,10942929,0.0001560825259855
WA03,3p,14,G>C,830,910,1740,5399356,5543493,10942849,0.00015900795122
WA03,3p,15,G>C,966,1046,2012,5399349,5543505,10942854,0.0001838642825719
WA03,3p,16,G>C,830,1091,1921,5399342,5543495,10942837,0.0001755486260098
WA03,3p,17,G>C,845,862,1707,5399346,5543438,10942784,0.0001559932097718
WA03,3p,18,G>C,901,1071,1972,5399325,5543443,10942768,0.0001802103453166
WA03,3p,19,G>C,1018,1104,2122,5399297,5543425,10942722,0.0001939188439585
WA03,3p,20,G>C,760,1606,2366,5399252,5543409,10942661,0.0002162179747686
WA03,3p,21,G>C,904,1221,2125,5399248,5543303,10942551,0.0001941960334477
WA03,3p,22,G>C,1035,1153,2188,5399256,5543263,10942519,0.0001999539594128
WA03,3p,23,G>C,899,2071,2970,5399255,5543267,10942522,0.0002714182342973
WA03,3p,24,G>C,861,1561,2422,5399198,5543130,10942328,0.0002213422957162
WA03,3p,25,G>C,940,1030,1970,5399050,5543142,10942192,0.0001800370529049
WA03,5p,1,G>C,26,99,125,5399457,5543742,10943199,1.1422619656281495e-05
WA03,5p,2,G>C,182,70,252,5399258,5543638,10942896,2.3028638853919477e-05
WA03,5p,3,G>C,120,178,298,5399457,5543742,10943199,2.7231525260575084e-05
WA03,5p,4,G>C,174,178,352,5399458,5543742,10943200,3.2166094012720226e-05
WA03,5p,5,G>C,585,391,976,5399456,5543740,10943196,8.918783872645615e-05
WA03,5p,6,G>C,584,460,1044,5399452,5543742,10943194,9.540176295878516e-05
WA03,5p,7,G>C,757,558,1315,5399453,5543742,10943195,0.0001201660027076
WA03,5p,8,G>C,952,734,1686,5399403,5543732,10943135,0.0001540691949793
WA03,5p,9,G>C,883,1156,2039,5399319,5543732,10943051,0.0001863282918081
WA03,5p,10,G>C,960,720,1680,5399344,5543717,10943061,0.0001535219441799
WA03,5p,11,G>C,1118,761,1879,5399321,5543705,10943026,0.0001717075331814
WA03,5p,12,G>C,1064,940,2004,5399213,5543665,10942878,0.0001831328102168
WA03,5p,13,G>C,997,880,1877,5399156,5543662,10942818,0.0001715280287033
WA03,5p,14,G>C,1131,858,1989,5399124,5543629,10942753,0.0001817641319327
WA03,5p,15,G>C,1073,1006,2079,5399092,5543505,10942597,0.0001899914618074
WA03,5p,16,G>C,911,1130,2041,5399083,5543501,10942584,0.0001865190159837
WA03,5p,17,G>C,926,1062,1988,5399113,5543491,10942604,0.0001816752209985
WA03,5p,18,G>C,1186,937,2123,5399074,5543600,10942674,0.0001940110799243
WA03,5p,19,G>C,1145,986,2131,5399071,5543546,10942617,0.0001947431770663
WA03,5p,20,G>C,956,1042,1998,5399050,5543533,10942583,0.0001825894306673
WA03,5p,21,G>C,1176,1153,2329,5399034,5543509,10942543,0.0002128390082634
WA03,5p,22,G>C,993,1072,2065,5398989,5543454,10942443,0.0001887147138897
WA03,5p,23,G>C,1019,1017,2036,5398935,5543457,10942392,0.0001860653502451
WA03,5p,24,G>C,1043,1126,2169,5398952,5543428,10942380,0.0001982201312694
WA03,5p,25,G>C,1087,895,1982,5398991,5543444,10942435,0.0001811297028495
WA07,3p,1,G>C,10,2,12,5691729,6013979,11705708,1.0251408970734618e-06
WA07,3p,2,G>C,34,20,54,5691729,6013979,11705708,4.613134036830579e-06
WA07,3p,3,G>C,64,36,100,5691729,6013979,11705708,8.542840808945516e-06
WA07,3p,4,G>C,75,51,126,5691729,6013979,11705708,1.0763979419271353e-05
WA07,3p,5,G>C,256,158,414,5691729,6013979,11705708,3.536736094903444e-05
WA07,3p,6,G>C,258,153,411,5691729,6013979,11705708,3.5111075724766074e-05
WA07,3p,7,G>C,278,184,462,5691729,6013979,11705708,3.946792453732829e-05
WA07,3p,8,G>C,288,289,577,5691713,6013800,11705513,4.9293012617217205e-05
WA07,3p,9,G>C,461,318,779,5691720,6013901,11705621,6.654922451359053e-05
WA07,3p,10,G>C,443,286,729,5691718,6013892,11705610,6.22778308862161e-05
WA07,3p,11,G>C,262,278,540,5691711,6013883,11705594,4.613178963835582e-05
WA07,3p,12,G>C,426,341,767,5691705,6013884,11705589,6.552425512291607e-05
WA07,3p,13,G>C,289,235,524,5691711,6013848,11705559,4.476505564578334e-05
WA07,3p,14,G>C,355,339,694,5691695,6013877,11705572,5.928800403773519e-05
WA07,3p,15,G>C,352,310,662,5691211,6013856,11705067,5.655670317820479e-05
WA07,3p,16,G>C,372,364,736,5691636,6013850,11705486,6.28765008133793e-05
WA07,3p,17,G>C,290,386,676,5691662,6013813,11705475,5.775075338676987e-05
WA07,3p,18,G>C,369,398,767,5691639,6013769,11705408,6.552526832042078e-05
WA07,3p,19,G>C,299,402,701,5691628,6013742,11705370,5.98870432972217e-05
WA07,3p,20,G>C,339,455,794,5691604,6013772,11705376,6.783207989217946e-05
WA07,3p,21,G>C,321,378,699,5691611,6013735,11705346,5.971630398622988e-05
WA07,3p,22,G>C,378,386,764,5691577,6013736,11705313,6.526950624899992e-05
WA07,3p,23,G>C,425,416,841,5691568,6013670,11705238,7.184817600462288e-05
WA07,3p,24,G>C,419,362,781,5691554,6013661,11705215,6.672239681201925e-05
WA07,3p,25,G>C,427,310,737,5691455,6013662,11705117,6.296391569601568e-05
WA07,5p,1,G>C,14,9,23,5691729,6013979,11705708,1.9648533860574688e-06
WA07,5p,2,G>C,106,28,134,5691636,6013923,11705559,1.1447552397967496e-05
WA07,5p,3,G>C,85,30,115,5691729,6013979,11705708,9.824266930287343e-06
WA07,5p,4,G>C,124,76,200,5691728,6013979,11705707,1.7085683077493738e-05
WA07,5p,5,G>C,194,138,332,5691729,6013978,11705707,2.836223390863961e-05
WA07,5p,6,G>C,311,142,453,5691728,6013979,11705707,3.869907217052332e-05
WA07,5p,7,G>C,335,141,476,5691728,6013979,11705707,4.0663925724435096e-05
WA07,5p,8,G>C,288,223,511,5691579,6013975,11705554,4.365449085109513e-05
WA07,5p,9,G>C,500,220,720,5691672,6013971,11705643,6.150879537330842e-05
WA07,5p,10,G>C,331,282,613,5691582,6013961,11705543,5.236835232675665e-05
WA07,5p,11,G>C,406,268,674,5691326,6013942,11705268,5.758091143235678e-05
WA07,5p,12,G>C,620,235,855,5691520,6013938,11705458,7.304284890006012e-05
WA07,5p,13,G>C,492,227,719,5691511,6013949,11705460,6.142432676716678e-05
WA07,5p,14,G>C,561,250,811,5691556,6013950,11705506,6.92836345562507e-05
WA07,5p,15,G>C,513,228,741,5691563,6013633,11705196,6.330521932311087e-05
WA07,5p,16,G>C,580,347,927,5691534,6013925,11705459,7.91938188839925e-05
WA07,5p,17,G>C,374,328,702,5691561,6013916,11705477,5.997192596252165e-05
WA07,5p,18,G>C,430,350,780,5691474,6013905,11705379,6.66360311784864e-05
WA07,5p,19,G>C,457,439,896,5691482,6013884,11705366,7.654609005818358e-05
WA07,5p,20,G>C,370,360,730,5691421,6013876,11705297,6.236492760499798e-05
WA07,5p,21,G>C,474,640,1114,5691379,6013853,11705232,9.51711166425407e-05
WA07,5p,22,G>C,417,433,850,5691396,6013861,11705257,7.261694467707971e-05
WA07,5p,23,G>C,537,515,1052,5691314,6013795,11705109,8.987528437368674e-05
WA07,5p,24,G>C,440,475,915,5691332,6013785,11705117,7.817094011106425e-05
WA07,5p,25,G>C,395,524,919,5691334,6013719,11705053,7.85131002824165e-05
WA08,3p,1,G>C,15,0,15,6798117,7189085,13987202,1.0724089063702665e-06
WA08,3p,2,G>C,15,12,27,6798117,7189085,13987202,1.930336031466479e-06
WA08,3p,3,G>C,30,44,74,6798117,7189085,13987202,5.29055060475998e-06
WA08,3p,4,G>C,56,25,81,6798117,7189081,13987198,5.791009750487553e-06
WA08,3p,5,G>C,271,318,589,6798117,7189085,13987202,4.210992305680579e-05
WA08,3p,6,G>C,274,357,631,6798117,7189085,13987202,4.511266799464253e-05
WA08,3p,7,G>C,232,247,479,6798117,7189084,13987201,3.4245593525109135e-05
WA08,3p,8,G>C,326,343,669,6798110,7189053,13987163,4.782957058554333e-05
WA08,3p,9,G>C,361,346,707,6798103,7189051,13987154,5.0546379914026826e-05
WA08,3p,10,G>C,633,446,1079,6798074,7189042,13987116,7.71424216400293e-05
WA08,3p,11,G>C,531,476,1007,6798109,7189046,13987155,7.199462649838369e-05
WA08,3p,12,G>C,377,533,910,6798091,7189018,13987109,6.50599062322314e-05
WA08,3p,13,G>C,518,396,914,6798090,7189013,13987103,6.534591187324494e-05
WA08,3p,14,G>C,417,381,798,6798067,7188981,13987048,5.705278197372312e-05
WA08,3p,15,G>C,454,385,839,6798069,7188978,13987047,5.998406954663125e-05
WA08,3p,16,G>C,436,393,829,6798049,7188961,13987010,5.9269279138286166e-05
WA08,3p,17,G>C,364,433,797,6798000,7188943,13986943,5.698171501807078e-05
WA08,3p,18,G>C,470,481,951,6798023,7188956,13986979,6.799180866718968e-05
WA08,3p,19,G>C,452,417,869,6798028,7188946,13986974,6.21292353871538e-05
WA08,3p,20,G>C,460,460,920,6798009,7188917,13986926,6.577571083167237e-05
WA08,3p,21,G>C,396,388,784,6798010,7188926,13986936,5.6052304807857846e-05
WA08,3p,22,G>C,397,367,764,6798012,7188920,13986932,5.462241469394432e-05
WA08,3p,23,G>C,530,477,1007,6798009,7188864,13986873,7.199607803688501e-05
WA08,3p,24,G>C,469,448,917,6798015,7188867,13986882,6.556143106090407e-05
WA08,3p,25,G>C,500,483,983,6797966,7188892,13986858,7.028025879722237e-05
WA08,5p,1,G>C,16,46,62,6798116,7189085,13987201,4.432623796569449e-06
WA08,5p,2,G>C,128,119,247,6797941,7188997,13986938,1.7659333300826813e-05
WA08,5p,3,G>C,67,51,118,6798117,7189084,13987201,8.4362839999225e-06
WA08,5p,4,G>C,87,113,200,6798115,7189085,13987200,1.4298787462823152e-05
WA08,5p,5,G>C,266,265,531,6798116,7189084,13987200,3.796328071379547e-05
WA08,5p,6,G>C,357,219,576,6798112,7189085,13987197,4.1180516725402526e-05
WA08,5p,7,G>C,371,322,693,6798110,7189085,13987195,4.95453162696309e-05
WA08,5p,8,G>C,414,292,706,6798069,7189064,13987133,5.047496152356598e-05
WA08,5p,9,G>C,358,390,748,6798054,7189067,13987121,5.347776715451307e-05
WA08,5p,10,G>C,386,235,621,6798015,7189037,13987052,4.439820485403215e-05
WA08,5p,11,G>C,408,472,880,6797997,7189047,13987044,6.291536653491616e-05
WA08,5p,12,G>C,468,370,838,6798016,7189056,13987072,5.991246774164028e-05
WA08,5p,13,G>C,348,278,626,6797995,7189043,13987038,4.475572312022031e-05
WA08,5p,14,G>C,414,370,784,6797984,7189041,13987025,5.605194814479848e-05
WA08,5p,15,G>C,442,488,930,6797997,7189013,13987010,6.649026489578545e-05
WA08,5p,16,G>C,362,447,809,6797921,7188997,13986918,5.783976141134166e-05
WA08,5p,17,G>C,553,423,976,6797959,7188875,13986834,6.977990873417101e-05
WA08,5p,18,G>C,452,441,893,6797991,7188972,13986963,6.38451678180603e-05
WA08,5p,19,G>C,415,482,897,6797966,7188988,13986954,6.41311896786105e-05
WA08,5p,20,G>C,470,634,1104,6797883,7188971,13986854,7.89312593096346e-05
WA08,5p,21,G>C,453,698,1151,6797885,7188979,13986864,8.229149865187793e-05
WA08,5p,22,G>C,495,545,1040,6797887,7188939,13986826,7.435568298340166e-05
WA08,5p,23,G>C,482,591,1073,6797851,7188919,13986770,7.67153531515854e-05
WA08,5p,24,G>C,495,657,1152,6797841,7188876,13986717,8.236385993939821e-05
WA08,5p,25,G>C,566,579,1145,6797835,7188817,13986652,8.186376553874366e-05
WA09,3p,1,G>C,20,9,29,4741672,4881751,9623423,3.013480754197337e-06
WA09,3p,2,G>C,32,5,37,4741672,4881751,9623423,3.844785789837982e-06
WA09,3p,3,G>C,98,49,147,4741672,4881751,9623423,1.5275230029896846e-05
WA09,3p,4,G>C,114,113,227,4741672,4881748,9623420,2.358828773970169e-05
WA09,3p,5,G>C,627,536,1163,4741672,4881751,9623423,0.0001208509695562
WA09,3p,6,G>C,650,575,1225,4741672,4881751,9623423,0.0001272935835824
WA09,3p,7,G>C,778,541,1319,4741672,4881748,9623420,0.0001370614604787
WA09,3p,8,G>C,1652,627,2279,4741663,4881718,9623381,0.0002368190555897
WA09,3p,9,G>C,752,773,1525,4741664,4881723,9623387,0.000158468115228
WA09,3p,10,G>C,854,670,1524,4741658,4881705,9623363,0.0001583645966591
WA09,3p,11,G>C,849,710,1559,4741648,4881712,9623360,0.0001620016293685
WA09,3p,12,G>C,759,848,1607,4741642,4881680,9623322,0.0001669901516337
WA09,3p,13,G>C,777,812,1589,4741628,4881645,9623273,0.0001651205364328
WA09,3p,14,G>C,877,745,1622,4741616,4881571,9623187,0.0001685512294419
WA09,3p,15,G>C,798,961,1759,4741598,4881557,9623155,0.000182788285131
WA09,3p,16,G>C,815,886,1701,4741586,4881546,9623132,0.000176761578247
WA09,3p,17,G>C,850,797,1647,4741582,4881528,9623110,0.0001711504908496
WA09,3p,18,G>C,897,937,1834,4741560,4881490,9623050,0.0001905840663822
WA09,3p,19,G>C,926,1010,1936,4741552,4881442,9622994,0.0002011847871878
WA09,3p,20,G>C,943,996,1939,4741534,4881501,9623035,0.0002014956819755
WA09,3p,21,G>C,919,1096,2015,4741546,4881493,9623039,0.0002093933111982
WA09,3p,22,G>C,824,973,1797,4741524,4881498,9623022,0.000186739674917
WA09,3p,23,G>C,881,988,1869,4741501,4881486,9622987,0.0001942224384175
WA09,3p,24,G>C,1055,1171,2226,4741491,4881450,9622941,0.000231322212201
WA09,3p,25,G>C,1019,1773,2792,4741451,4881469,9622920,0.0002901406225968
WA09,5p,1,G>C,10,55,65,4741672,4881751,9623423,6.754353414580239e-06
WA09,5p,2,G>C,125,41,166,4741495,4881667,9623162,1.725004733371422e-05
WA09,5p,3,G>C,140,71,211,4741672,4881750,9623422,2.192567259338726e-05
WA09,5p,4,G>C,125,115,240,4741672,4881751,9623423,2.4939151069219345e-05
WA09,5p,5,G>C,468,346,814,4741671,4881751,9623422,8.458529616595843e-05
WA09,5p,6,G>C,598,291,889,4741669,4881751,9623420,9.237880088367752e-05
WA09,5p,7,G>C,647,271,918,4741667,4881751,9623418,9.539230240232732e-05
WA09,5p,8,G>C,1035,504,1539,4741639,4881744,9623383,0.0001599229709552
WA09,5p,9,G>C,884,641,1525,4741618,4881747,9623365,0.0001584684775024
WA09,5p,10,G>C,811,502,1313,4741622,4881737,9623359,0.0001364388463529
WA09,5p,11,G>C,887,630,1517,4741614,4881733,9623347,0.0001576374623091
WA09,5p,12,G>C,1161,791,1952,4741580,4881734,9623314,0.0002028407261781
WA09,5p,13,G>C,994,743,1737,4741530,4881708,9623238,0.0001805005757937
WA09,5p,14,G>C,805,658,1463,4741498,4881705,9623203,0.0001520283838967
WA09,5p,15,G>C,1038,905,1943,4741496,4881672,9623168,0.0002019085606735
WA09,5p,16,G>C,1176,863,2039,4741451,4881636,9623087,0.000211886268928
WA09,5p,17,G>C,981,700,1681,4741476,4881638,9623114,0.0001746835795564
WA09,5p,18,G>C,1155,1066,2221,4741455,4881610,9623065,0.0002307996464743
WA09,5p,19,G>C,1359,891,2250,4741379,4881580,9622959,0.0002338158148652
WA09,5p,20,G>C,1092,883,1975,4741390,4881557,9622947,0.0002052385823178
WA09,5p,21,G>C,1101,902,2003,4741379,4881587,9622966,0.0002081478828876
WA09,5p,22,G>C,1029,1472,2501,4741354,4881580,9622934,0.0002598999431981
WA09,5p,23,G>C,1014,1131,2145,4741312,4881565,9622877,0.0002229063096202
WA09,5p,24,G>C,1011,958,1969,4741363,4881548,9622911,0.0002046158381803
WA09,5p,25,G>C,988,1026,2014,4741301,4881503,9622804,0.0002092945050112
WA11,3p,1,G>C,16,8,24,9756642,10108269,19864911,1.2081604594150965e-06
WA11,3p,2,G>C,258,26,284,9756642,10108269,19864911,1.4296565436411971e-05
WA11,3p,3,G>C,129,83,212,9756642,10108269,19864911,1.0672084058166684e-05
WA11,3p,4,G>C,167,132,299,9756642,10108267,19864909,1.505166723894884e-05
WA11,3p,5,G>C,601,860,1461,9756642,10108269,19864911,7.354676796689399e-05
WA11,3p,6,G>C,595,701,1296,9756642,10108269,19864911,6.52406648084152e-05
WA11,3p,7,G>C,847,872,1719,9756642,10108265,19864907,8.65345103302019e-05
WA11,3p,8,G>C,698,760,1458,9756629,10108160,19864789,7.339619867092472e-05
WA11,3p,9,G>C,762,988,1750,9756610,10108092,19864702,8.809596036225462e-05
WA11,3p,10,G>C,813,871,1684,9756615,10107969,19864584,8.477398771602768e-05
WA11,3p,11,G>C,892,1040,1932,9756587,10107918,19864505,9.725890476505707e-05
WA11,3p,12,G>C,1023,1079,2102,9756581,10108019,19864600,0.0001058163768714
WA11,3p,13,G>C,1023,977,2000,9756565,10107963,19864528,0.000100681979456
WA11,3p,14,G>C,952,875,1827,9756515,10107914,19864429,9.197344660649446e-05
WA11,3p,15,G>C,927,942,1869,9756471,10107972,19864443,9.408771240150053e-05
WA11,3p,16,G>C,1103,1113,2216,9756477,10108011,19864488,0.0001115558578705
WA11,3p,17,G>C,1669,1058,2727,9756469,10108044,19864513,0.0001372799826504
WA11,3p,18,G>C,892,1197,2089,9756421,10108016,19864437,0.0001051628092958
WA11,3p,19,G>C,1111,1118,2229,9756438,10108000,19864438,0.0001122105744949
WA11,3p,20,G>C,1095,1174,2269,9756433,10107963,19864396,0.0001142244647156
WA11,3p,21,G>C,1115,1216,2331,9756421,10107904,19864325,0.0001173460462411
WA11,3p,22,G>C,1111,1135,2246,9756405,10107842,19864247,0.0001130674623608
WA11,3p,23,G>C,1011,1063,2074,9756375,10107816,19864191,0.0001044089839853
WA11,3p,24,G>C,1032,1439,2471,9756358,10107704,19864062,0.0001243955037997
WA11,3p,25,G>C,1259,1412,2671,9756281,10107693,19863974,0.0001344645336325
WA11,5p,1,G>C,30,45,75,9756641,10108269,19864910,3.775501625731e-06
WA11,5p,2,G>C,437,60,497,9756471,10108196,19864667,2.5019296824859937e-05
WA11,5p,3,G>C,185,129,314,9756642,10108269,19864911,1.5806766010680844e-05
WA11,5p,4,G>C,350,812,1162,9756638,10108269,19864907,5.849511402192822e-05
WA11,5p,5,G>C,648,3736,4384,9756638,10108267,19864905,0.0002206907105772
WA11,5p,6,G>C,898,582,1480,9756642,10108269,19864911,7.450322833059761e-05
WA11,5p,7,G>C,965,520,1485,9756629,10108269,19864898,7.475497734747996e-05
WA11,5p,8,G>C,1115,786,1901,9756500,10108261,19864761,9.56970989985734e-05
WA11,5p,9,G>C,896,834,1730,9756493,10108240,19864733,8.708901347931533e-05
WA11,5p,10,G>C,827,1066,1893,9756446,10108197,19864643,9.529494187235078e-05
WA11,5p,11,G>C,1304,1423,2727,9756457,10108195,19864652,0.0001372790220538
WA11,5p,12,G>C,1151,1284,2435,9756411,10108221,19864632,0.0001225796682264
WA11,5p,13,G>C,1464,1159,2623,9756334,10108178,19864512,0.0001320445224126
WA11,5p,14,G>C,1117,1120,2237,9756261,10108167,19864428,0.0001126133609283
WA11,5p,15,G>C,1081,944,2025,9756237,10108096,19864333,0.0001019415049073
WA11,5p,16,G>C,1194,1177,2371,9756275,10108079,19864354,0.0001193595321549
WA11,5p,17,G>C,1055,1473,2528,9756369,10108078,19864447,0.0001272625409607
WA11,5p,18,G>C,1173,1259,2432,9756327,10108075,19864402,0.0001224300635881
WA11,5p,19,G>C,1309,1378,2687,9756284,10108088,19864372,0.0001352673016796
WA11,5p,20,G>C,1429,1467,2896,9756292,10108082,19864374,0.0001457886364805
WA11,5p,21,G>C,1190,1324,2514,9756251,10108036,19864287,0.00012655878361
WA11,5p,22,G>C,1446,1591,3037,9756136,10108029,19864165,0.0001528883796525
WA11,5p,23,G>C,1264,1583,2847,9756095,10108016,19864111,0.0001433238064366
WA11,5p,24,G>C,1230,1518,2748,9756046,10108010,19864056,0.0001383403268697
WA11,5p,25,G>C,1405,1267,2672,9756056,10107943,19863999,0.0001345147067315
WA12,3p,1,G>C,17,8,25,6632243,6940679,13572922,1.8419025763207067e-06
WA12,3p,2,G>C,44,28,72,6632243,6940679,13572922,5.304679419803635e-06
WA12,3p,3,G>C,70,59,129,6632243,6940679,13572922,9.504217293814848e-06
WA12,3p,4,G>C,160,130,290,6632243,6940676,13572919,2.1366074607827544e-05
WA12,3p,5,G>C,804,628,1432,6632243,6940678,13572921,0.0001055041873447
WA12,3p,6,G>C,738,686,1424,6632243,6940679,13572922,0.0001049147707472
WA12,3p,7,G>C,738,677,1415,6632243,6940676,13572919,0.0001042517088623
WA12,3p,8,G>C,826,688,1514,6632240,6940664,13572904,0.0001115457679506
WA12,3p,9,G>C,990,1102,2092,6632231,6940656,13572887,0.000154130805038
WA12,3p,10,G>C,844,1298,2142,6632228,6940644,13572872,0.0001578147940981
WA12,3p,11,G>C,844,1249,2093,6632231,6940642,13572873,0.0001542046403882
WA12,3p,12,G>C,834,1147,1981,6632223,6940615,13572838,0.0001459532634221
WA12,3p,13,G>C,978,1171,2149,6632204,6940591,13572795,0.0001583314269463
WA12,3p,14,G>C,1023,882,1905,6632209,6940533,13572742,0.0001403548376591
WA12,3p,15,G>C,1029,1011,2040,6632188,6940474,13572662,0.0001503021293833
WA12,3p,16,G>C,1005,968,1973,6632187,6940478,13572665,0.0001453657037877
WA12,3p,17,G>C,883,1041,1924,6632168,6940473,13572641,0.0001417557570409
WA12,3p,18,G>C,1057,1598,2655,6632160,6940482,13572642,0.0001956140889887
WA12,3p,19,G>C,1376,1088,2464,6632121,6940435,13572556,0.0001815428133064
WA12,3p,20,G>C,978,1041,2019,6632105,6940432,13572537,0.0001487562715798
WA12,3p,21,G>C,1115,1077,2192,6632096,6940454,13572550,0.0001615024442717
WA12,3p,22,G>C,1037,964,2001,6632039,6940438,13572477,0.0001474307158523
WA12,3p,23,G>C,940,967,1907,6631950,6940459,13572409,0.0001405056390505
WA12,3p,24,G>C,944,1196,2140,6631933,6940411,13572344,0.0001576735750287
WA12,3p,25,G>C,992,918,1910,6631986,6940428,13572414,0.000140726623871
WA12,5p,1,G>C,23,80,103,6632243,6940679,13572922,7.588638614441312e-06
WA12,5p,2,G>C,118,29,147,6631949,6940524,13572473,1.0830745436001235e-05
WA12,5p,3,G>C,119,55,174,6632242,6940678,13572920,1.2819643820194918e-05
WA12,5p,4,G>C,172,96,268,6632242,6940679,13572921,1.9745197072907152e-05
WA12,5p,5,G>C,566,447,1013,6632242,6940677,13572919,7.463390888872173e-05
WA12,5p,6,G>C,917,398,1315,6632242,6940679,13572921,9.688408265251084e-05
WA12,5p,7,G>C,792,430,1222,6632238,6940679,13572917,9.003223109667583e-05
WA12,5p,8,G>C,937,667,1604,6632204,6940670,13572874,0.0001181768872237
WA12,5p,9,G>C,1213,737,1950,6632209,6940675,13572884,0.0001436688031814
WA12,5p,10,G>C,990,790,1780,6632199,6940665,13572864,0.0001311440238405
WA12,5p,11,G>C,1104,749,1853,6632166,6940667,13572833,0.0001365227141599
WA12,5p,12,G>C,1066,924,1990,6632126,6940660,13572786,0.0001466169141692
WA12,5p,13,G>C,1059,836,1895,6632065,6940658,13572723,0.0001396182623044
WA12,5p,14,G>C,975,785,1760,6632026,6940638,13572664,0.0001296724062424
WA12,5p,15,G>C,1006,822,1828,6631987,6940631,13572618,0.0001346829329463
WA12,5p,16,G>C,1063,1061,2124,6631930,6940590,13572520,0.000156492677852
WA12,5p,17,G>C,1165,1102,2267,6631958,6940621,13572579,0.0001670279465678
WA12,5p,18,G>C,1117,1052,2169,6632019,6940577,13572596,0.0001598073058389
WA12,5p,19,G>C,992,1059,2051,6631996,6940532,13572528,0.0001511140739588
WA12,5p,20,G>C,1009,1083,2092,6631973,6940532,13572505,0.0001541351430704
WA12,5p,21,G>C,1320,1125,2445,6631936,6940534,13572470,0.0001801440710497
WA12,5p,22,G>C,1170,1202,2372,6631921,6940529,13572450,0.0001747657939428
WA12,5p,23,G>C,1166,1107,2273,6631926,6940534,13572460,0.0001674714826936
WA12,5p,24,G>C,1082,1176,2258,6631934,6940518,13572452,0.0001663664015905
WA12,5p,25,G>C,1007,1182,2189,6631933,6940515,13572448,0.0001612826219706
WA13,3p,1,G>C,3,8,11,5896847,6081528,11978375,9.183215586421364e-07
WA13,3p,2,G>C,10,4,14,5896847,6081528,11978375,1.1687728928172645e-06
WA13,3p,3,G>C,27,3,30,5896847,6081528,11978375,2.504513341751281e-06
WA13,3p,4,G>C,23,10,33,5896847,6081522,11978369,2.754966055896257e-06
WA13,3p,5,G>C,140,62,202,5896847,6081527,11978374,1.6863724575639398e-05
WA13,3p,6,G>C,101,76,177,5896847,6081528,11978375,1.4776628716332558e-05
WA13,3p,7,G>C,88,109,197,5896847,6081528,11978375,1.644630427750008e-05
WA13,3p,8,G>C,233,95,328,5896845,6081521,11978366,2.7382699777248412e-05
WA13,3p,9,G>C,186,131,317,5896842,6081517,11978359,2.646439299406538e-05
WA13,3p,10,G>C,222,213,435,5896843,6081517,11978360,3.631548893170684e-05
WA13,3p,11,G>C,202,173,375,5896841,6081492,11978333,3.1306526542549784e-05
WA13,3p,12,G>C,326,128,454,5896836,6081505,11978341,3.790174282064603e-05
WA13,3p,13,G>C,127,163,290,5896834,6081495,11978329,2.4210388610965686e-05
WA13,3p,14,G>C,121,109,230,5896832,6081501,11978333,1.9201336279430532e-05
WA13,3p,15,G>C,207,115,322,5896825,6081505,11978330,2.688187752382845e-05
WA13,3p,16,G>C,143,106,249,5896830,6081509,11978339,2.07875232116907e-05
WA13,3p,17,G>C,265,131,396,5896823,6081499,11978322,3.305972238849482e-05
WA13,3p,18,G>C,183,138,321,5896827,6081499,11978326,2.6798402381100665e-05
WA13,3p,19,G>C,199,94,293,5896822,6081480,11978302,2.4460896043529376e-05
WA13,3p,20,G>C,147,180,327,5896818,6081448,11978266,2.7299443842706448e-05
WA13,3p,21,G>C,123,132,255,5896824,6081466,11978290,2.128851447076336e-05
WA13,3p,22,G>C,196,119,315,5896824,6081460,11978284,2.629758987180468e-05
WA13,3p,23,G>C,137,267,404,5896819,6081454,11978273,3.372773353888328e-05
WA13,3p,24,G>C,170,304,474,5896803,6081440,11978243,3.957174687472946e-05
WA13,3p,25,G>C,175,347,522,5896783,6081437,11978220,4.357909605934772e-05
WA13,5p,1,G>C,11,10,21,5896847,6081528,11978375,1.753159339225897e-06
WA13,5p,2,G>C,88,8593,8681,5896725,6081443,11978168,0.0007247352015767
WA13,5p,3,G>C,31,34,65,5896847,6081528,11978375,5.426445573794442e-06
WA13,5p,4,G>C,48,45,93,5896841,6081528,11978369,7.763995248434908e-06
WA13,5p,5,G>C,64,76,140,5896841,6081528,11978369,1.1687734782590184e-05
WA13,5p,6,G>C,111,36,147,5896841,6081528,11978369,1.2272121521719693e-05
WA13,5p,7,G>C,145,40,185,5896845,6081528,11978373,1.544450151953024e-05
WA13,5p,8,G>C,155,77,232,5896843,6081526,11978369,1.936824621114945e-05
WA13,5p,9,G>C,151,125,276,5896837,6081518,11978355,2.304156121604344e-05
WA13,5p,10,G>C,100,88,188,5896833,6081518,11978351,1.569498172160759e-05
WA13,5p,11,G>C,152,126,278,5896827,6081513,11978340,2.320855811406255e-05
WA13,5p,12,G>C,175,120,295,5896822,6081502,11978324,2.462781938441472e-05
WA13,5p,13,G>C,130,79,209,5896809,6081508,11978317,1.7448194099388085e-05
WA13,5p,14,G>C,181,119,300,5896802,6081520,11978322,2.5045244233708197e-05
WA13,5p,15,G>C,115,8715,8830,5896798,6081508,11978306,0.0007371660066122
WA13,5p,16,G>C,158,141,299,5896754,6081491,11978245,2.496192054846098e-05
WA13,5p,17,G>C,122,138,260,5896805,6081514,11978319,2.170588377217204e-05
WA13,5p,18,G>C,174,232,406,5896796,6081504,11978300,3.389462611555897e-05
WA13,5p,19,G>C,142,201,343,5896797,6081472,11978269,2.8635189274844305e-05
WA13,5p,20,G>C,117,180,297,5896788,6081482,11978270,2.479489943038519e-05
WA13,5p,21,G>C,136,184,320,5896782,6081484,11978266,2.671505207848949e-05
WA13,5p,22,G>C,162,137,299,5896771,6081483,11978254,2.4961901793032606e-05
WA13,5p,23,G>C,152,125,277,5896768,6081501,11978269,2.312521116364977e-05
WA13,5p,24,G>C,126,204,330,5896781,6081498,11978279,2.754986755609884e-05
WA13,5p,25,G>C,141,245,386,5896769,6081462,11978231,3.222512573016834e-05
WA14,3p,1,G>C,9,14,23,6684341,7140972,13825313,1.663615138405908e-06
WA14,3p,2,G>C,25,49,74,6684341,7140972,13825313,5.352500880088574e-06
WA14,3p,3,G>C,81,85,166,6684341,7140972,13825313,1.2006961433712206e-05
WA14,3p,4,G>C,127,120,247,6684341,7140971,13825312,1.7865781256871454e-05
WA14,3p,5,G>C,574,664,1238,6684341,7140970,13825311,8.954590605592886e-05
WA14,3p,6,G>C,577,603,1180,6684341,7140971,13825312,8.535069588302961e-05
WA14,3p,7,G>C,746,708,1454,6684341,7140969,13825310,0.0001051694320055
WA14,3p,8,G>C,790,896,1686,6684326,7140932,13825258,0.0001219507078999
WA14,3p,9,G>C,654,854,1508,6684323,7140920,13825243,0.0001090758404752
WA14,3p,10,G>C,808,768,1576,6684256,7140912,13825168,0.0001139949981077
WA14,3p,11,G>C,804,678,1482,6684256,7140894,13825150,0.0001071959436244
WA14,3p,12,G>C,658,950,1608,6684291,7140849,13825140,0.0001163098529201
WA14,3p,13,G>C,652,912,1564,6684289,7140794,13825083,0.0001131277114213
WA14,3p,14,G>C,857,972,1829,6684291,7140742,13825033,0.0001322962484067
WA14,3p,15,G>C,1014,766,1780,6684271,7140702,13824973,0.0001287525118493
WA14,3p,16,G>C,869,897,1766,6684263,7140648,13824911,0.0001277404245134
WA14,3p,17,G>C,919,690,1609,6684212,7140653,13824865,0.0001163844999571
WA14,3p,18,G>C,745,914,1659,6684177,7140647,13824824,0.0001200015276867
WA14,3p,19,G>C,900,901,1801,6684172,7140542,13824714,0.0001302739427376
WA14,3p,20,G>C,1012,1047,2059,6684176,7140544,13824720,0.0001489361086517
WA14,3p,21,G>C,814,1082,1896,6684132,7140443,13824575,0.0001371470732373
WA14,3p,22,G>C,922,1009,1931,6684105,7140560,13824665,0.0001396778873122
WA14,3p,23,G>C,1350,1421,2771,6683638,7140562,13824200,0.0002004455954051
WA14,3p,24,G>C,1160,1293,2453,6683623,7140532,13824155,0.0001774430335886
WA14,3p,25,G>C,928,1296,2224,6683613,7140513,13824126,0.0001608781632922
WA14,5p,1,G>C,23,75,98,6684341,7140972,13825313,7.088447111468652e-06
WA14,5p,2,G>C,173,127,300,6684184,7140911,13825095,2.1699670056516792e-05
WA14,5p,3,G>C,128,620,748,6684338,7140972,13825310,5.4103669284811695e-05
WA14,5p,4,G>C,195,351,546,6684341,7140972,13825313,3.9492776763896775e-05
WA14,5p,5,G>C,566,413,979,6684341,7140972,13825313,7.081214002171235e-05
WA14,5p,6,G>C,612,989,1601,6684340,7140972,13825312,0.0001158020882277
WA14,5p,7,G>C,519,419,938,6684336,7140972,13825308,6.784658974686133e-05
WA14,5p,8,G>C,868,565,1433,6684277,7140970,13825247,0.0001036509510462
WA14,5p,9,G>C,778,1205,1983,6684241,7140959,13825200,0.0001434337297109
WA14,5p,10,G>C,672,670,1342,6684210,7140628,13824838,9.70716618885516e-05
WA14,5p,11,G>C,877,1650,2527,6684218,7140646,13824864,0.0001827866082443
WA14,5p,12,G>C,850,2185,3035,6684139,7140917,13825056,0.0002195289480201
WA14,5p,13,G>C,1003,1805,2808,6684018,7140931,13824949,0.0002031110566845
WA14,5p,14,G>C,1055,1447,2502,6683951,7140942,13824893,0.0001809778925594
WA14,5p,15,G>C,924,1956,2880,6684030,7140908,13824938,0.0002083191982488
WA14,5p,16,G>C,883,1643,2526,6683910,7140868,13824778,0.0001827154114156
WA14,5p,17,G>C,937,1002,1939,6683904,7140873,13824777,0.0001402554269048
WA14,5p,18,G>C,907,1199,2106,6683891,7140646,13824537,0.0001523378323628
WA14,5p,19,G>C,974,1406,2380,6683958,7140595,13824553,0.0001721574650551
WA14,5p,20,G>C,918,954,1872,6683860,7140558,13824418,0.0001354125721603
WA14,5p,21,G>C,984,1657,2641,6683480,7140494,13823974,0.0001910449194999
WA14,5p,22,G>C,897,1166,2063,6683768,7140398,13824166,0.0001492314256064
WA14,5p,23,G>C,773,1183,1956,6683762,7140257,13824019,0.0001414928610847
WA14,5p,24,G>C,990,1390,2380,6683714,7140421,13824135,0.0001721626705757
WA14,5p,25,G>C,1026,1161,2187,6683731,7140511,13824242,0.0001582003555782
WA18,3p,1,G>C,27,13,40,14112928,14131239,28244167,1.4162216219724235e-06
WA18,3p,2,G>C,110,50,160,14112928,14131239,28244167,5.664886487889694e-06
WA18,3p,3,G>C,239,113,352,14112928,14131239,28244167,1.2462750273357327e-05
WA18,3p,4,G>C,313,252,565,14112928,14131238,28244166,2.000413111861756e-05
WA18,3p,5,G>C,1386,1401,2787,14112928,14131239,28244167,9.86752415109286e-05
WA18,3p,6,G>C,1238,1572,2810,14112928,14131239,28244167,9.948956894356276e-05
WA18,3p,7,G>C,1665,1268,2933,14112928,14131237,28244165,0.0001038444577844
WA18,3p,8,G>C,1617,1811,3428,14112927,14131187,28244114,0.0001213704207538
WA18,3p,9,G>C,1827,1280,3107,14112909,14131177,28244086,0.0001100053299653
WA18,3p,10,G>C,1807,1505,3312,14112909,14131197,28244106,0.0001172634035575
WA18,3p,11,G>C,1464,1555,3019,14112900,14131167,28244067,0.0001068897053671
WA18,3p,12,G>C,2575,1502,4077,14112895,14131136,28244031,0.0001443490838825
WA18,3p,13,G>C,1549,1306,2855,14112898,14131061,28243959,0.0001010835626832
WA18,3p,14,G>C,1345,1316,2661,14112830,14131006,28243836,9.421524753224032e-05
WA18,3p,15,G>C,1578,1786,3364,14112809,14130957,28243766,0.0001191059294288
WA18,3p,16,G>C,1829,1400,3229,14112765,14130927,28243692,0.0001143264131332
WA18,3p,17,G>C,1610,2263,3873,14112743,14130850,28243593,0.0001371284453787
WA18,3p,18,G>C,1929,1850,3779,14112708,14130769,28243477,0.0001338008064658
WA18,3p,19,G>C,1813,1882,3695,14112724,14130771,28243495,0.0001308265850242
WA18,3p,20,G>C,2069,1577,3646,14112697,14130797,28243494,0.00012909167683
WA18,3p,21,G>C,1832,1936,3768,14112659,14130783,28243442,0.0001334115013318
WA18,3p,22,G>C,1845,1634,3479,14112575,14130715,28243290,0.0001231797003819
WA18,3p,23,G>C,1780,2008,3788,14112548,14130648,28243196,0.0001341207985101
WA18,3p,24,G>C,1977,2013,3990,14112551,14130690,28243241,0.0001412727384934
WA18,3p,25,G>C,2395,1873,4268,14112486,14130651,28243137,0.0001511163579314
WA18,5p,1,G>C,33,60,93,14112926,14131239,28244165,3.292715504246629e-06
WA18,5p,2,G>C,841,102,943,14112820,14131183,28244003,3.338761860349611e-05
WA18,5p,3,G>C,304,154,458,14112928,14131239,28244167,1.621573757158425e-05
WA18,5p,4,G>C,616,579,1195,14112928,14131239,28244167,4.230962095642616e-05
WA18,5p,5,G>C,1086,810,1896,14112925,14131239,28244164,6.712891201169912e-05
WA18,5p,6,G>C,1777,770,2547,14112927,14131239,28244166,9.01779149718919e-05
WA18,5p,7,G>C,1798,879,2677,14112921,14131239,28244160,9.478065554082685e-05
WA18,5p,8,G>C,6048,1143,7191,14112828,14131230,28244058,0.0002546022246519
WA18,5p,9,G>C,2277,1035,3312,14112833,14131230,28244063,0.0001172635820844
WA18,5p,10,G>C,1896,1020,2916,14112791,14131213,28244004,0.0001032431520686
WA18,5p,11,G>C,2002,1475,3477,14112776,14131211,28243987,0.0001231058490431
WA18,5p,12,G>C,2369,1432,3801,14112682,14131223,28243905,0.0001345777080046
WA18,5p,13,G>C,2028,1605,3633,14112608,14131206,28243814,0.0001286299364526
WA18,5p,14,G>C,2021,1147,3168,14112535,14131179,28243714,0.0001121665514669
WA18,5p,15,G>C,2475,1686,4161,14112545,14131148,28243693,0.0001473249266659
WA18,5p,16,G>C,1965,1981,3946,14112522,14131083,28243605,0.0001397130430056
WA18,5p,17,G>C,2181,2063,4244,14112485,14130990,28243475,0.000150264795674
WA18,5p,18,G>C,2118,1569,3687,14112481,14130987,28243468,0.0001305434587565
WA18,5p,19,G>C,2355,1548,3903,14112359,14130867,28243226,0.0001381924288677
WA18,5p,20,G>C,2808,1946,4754,14112397,14130866,28243263,0.0001683233272302
WA18,5p,21,G>C,2030,1663,3693,14112347,14130679,28243026,0.0001307579435716
WA18,5p,22,G>C,2565,1783,4348,14112376,14129592,28241968,0.000153955276771
WA18,5p,23,G>C,1784,1775,3559,14112288,14129275,28241563,0.0001260199373526
WA18,5p,24,G>C,2018,3001,5019,14112253,14129481,28241734,0.0001777157167474
WA18,5p,25,G>C,2348,1928,4276,14112273,14130551,28242824,0.0001514012904658
WA22,3p,1,G>C,0,1,1,1513709,1653397,3167106,3.157456681273061e-07
WA22,3p,2,G>C,2,0,2,1513709,1653396,3167105,6.314915356453291e-07
WA22,3p,3,G>C,8,3,11,1513709,1653396,3167105,3.47320344604931e-06
WA22,3p,4,G>C,6,4,10,1513709,1653394,3167103,3.1574596721357024e-06
WA22,3p,5,G>C,58,42,100,1513709,1653397,3167106,3.1574566812730615e-05
WA22,3p,6,G>C,25,41,66,1513709,1653397,3167106,2.083921409640221e-05
WA22,3p,7,G>C,78,34,112,1513709,1653397,3167106,3.5363514830258286e-05
WA22,3p,8,G>C,69,72,141,1513709,1653395,3167104,4.452016732005012e-05
WA22,3p,9,G>C,86,82,168,1513709,1653397,3167106,5.304527224538743e-05
WA22,3p,10,G>C,76,69,145,1513706,1653396,3167102,4.5783179701822045e-05
WA22,3p,11,G>C,103,103,206,1513685,1653390,3167075,6.504424429481461e-05
WA22,3p,12,G>C,93,47,140,1513662,1653379,3167041,4.420530078391786e-05
WA22,3p,13,G>C,61,89,150,1513689,1653380,3167069,4.73624035346246e-05
WA22,3p,14,G>C,43,75,118,1513686,1653352,3167038,3.725878881150147e-05
WA22,3p,15,G>C,99,141,240,1513677,1653343,3167020,7.578101811797842e-05
WA22,3p,16,G>C,99,138,237,1513637,1653341,3166978,7.483474782584534e-05
WA22,3p,17,G>C,74,143,217,1513671,1653319,3166990,6.851931960631388e-05
WA22,3p,18,G>C,82,158,240,1513665,1653288,3166953,7.57826213398178e-05
WA22,3p,19,G>C,86,84,170,1513662,1653275,3166937,5.367962798123234e-05
WA22,3p,20,G>C,75,72,147,1513684,1653304,3166988,4.641634259428832e-05
WA22,3p,21,G>C,94,90,184,1513677,1653327,3167004,5.809907407758248e-05
WA22,3p,22,G>C,118,130,248,1513684,1653356,3167040,7.83065575426897e-05
WA22,3p,23,G>C,89,105,194,1513676,1653329,3167005,6.125661310923096e-05
WA22,3p,24,G>C,97,205,302,1513672,1653285,3166957,9.535967807583115e-05
WA22,3p,25,G>C,119,120,239,1513669,1653296,3166965,7.546657446482674e-05
WA22,5p,1,G>C,5,3,8,1513709,1653397,3167106,2.525965345018449e-06
WA22,5p,2,G>C,23,23,46,1513674,1653378,3167052,1.4524548381270655e-05
WA22,5p,3,G>C,9,1,10,1513709,1653397,3167106,3.157456681273061e-06
WA22,5p,4,G>C,16,26,42,1513709,1653397,3167106,1.3261318061346858e-05
WA22,5p,5,G>C,72,29,101,1513708,1653396,3167104,3.1890332619326675e-05
WA22,5p,6,G>C,116,49,165,1513704,1653397,3167101,5.2098117489780086e-05
WA22,5p,7,G>C,65,53,118,1513707,1653397,3167104,3.725801236713414e-05
WA22,5p,8,G>C,85,96,181,1513692,1653397,3167089,5.715027269521002e-05
WA22,5p,9,G>C,154,52,206,1513700,1653389,3167089,6.504395676913405e-05
WA22,5p,10,G>C,72,37,109,1513705,1653389,3167094,3.441640822785809e-05
WA22,5p,11,G>C,106,62,168,1513699,1653381,3167080,5.304570771815047e-05
WA22,5p,12,G>C,165,55,220,1513692,1653345,3167037,6.946556039604211e-05
WA22,5p,13,G>C,101,75,176,1513697,1653377,3167074,5.5571799080160426e-05
WA22,5p,14,G>C,51,76,127,1513677,1653376,3167053,4.010037091264339e-05
WA22,5p,15,G>C,191,56,247,1513695,1653381,3167076,7.798991877681495e-05
WA22,5p,16,G>C,94,187,281,1513668,1653368,3167036,8.872649379419747e-05
WA22,5p,17,G>C,118,74,192,1513675,1653395,3167070,6.062385738237551e-05
WA22,5p,18,G>C,121,108,229,1513651,1653392,3167043,7.230719633424617e-05
WA22,5p,19,G>C,102,106,208,1513674,1653350,3167024,6.567679941800251e-05
WA22,5p,20,G>C,126,88,214,1513678,1653356,3167034,6.757110911976316e-05
WA22,5p,21,G>C,90,96,186,1513690,1653371,3167061,5.872952873342193e-05
WA22,5p,22,G>C,127,141,268,1513691,1653380,3167071,8.462077421061921e-05
WA22,5p,23,G>C,73,73,146,1513634,1653393,3167027,4.6100017461171e-05
WA22,5p,24,G>C,106,79,185,1513632,1653375,3167007,5.841477458054245e-05
WA22,5p,25,G>C,179,132,311,1513644,1653364,3167008,9.81999413957906e-05
WA25,3p,1,G>C,3,2,5,3375244,3569089,6944333,7.200115547454306e-07
WA25,3p,2,G>C,199,4,203,3375244,3569089,6944333,2.923246912266448e-05
WA25,3p,3,G>C,236,53,289,3375244,3569089,6944333,4.161666786428589e-05
WA25,3p,4,G>C,281,91,372,3375244,3569087,6944331,5.3568875101143655e-05
WA25,3p,5,G>C,451,207,658,3375244,3569089,6944333,9.475352060449866e-05
WA25,3p,6,G>C,525,179,704,3375244,3569089,6944333,0.0001013776269081
WA25,3p,7,G>C,358,206,564,3375244,3569089,6944333,8.121730337528456e-05
WA25,3p,8,G>C,501,494,995,3375239,3569076,6944315,0.0001432826707889
WA25,3p,9,G>C,518,214,732,3375240,3569076,6944316,0.0001054099496624
WA25,3p,10,G>C,359,210,569,3375240,3569075,6944315,8.193752731550915e-05
WA25,3p,11,G>C,248,367,615,3375233,3569054,6944287,8.856200787784261e-05
WA25,3p,12,G>C,398,426,824,3375226,3569069,6944295,0.000118658553532
WA25,3p,13,G>C,359,271,630,3375230,3569053,6944283,9.072210910759254e-05
WA25,3p,14,G>C,378,223,601,3375223,3569037,6944260,8.654629866969266e-05
WA25,3p,15,G>C,391,329,720,3375218,3569039,6944257,0.000103682798606
WA25,3p,16,G>C,374,353,727,3375196,3569030,6944226,0.0001046912931693
WA25,3p,17,G>C,511,388,899,3375198,3569022,6944220,0.0001294601841531
WA25,3p,18,G>C,513,372,885,3375213,3569006,6944219,0.0001274441373464
WA25,3p,19,G>C,724,313,1037,3375204,3569005,6944209,0.0001493330629881
WA25,3p,20,G>C,487,281,768,3375190,3568979,6944169,0.000110596386695
WA25,3p,21,G>C,446,316,762,3375199,3568998,6944197,0.0001097319099674
WA25,3p,22,G>C,377,273,650,3375179,3568994,6944173,9.360365877981438e-05
WA25,3p,23,G>C,313,327,640,3375175,3568972,6944147,9.216394756620216e-05
WA25,3p,24,G>C,506,314,820,3375177,3568962,6944139,0.0001180851938591
WA25,3p,25,G>C,454,403,857,3375156,3568970,6944126,0.0001234136592567
WA25,5p,1,G>C,9,8,17,3375244,3569089,6944333,2.448039286134464e-06
WA25,5p,2,G>C,127,42,169,3375147,3569045,6944192,2.4336884694432413e-05
WA25,5p,3,G>C,98,33,131,3375243,3569089,6944332,1.886430545083386e-05
WA25,5p,4,G>C,73,120,193,3375243,3569089,6944332,2.7792450015350648e-05
WA25,5p,5,G>C,196,202,398,3375244,3569088,6944332,5.731292801093035e-05
WA25,5p,6,G>C,186,194,380,3375244,3569089,6944333,5.472087816065272e-05
WA25,5p,7,G>C,337,223,560,3375242,3569089,6944331,8.064131735656033e-05
WA25,5p,8,G>C,385,227,612,3375221,3569088,6944309,8.812971888203708e-05
WA25,5p,9,G>C,326,306,632,3375227,3569087,6944314,9.100970952638374e-05
WA25,5p,10,G>C,228,257,485,3375217,3569085,6944302,6.984143258746524e-05
WA25,5p,11,G>C,278,221,499,3375193,3569088,6944281,7.185769124262109e-05
WA25,5p,12,G>C,455,292,747,3375142,3569084,6944226,0.0001075713837654
WA25,5p,13,G>C,310,301,611,3375133,3569081,6944214,8.798691975794524e-05
WA25,5p,14,G>C,297,307,604,3375151,3569071,6944222,8.69787861044765e-05
WA25,5p,15,G>C,337,363,700,3375137,3569055,6944192,0.0001008036644148
WA25,5p,16,G>C,341,270,611,3375081,3569035,6944116,8.798816148808575e-05
WA25,5p,17,G>C,334,411,745,3375076,3568871,6943947,0.0001072876852314
WA25,5p,18,G>C,358,320,678,3375102,3568996,6944098,9.763687090821586e-05
WA25,5p,19,G>C,301,407,708,3375134,3569021,6944155,0.0001019562495364
WA25,5p,20,G>C,318,480,798,3375145,3569019,6944164,0.0001149166407936
WA25,5p,21,G>C,397,391,788,3375130,3569013,6944143,0.0001134769258063
WA25,5p,22,G>C,440,648,1088,3375139,3569001,6944140,0.0001566788688016
WA25,5p,23,G>C,426,635,1061,3375144,3569002,6944146,0.0001527905663273
WA25,5p,24,G>C,431,479,910,3375124,3568967,6944091,0.0001310466697513
WA25,5p,25,G>C,430,607,1037,3375125,3568950,6944075,0.0001493359446722
WA26,3p,1,G>C,2,2,4,2709623,2900126,5609749,7.130443804170204e-07
WA26,3p,2,G>C,20,12,32,2709623,2900126,5609749,5.704355043336163e-06
WA26,3p,3,G>C,330,31,361,2709623,2900126,5609749,6.43522553326361e-05
WA26,3p,4,G>C,80,140,220,2709623,2900126,5609749,3.921744092293612e-05
WA26,3p,5,G>C,170,161,331,2709623,2900126,5609749,5.900442247950844e-05
WA26,3p,6,G>C,492,293,785,2709623,2900126,5609749,0.0001399349596568
WA26,3p,7,G>C,151,220,371,2709623,2900126,5609749,6.613486628367865e-05
WA26,3p,8,G>C,237,340,577,2709619,2900114,5609733,0.0001028569452414
WA26,3p,9,G>C,239,286,525,2709613,2900111,5609724,9.358749200495426e-05
WA26,3p,10,G>C,223,247,470,2709609,2900074,5609683,8.378370043369652e-05
WA26,3p,11,G>C,173,269,442,2709594,2900076,5609670,7.879251364162241e-05
WA26,3p,12,G>C,261,305,566,2709607,2900081,5609688,0.0001008968769742
WA26,3p,13,G>C,339,274,613,2709604,2900084,5609688,0.0001092752395498
WA26,3p,14,G>C,302,456,758,2709584,2900069,5609653,0.0001351242224786
WA26,3p,15,G>C,379,804,1183,2709593,2900082,5609675,0.0002108856573687
WA26,3p,16,G>C,267,489,756,2709580,2900075,5609655,0.0001347676461386
WA26,3p,17,G>C,312,558,870,2709570,2900078,5609648,0.0001550899450375
WA26,3p,18,G>C,232,396,628,2709582,2900059,5609641,0.0001119501230114
WA26,3p,19,G>C,230,335,565,2709567,2900016,5609583,0.0001007204991886
WA26,3p,20,G>C,259,319,578,2709563,2899983,5609546,0.0001030386416298
WA26,3p,21,G>C,662,238,900,2709562,2900021,5609583,0.0001604397332208
WA26,3p,22,G>C,227,348,575,2709522,2900007,5609529,0.0001025041496353
WA26,3p,23,G>C,225,325,550,2709541,2899974,5609515,9.804769218016174e-05
WA26,3p,24,G>C,263,283,546,2709558,2899951,5609509,9.733472216552288e-05
WA26,3p,25,G>C,599,551,1150,2709500,2900002,5609502,0.0002050092860293
WA26,5p,1,G>C,6,19,25,2709622,2900126,5609748,4.45652817203197e-06
WA26,5p,2,G>C,57,137,194,2709554,2900092,5609646,3.458328743025852e-05
WA26,5p,3,G>C,45,29,74,2709623,2900126,5609749,1.3191321037714878e-05
WA26,5p,4,G>C,56,105,161,2709623,2900126,5609749,2.8700036311785077e-05
WA26,5p,5,G>C,147,242,389,2709623,2900125,5609748,6.934357835681745e-05
WA26,5p,6,G>C,156,105,261,2709621,2900126,5609747,4.652616240981991e-05
WA26,5p,7,G>C,196,145,341,2709622,2900126,5609748,6.078704426651607e-05
WA26,5p,8,G>C,265,310,575,2709609,2900124,5609733,0.0001025004220343
WA26,5p,9,G>C,256,274,530,2709594,2900123,5609717,9.447891934655528e-05
WA26,5p,10,G>C,242,316,558,2709601,2900123,5609724,9.947013435955138e-05
WA26,5p,11,G>C,227,359,586,2709605,2900103,5609708,0.0001044617652113
WA26,5p,12,G>C,257,286,543,2709595,2900107,5609702,9.67965856296823e-05
WA26,5p,13,G>C,217,265,482,2709592,2900104,5609696,8.592265962362309e-05
WA26,5p,14,G>C,188,373,561,2709563,2900089,5609652,0.0001000062035933
WA26,5p,15,G>C,403,446,849,2709545,2900085,5609630,0.0001513468802755
WA26,5p,16,G>C,237,368,605,2709540,2900076,5609616,0.0001078505195364
WA26,5p,17,G>C,227,267,494,2709554,2900055,5609609,8.806317873491718e-05
WA26,5p,18,G>C,436,302,738,2709554,2900082,5609636,0.0001315593382529
WA26,5p,19,G>C,263,223,486,2709570,2900086,5609656,8.663632850213988e-05
WA26,5p,20,G>C,243,278,521,2709563,2900082,5609645,9.287575238718316e-05
WA26,5p,21,G>C,213,265,478,2709545,2900061,5609606,8.521097560149501e-05
WA26,5p,22,G>C,263,313,576,2709542,2900059,5609601,0.0001026810997787
WA26,5p,23,G>C,261,354,615,2709528,2900065,5609593,0.000109633622261
WA26,5p,24,G>C,293,467,760,2709495,2900057,5609552,0.0001354831901014
WA26,5p,25,G>C,310,370,680,2709506,2900041,5609547,0.0001212219097192
