Sample,End,Position,Substitution,Pos_Count,Neg_Count,Combined_Count,Pos_Total,Neg_Total,Combined_Total,Frequency
DAL192,3p,1,G>-,0,0,0,6350003,6167708,12517711,0.0
DAL192,3p,2,G>-,0,0,0,6350003,6167706,12517709,0.0
DAL192,3p,3,G>-,0,0,0,6350003,6167708,12517711,0.0
DAL192,3p,4,G>-,0,0,0,6350003,6167708,12517711,0.0
DAL192,3p,5,G>-,0,0,0,6350003,6167708,12517711,0.0
DAL192,3p,6,G>-,0,0,0,6350003,6167708,12517711,0.0
DAL192,3p,7,G>-,0,0,0,6350003,6167708,12517711,0.0
DAL192,3p,8,G>-,0,0,0,6350003,6167618,12517621,0.0
DAL192,3p,9,G>-,9,4,13,6350003,6167637,12517640,1.0385344202261769e-06
DAL192,3p,10,G>-,3,5,8,6350003,6167645,12517648,6.390976963084439e-07
DAL192,3p,11,G>-,9,2,11,6349987,6167644,12517631,8.787605258534941e-07
DAL192,3p,12,G>-,2,2,4,6349997,6167646,12517643,3.195489757936059e-07
DAL192,3p,13,G>-,2,4,6,6349992,6167621,12517613,4.793246124480761e-07
DAL192,3p,14,G>-,5,6,11,6349967,6167610,12517577,8.78764316768333e-07
DAL192,3p,15,G>-,11,7,18,6349968,6167615,12517583,1.437977283633749e-06
DAL192,3p,16,G>-,4,9,13,6349943,6167587,12517530,1.0385435465303458e-06
DAL192,3p,17,G>-,6,10,16,6349922,6167606,12517528,1.2782076461103183e-06
DAL192,3p,18,G>-,15,11,26,6349922,6167564,12517486,2.07709439419385e-06
DAL192,3p,19,G>-,33,32,65,6349921,6167519,12517440,5.192755068128946e-06
DAL192,3p,20,G>-,27,27,54,6349910,6167516,12517426,4.313985958455037e-06
DAL192,3p,21,G>-,27,10,37,6349882,6167507,12517389,2.9558880050783755e-06
DAL192,3p,22,G>-,23,21,44,6349894,6167488,12517382,3.5151120258213737e-06
DAL192,3p,23,G>-,21,20,41,6349902,6167465,12517367,3.275449221869104e-06
DAL192,3p,24,G>-,45,43,88,6349899,6167465,12517364,7.030234161122102e-06
DAL192,3p,25,G>-,61,50,111,6349856,6167384,12517240,8.867769572206013e-06
DAL192,5p,1,G>-,0,0,0,6350003,6167708,12517711,0.0
DAL192,5p,2,G>-,0,0,0,6349992,6167694,12517686,0.0
DAL192,5p,3,G>-,0,0,0,6350003,6167707,12517710,0.0
DAL192,5p,4,G>-,0,0,0,6350003,6167708,12517711,0.0
DAL192,5p,5,G>-,1,0,1,6350003,6167707,12517710,7.988681635858315e-08
DAL192,5p,6,G>-,0,0,0,6350002,6167707,12517709,0.0
DAL192,5p,7,G>-,1,0,1,6350002,6167708,12517710,7.988681635858315e-08
DAL192,5p,8,G>-,1,0,1,6349926,6167708,12517634,7.988730138618847e-08
DAL192,5p,9,G>-,12,0,12,6349914,6167708,12517622,9.586485356403957e-07
DAL192,5p,10,G>-,10,1,11,6349896,6167708,12517604,8.787624213068252e-07
DAL192,5p,11,G>-,21,6,27,6349942,6167706,12517648,2.156954725040998e-06
DAL192,5p,12,G>-,18,1,19,6349906,6167700,12517606,1.5178621215590263e-06
DAL192,5p,13,G>-,0,2,2,6349906,6167705,12517611,1.5977489634403882e-07
DAL192,5p,14,G>-,7,1,8,6349889,6167679,12517568,6.39101780793202e-07
DAL192,5p,15,G>-,8,3,11,6349890,6167649,12517539,8.787669844687522e-07
DAL192,5p,16,G>-,10,5,15,6349904,6167639,12517543,1.198318232260117e-06
DAL192,5p,17,G>-,23,3,26,6349778,6167623,12517401,2.077108498800989e-06
DAL192,5p,18,G>-,19,8,27,6349859,6167631,12517490,2.1569819508543647e-06
DAL192,5p,19,G>-,20,19,39,6349822,6167638,12517460,3.115648062785901e-06
DAL192,5p,20,G>-,20,6,26,6349836,6167621,12517457,2.0770992063324044e-06
DAL192,5p,21,G>-,37,21,58,6349784,6167624,12517408,4.633547136915247e-06
DAL192,5p,22,G>-,39,15,54,6349783,6167584,12517367,4.314006292217844e-06
DAL192,5p,23,G>-,36,25,61,6349801,6167567,12517368,4.873228940780522e-06
DAL192,5p,24,G>-,71,34,105,6349759,6167564,12517323,8.388375054314728e-06
DAL192,5p,25,G>-,53,40,93,6349777,6167551,12517328,7.429700651768493e-06
DAL193,3p,1,G>-,0,0,0,6484405,6362696,12847101,0.0
DAL193,3p,2,G>-,0,0,0,6484402,6362696,12847098,0.0
DAL193,3p,3,G>-,0,0,0,6484405,6362696,12847101,0.0
DAL193,3p,4,G>-,0,0,0,6484405,6362696,12847101,0.0
DAL193,3p,5,G>-,0,0,0,6484405,6362696,12847101,0.0
DAL193,3p,6,G>-,0,0,0,6484405,6362696,12847101,0.0
DAL193,3p,7,G>-,0,0,0,6484405,6362696,12847101,0.0
DAL193,3p,8,G>-,0,0,0,6484400,6362644,12847044,0.0
DAL193,3p,9,G>-,0,7,7,6484400,6362631,12847031,5.448729749309393e-07
DAL193,3p,10,G>-,1,4,5,6484393,6362640,12847033,3.89194921504444e-07
DAL193,3p,11,G>-,4,4,8,6484398,6362639,12847037,6.227116805221313e-07
DAL193,3p,12,G>-,1,5,6,6484368,6362594,12846962,4.6703648691418253e-07
DAL193,3p,13,G>-,2,23,25,6484385,6362543,12846928,1.945990512284337e-06
DAL193,3p,14,G>-,1,14,15,6484363,6362486,12846849,1.1676014873374787e-06
DAL193,3p,15,G>-,5,8,13,6484332,6362438,12846770,1.011927511740305e-06
DAL193,3p,16,G>-,49,21,70,6484341,6362460,12846801,5.448827299496583e-06
DAL193,3p,17,G>-,25,35,60,6484294,6362445,12846739,4.6704459396271695e-06
DAL193,3p,18,G>-,62,44,106,6484244,6362380,12846624,8.251195022131885e-06
DAL193,3p,19,G>-,172,40,212,6484265,6362400,12846665,1.6502337377054667e-05
DAL193,3p,20,G>-,76,53,129,6484261,6362382,12846643,1.0041533807703694e-05
DAL193,3p,21,G>-,73,36,109,6484248,6362443,12846691,8.484675158762672e-06
DAL193,3p,22,G>-,35,52,87,6484224,6362407,12846631,6.772203545038384e-06
DAL193,3p,23,G>-,42,55,97,6484218,6362399,12846617,7.550625974137782e-06
DAL193,3p,24,G>-,76,69,145,6484164,6362319,12846483,1.1287135942187446e-05
DAL193,3p,25,G>-,84,62,146,6484128,6362355,12846483,1.1364978259030118e-05
DAL193,5p,1,G>-,0,0,0,6484405,6362696,12847101,0.0
DAL193,5p,2,G>-,0,0,0,6484386,6362681,12847067,0.0
DAL193,5p,3,G>-,0,0,0,6484400,6362696,12847096,0.0
DAL193,5p,4,G>-,0,0,0,6484403,6362696,12847099,0.0
DAL193,5p,5,G>-,0,0,0,6484403,6362696,12847099,0.0
DAL193,5p,6,G>-,0,0,0,6484404,6362696,12847100,0.0
DAL193,5p,7,G>-,0,0,0,6484404,6362696,12847100,0.0
DAL193,5p,8,G>-,0,0,0,6484314,6362693,12847007,0.0
DAL193,5p,9,G>-,10,0,10,6484295,6362695,12846990,7.783924483478231e-07
DAL193,5p,10,G>-,3,0,3,6484284,6362694,12846978,2.3351795262668e-07
DAL193,5p,11,G>-,8,3,11,6484315,6362677,12846992,8.562315598857693e-07
DAL193,5p,12,G>-,25,2,27,6484218,6362670,12846888,2.1016762970144987e-06
DAL193,5p,13,G>-,2,2,4,6484143,6362652,12846795,3.113617053903328e-07
DAL193,5p,14,G>-,4,9,13,6484145,6362627,12846772,1.0119273542022851e-06
DAL193,5p,15,G>-,12,2,14,6484166,6362534,12846700,1.089774027571283e-06
DAL193,5p,16,G>-,16,5,21,6484111,6362519,12846630,1.6346699484611917e-06
DAL193,5p,17,G>-,25,6,31,6484043,6362598,12846641,2.4130821434178786e-06
DAL193,5p,18,G>-,32,17,49,6483967,6362571,12846538,3.814257195206989e-06
DAL193,5p,19,G>-,102,31,133,6483980,6362593,12846573,1.035295560925081e-05
DAL193,5p,20,G>-,34,52,86,6483952,6362554,12846506,6.694427262946049e-06
DAL193,5p,21,G>-,50,39,89,6484003,6362532,12846535,6.927938156086447e-06
DAL193,5p,22,G>-,46,36,82,6484010,6362499,12846509,6.3830570624284e-06
DAL193,5p,23,G>-,77,42,119,6483966,6362463,12846429,9.263274642314996e-06
DAL193,5p,24,G>-,232,50,282,6483905,6362426,12846331,2.1951793083955256e-05
DAL193,5p,25,G>-,168,90,258,6483942,6362403,12846345,2.008353348754062e-05
DAL195,3p,1,G>-,0,0,0,2363278,2267461,4630739,0.0
DAL195,3p,2,G>-,0,0,0,2363278,2267460,4630738,0.0
DAL195,3p,3,G>-,0,0,0,2363278,2267461,4630739,0.0
DAL195,3p,4,G>-,0,0,0,2363278,2267461,4630739,0.0
DAL195,3p,5,G>-,0,1,1,2363278,2267461,4630739,2.159482536156756e-07
DAL195,3p,6,G>-,0,0,0,2363278,2267461,4630739,0.0
DAL195,3p,7,G>-,0,0,0,2363278,2267461,4630739,0.0
DAL195,3p,8,G>-,0,0,0,2363278,2267413,4630691,0.0
DAL195,3p,9,G>-,1,0,1,2363276,2267438,4630714,2.1594941946317565e-07
DAL195,3p,10,G>-,0,2,2,2363274,2267432,4630706,4.318995850740686e-07
DAL195,3p,11,G>-,2,5,7,2363274,2267431,4630705,1.511648874199501e-06
DAL195,3p,12,G>-,0,3,3,2363273,2267414,4630687,6.478520357778446e-07
DAL195,3p,13,G>-,2,4,6,2363269,2267412,4630681,1.2957057504069056e-06
DAL195,3p,14,G>-,5,0,5,2363250,2267410,4630660,1.0797596886836866e-06
DAL195,3p,15,G>-,3,10,13,2363254,2267411,4630665,2.8073721592902963e-06
DAL195,3p,16,G>-,3,11,14,2363259,2267394,4630653,3.0233316985746936e-06
DAL195,3p,17,G>-,8,11,19,2363234,2267398,4630632,4.103111627095394e-06
DAL195,3p,18,G>-,6,6,12,2363236,2267374,4630610,2.5914512342866275e-06
DAL195,3p,19,G>-,10,18,28,2363215,2267369,4630584,6.0467534980468985e-06
DAL195,3p,20,G>-,9,11,20,2363222,2267380,4630602,4.319092852290048e-06
DAL195,3p,21,G>-,14,19,33,2363235,2267382,4630617,7.126480121331563e-06
DAL195,3p,22,G>-,16,15,31,2363231,2267383,4630614,6.69457657235088e-06
DAL195,3p,23,G>-,11,16,27,2363219,2267370,4630589,5.830791720016611e-06
DAL195,3p,24,G>-,22,34,56,2363198,2267373,4630571,1.2093540947757846e-05
DAL195,3p,25,G>-,37,34,71,2363180,2267377,4630557,1.533292863040019e-05
DAL195,5p,1,G>-,0,0,0,2363278,2267461,4630739,0.0
DAL195,5p,2,G>-,0,0,0,2363264,2267447,4630711,0.0
DAL195,5p,3,G>-,0,0,0,2363278,2267459,4630737,0.0
DAL195,5p,4,G>-,0,0,0,2363278,2267461,4630739,0.0
DAL195,5p,5,G>-,0,0,0,2363277,2267461,4630738,0.0
DAL195,5p,6,G>-,0,0,0,2363277,2267461,4630738,0.0
DAL195,5p,7,G>-,1,0,1,2363277,2267461,4630738,2.1594830024933394e-07
DAL195,5p,8,G>-,0,0,0,2363212,2267460,4630672,0.0
DAL195,5p,9,G>-,2,0,2,2363181,2267461,4630642,4.3190555434861946e-07
DAL195,5p,10,G>-,8,1,9,2363146,2267458,4630604,1.943590944075546e-06
DAL195,5p,11,G>-,8,9,17,2362948,2267450,4630398,3.67139066663384e-06
DAL195,5p,12,G>-,7,1,8,2362864,2267454,4630318,1.727743105333154e-06
DAL195,5p,13,G>-,7,1,8,2363073,2267445,4630518,1.727668481150489e-06
DAL195,5p,14,G>-,6,3,9,2363094,2267434,4630528,1.943622843874392e-06
DAL195,5p,15,G>-,10,7,17,2363178,2267432,4630610,3.671222581906056e-06
DAL195,5p,16,G>-,17,7,24,2363170,2267429,4630599,5.182914780571584e-06
DAL195,5p,17,G>-,18,7,25,2363159,2267431,4630590,5.398880056321117e-06
DAL195,5p,18,G>-,25,2,27,2363182,2267420,4630602,5.830775350591564e-06
DAL195,5p,19,G>-,13,4,17,2363138,2267420,4630558,3.6712638088109463e-06
DAL195,5p,20,G>-,16,7,23,2363110,2267401,4630511,4.967054392053058e-06
DAL195,5p,21,G>-,18,2,20,2363086,2267400,4630486,4.319201051466304e-06
DAL195,5p,22,G>-,17,5,22,2363094,2267388,4630482,4.751125260825979e-06
DAL195,5p,23,G>-,19,2,21,2363068,2267398,4630466,4.535180692396834e-06
DAL195,5p,24,G>-,25,13,38,2363067,2267402,4630469,8.206512126525412e-06
DAL195,5p,25,G>-,31,29,60,2363135,2267374,4630509,1.2957538793251454e-05
DAL212,3p,1,G>-,0,0,0,4131322,4008153,8139475,0.0
DAL212,3p,2,G>-,0,0,0,4131322,4008153,8139475,0.0
DAL212,3p,3,G>-,0,0,0,4131322,4008153,8139475,0.0
DAL212,3p,4,G>-,0,0,0,4131322,4008153,8139475,0.0
DAL212,3p,5,G>-,0,0,0,4131322,4008151,8139473,0.0
DAL212,3p,6,G>-,0,0,0,4131322,4008151,8139473,0.0
DAL212,3p,7,G>-,0,0,0,4131322,4008153,8139475,0.0
DAL212,3p,8,G>-,0,0,0,4131319,4008093,8139412,0.0
DAL212,3p,9,G>-,4,5,9,4131316,4008115,8139431,1.1057283979678678e-06
DAL212,3p,10,G>-,7,8,15,4131317,4008102,8139419,1.8428833802510968e-06
DAL212,3p,11,G>-,12,4,16,4131313,4008105,8139418,1.9657425137767835e-06
DAL212,3p,12,G>-,19,4,23,4131314,4008034,8139348,2.825779165603928e-06
DAL212,3p,13,G>-,10,7,17,4131307,4007923,8139230,2.08864966342025e-06
DAL212,3p,14,G>-,18,6,24,4131271,4007904,8139175,2.948701803315446e-06
DAL212,3p,15,G>-,22,16,38,4131254,4007935,8139189,4.66876982461029e-06
DAL212,3p,16,G>-,16,14,30,4131236,4007982,8139218,3.685857781423228e-06
DAL212,3p,17,G>-,18,33,51,4131249,4007981,8139230,6.265948990260749e-06
DAL212,3p,18,G>-,26,41,67,4131222,4007954,8139176,8.231791522876517e-06
DAL212,3p,19,G>-,60,45,105,4131233,4007956,8139189,1.2900548199581063e-05
DAL212,3p,20,G>-,52,35,87,4131221,4007928,8139149,1.0689078182497948e-05
DAL212,3p,21,G>-,45,34,79,4131228,4007917,8139145,9.706179211698526e-06
DAL212,3p,22,G>-,51,42,93,4131183,4007898,8139081,1.1426351451717952e-05
DAL212,3p,23,G>-,102,70,172,4131172,4007904,8139076,2.1132619968163463e-05
DAL212,3p,24,G>-,97,70,167,4131124,4007904,8139028,2.05184206271314e-05
DAL212,3p,25,G>-,128,100,228,4131071,4007924,8138995,2.8013286652713265e-05
DAL212,5p,1,G>-,0,0,0,4131322,4008153,8139475,0.0
DAL212,5p,2,G>-,0,0,0,4131307,4008143,8139450,0.0
DAL212,5p,3,G>-,0,0,0,4131321,4008153,8139474,0.0
DAL212,5p,4,G>-,0,0,0,4131322,4008153,8139475,0.0
DAL212,5p,5,G>-,0,0,0,4131322,4008153,8139475,0.0
DAL212,5p,6,G>-,0,0,0,4131322,4008153,8139475,0.0
DAL212,5p,7,G>-,1,0,1,4131322,4008153,8139475,1.228580467413439e-07
DAL212,5p,8,G>-,2,0,2,4131248,4008153,8139401,2.4571832742974574e-07
DAL212,5p,9,G>-,24,2,26,4131243,4008153,8139396,3.194340218856534e-06
DAL212,5p,10,G>-,15,5,20,4131179,4008148,8139327,2.4572056141742438e-06
DAL212,5p,11,G>-,23,14,37,4131234,4008143,8139377,4.545802461294028e-06
DAL212,5p,12,G>-,18,14,32,4131187,4008141,8139328,3.931528499650094e-06
DAL212,5p,13,G>-,16,8,24,4131181,4008142,8139323,2.948648186096067e-06
DAL212,5p,14,G>-,14,2,16,4131134,4008108,8139242,1.965785020275844e-06
DAL212,5p,15,G>-,32,17,49,4131156,4008091,8139247,6.0202129263309e-06
DAL212,5p,16,G>-,56,12,68,4131154,4008081,8139235,8.354593521381309e-06
DAL212,5p,17,G>-,99,25,124,4131159,4008081,8139240,1.5234837650689744e-05
DAL212,5p,18,G>-,78,24,102,4131113,4008066,8139179,1.2531976505247027e-05
DAL212,5p,19,G>-,61,15,76,4131040,4008052,8139092,9.337650932069572e-06
DAL212,5p,20,G>-,57,19,76,4131020,4008040,8139060,9.337687644519148e-06
DAL212,5p,21,G>-,53,21,74,4130973,4008040,8139013,9.092011525230393e-06
DAL212,5p,22,G>-,88,27,115,4131015,4007967,8138982,1.4129531187069833e-05
DAL212,5p,23,G>-,88,34,122,4131005,4007962,8138967,1.498961723275202e-05
DAL212,5p,24,G>-,106,74,180,4131060,4007918,8138978,2.211579881405257e-05
DAL212,5p,25,G>-,104,85,189,4131016,4007614,8138630,2.3222581687581324e-05
DAL218,3p,1,G>-,0,0,0,6952891,6658031,13610922,0.0
DAL218,3p,2,G>-,0,0,0,6952891,6658031,13610922,0.0
DAL218,3p,3,G>-,0,0,0,6952891,6658030,13610921,0.0
DAL218,3p,4,G>-,0,0,0,6952891,6658031,13610922,0.0
DAL218,3p,5,G>-,0,0,0,6952891,6658031,13610922,0.0
DAL218,3p,6,G>-,0,0,0,6952891,6658030,13610921,0.0
DAL218,3p,7,G>-,0,0,0,6952891,6658026,13610917,0.0
DAL218,3p,8,G>-,0,1,1,6952887,6657945,13610832,7.347089435825819e-08
DAL218,3p,9,G>-,0,19,19,6952882,6657945,13610827,1.395947505614464e-06
DAL218,3p,10,G>-,7,12,19,6952881,6657960,13610841,1.3959460697542496e-06
DAL218,3p,11,G>-,6,29,35,6952866,6657905,13610771,2.5714928272615856e-06
DAL218,3p,12,G>-,7,7,14,6952858,6657882,13610740,1.028599473650955e-06
DAL218,3p,13,G>-,4,13,17,6952870,6657811,13610681,1.2490190608390572e-06
DAL218,3p,14,G>-,6,9,15,6952816,6657779,13610595,1.1020826054996123e-06
DAL218,3p,15,G>-,5,26,31,6952788,6657738,13610526,2.277648931422636e-06
DAL218,3p,16,G>-,15,83,98,6952760,6657689,13610449,7.200350260303683e-06
DAL218,3p,17,G>-,1,60,61,6952737,6657651,13610388,4.481870759305319e-06
DAL218,3p,18,G>-,34,111,145,6952711,6657672,13610383,1.065363112852886e-05
DAL218,3p,19,G>-,27,82,109,6952716,6657697,13610413,8.008574023433382e-06
DAL218,3p,20,G>-,33,87,120,6952697,6657752,13610449,8.81675542078002e-06
DAL218,3p,21,G>-,40,130,170,6952660,6657692,13610352,1.249049253097936e-05
DAL218,3p,22,G>-,35,80,115,6952654,6657637,13610291,8.449488699396654e-06
DAL218,3p,23,G>-,44,190,234,6952651,6657632,13610283,1.719288276371623e-05
DAL218,3p,24,G>-,61,126,187,6952669,6657588,13610257,1.3739637686488947e-05
DAL218,3p,25,G>-,104,108,212,6952605,6657566,13610171,1.5576586069344755e-05
DAL218,5p,1,G>-,0,0,0,6952891,6658031,13610922,0.0
DAL218,5p,2,G>-,0,0,0,6952874,6658014,13610888,0.0
DAL218,5p,3,G>-,0,0,0,6952891,6658031,13610922,0.0
DAL218,5p,4,G>-,0,0,0,6952891,6658031,13610922,0.0
DAL218,5p,5,G>-,0,0,0,6952891,6658031,13610922,0.0
DAL218,5p,6,G>-,0,0,0,6952891,6658031,13610922,0.0
DAL218,5p,7,G>-,0,0,0,6952888,6658031,13610919,0.0
DAL218,5p,8,G>-,0,0,0,6952719,6658029,13610748,0.0
DAL218,5p,9,G>-,6,2,8,6952736,6658029,13610765,5.877700481934704e-07
DAL218,5p,10,G>-,4,2,6,6952716,6658028,13610744,4.408282162973604e-07
DAL218,5p,11,G>-,3,8,11,6952715,6658016,13610731,8.081858351325877e-07
DAL218,5p,12,G>-,9,5,14,6952625,6658005,13610630,1.0286077867078894e-06
DAL218,5p,13,G>-,14,3,17,6952475,6658005,13610480,1.2490375063921332e-06
DAL218,5p,14,G>-,16,6,22,6952554,6657955,13610509,1.6163980347832691e-06
DAL218,5p,15,G>-,28,4,32,6952449,6657923,13610372,2.351148080302287e-06
DAL218,5p,16,G>-,45,11,56,6952253,6657920,13610173,4.1145693004784e-06
DAL218,5p,17,G>-,69,9,78,6952350,6657874,13610224,5.730985764819154e-06
DAL218,5p,18,G>-,50,34,84,6952457,6657843,13610300,6.171796360109623e-06
DAL218,5p,19,G>-,95,36,131,6952296,6657770,13610066,9.625228856347942e-06
DAL218,5p,20,G>-,115,22,137,6952289,6657772,13610061,1.006608273100319e-05
DAL218,5p,21,G>-,135,39,174,6952371,6657729,13610100,1.278462318425287e-05
DAL218,5p,22,G>-,88,69,157,6952322,6657786,13610108,1.1535544023603634e-05
DAL218,5p,23,G>-,93,63,156,6952288,6657745,13610033,1.146213238424918e-05
DAL218,5p,24,G>-,140,63,203,6952375,6657772,13610147,1.491534220754559e-05
DAL218,5p,25,G>-,149,97,246,6952272,6657720,13609992,1.8074955517975324e-05
DAL224,3p,1,G>-,0,0,0,4609472,4586477,9195949,0.0
DAL224,3p,2,G>-,0,0,0,4609471,4586476,9195947,0.0
DAL224,3p,3,G>-,0,0,0,4609472,4586477,9195949,0.0
DAL224,3p,4,G>-,0,0,0,4609472,4586477,9195949,0.0
DAL224,3p,5,G>-,0,0,0,4609472,4586477,9195949,0.0
DAL224,3p,6,G>-,0,0,0,4609472,4586477,9195949,0.0
DAL224,3p,7,G>-,0,0,0,4609472,4586476,9195948,0.0
DAL224,3p,8,G>-,0,0,0,4609469,4586423,9195892,0.0
DAL224,3p,9,G>-,1,3,4,4609466,4586431,9195897,4.349765988027052e-07
DAL224,3p,10,G>-,2,2,4,4609461,4586371,9195832,4.349796733998621e-07
DAL224,3p,11,G>-,7,4,11,4609461,4586382,9195843,1.196192670971003e-06
DAL224,3p,12,G>-,1,9,10,4609458,4586384,9195842,1.0874480009552143e-06
DAL224,3p,13,G>-,5,13,18,4609454,4586364,9195818,1.9574115103191477e-06
DAL224,3p,14,G>-,2,15,17,4609412,4586293,9195705,1.8486891434642584e-06
DAL224,3p,15,G>-,6,14,20,4609400,4586272,9195672,2.1749362091209865e-06
DAL224,3p,16,G>-,3,33,36,4609379,4586240,9195619,3.914907740305465e-06
DAL224,3p,17,G>-,9,25,34,4609381,4586216,9195597,3.697421711717032e-06
DAL224,3p,18,G>-,18,15,33,4609363,4586282,9195645,3.5886552819296525e-06
DAL224,3p,19,G>-,21,24,45,4609353,4586195,9195548,4.893672459759875e-06
DAL224,3p,20,G>-,19,21,40,4609344,4586225,9195569,4.349921141367108e-06
DAL224,3p,21,G>-,32,51,83,4609343,4586223,9195566,9.026089313045003e-06
DAL224,3p,22,G>-,14,33,47,4609324,4586172,9195496,5.111197916893227e-06
DAL224,3p,23,G>-,28,44,72,4609323,4586083,9195406,7.82999684842627e-06
DAL224,3p,24,G>-,53,58,111,4609325,4586202,9195527,1.2071086300980902e-05
DAL224,3p,25,G>-,55,74,129,4609265,4586173,9195438,1.402869553358959e-05
DAL224,5p,1,G>-,0,0,0,4609472,4586477,9195949,0.0
DAL224,5p,2,G>-,0,0,0,4609461,4586469,9195930,0.0
DAL224,5p,3,G>-,0,0,0,4609468,4586477,9195945,0.0
DAL224,5p,4,G>-,0,0,0,4609471,4586477,9195948,0.0
DAL224,5p,5,G>-,0,0,0,4609471,4586477,9195948,0.0
DAL224,5p,6,G>-,0,0,0,4609472,4586477,9195949,0.0
DAL224,5p,7,G>-,0,0,0,4609471,4586477,9195948,0.0
DAL224,5p,8,G>-,0,0,0,4609397,4586477,9195874,0.0
DAL224,5p,9,G>-,10,1,11,4609357,4586473,9195830,1.196194362009737e-06
DAL224,5p,10,G>-,8,2,10,4609338,4586470,9195808,1.0874520216168063e-06
DAL224,5p,11,G>-,6,3,9,4609388,4586469,9195857,9.78701604429038e-07
DAL224,5p,12,G>-,6,2,8,4609357,4586464,9195821,8.699603874412084e-07
DAL224,5p,13,G>-,16,4,20,4609320,4586461,9195781,2.174910429032618e-06
DAL224,5p,14,G>-,10,6,16,4609270,4586428,9195698,1.7399440477492846e-06
DAL224,5p,15,G>-,9,4,13,4609299,4586416,9195715,1.413701925298903e-06
DAL224,5p,16,G>-,15,26,41,4609292,4586373,9195665,4.458622622724947e-06
DAL224,5p,17,G>-,34,18,52,4609285,4586385,9195670,5.654835373605186e-06
DAL224,5p,18,G>-,29,16,45,4609226,4586351,9195577,4.893657026633565e-06
DAL224,5p,19,G>-,23,35,58,4609203,4586337,9195540,6.307405546601939e-06
DAL224,5p,20,G>-,36,9,45,4609148,4586313,9195461,4.893718759722868e-06
DAL224,5p,21,G>-,27,22,49,4609195,4586347,9195542,5.328669044195546e-06
DAL224,5p,22,G>-,25,15,40,4609138,4586312,9195450,4.349977434492058e-06
DAL224,5p,23,G>-,37,28,65,4609100,4586313,9195413,7.068741773751761e-06
DAL224,5p,24,G>-,76,45,121,4609109,4586316,9195425,1.3158717514416136e-05
DAL224,5p,25,G>-,73,54,127,4609125,4586257,9195382,1.381128048840168e-05
DAL227,3p,1,G>-,0,0,0,3765386,3771243,7536629,0.0
DAL227,3p,2,G>-,0,0,0,3765386,3771243,7536629,0.0
DAL227,3p,3,G>-,0,0,0,3765386,3771243,7536629,0.0
DAL227,3p,4,G>-,0,0,0,3765386,3771243,7536629,0.0
DAL227,3p,5,G>-,0,0,0,3765386,3771243,7536629,0.0
DAL227,3p,6,G>-,0,0,0,3765386,3771243,7536629,0.0
DAL227,3p,7,G>-,0,0,0,3765386,3771243,7536629,0.0
DAL227,3p,8,G>-,0,1,1,3765386,3771207,7536593,1.326859497388276e-07
DAL227,3p,9,G>-,1,4,5,3765384,3771218,7536602,6.634289564448275e-07
DAL227,3p,10,G>-,2,5,7,3765382,3771209,7536591,9.288018946497164e-07
DAL227,3p,11,G>-,3,4,7,3765378,3771214,7536592,9.288017714107384e-07
DAL227,3p,12,G>-,2,0,2,3765377,3771173,7536550,2.65373413564562e-07
DAL227,3p,13,G>-,1,4,5,3765373,3771183,7536556,6.634330057389609e-07
DAL227,3p,14,G>-,0,0,0,3765341,3771166,7536507,0.0
DAL227,3p,15,G>-,1,7,8,3765341,3771186,7536527,1.0614968937283712e-06
DAL227,3p,16,G>-,1,5,6,3765340,3771079,7536419,7.961340790632792e-07
DAL227,3p,17,G>-,3,6,9,3765328,3771049,7536377,1.1942077738414623e-06
DAL227,3p,18,G>-,8,12,20,3765321,3771036,7536357,2.653802095627901e-06
DAL227,3p,19,G>-,9,11,20,3765313,3771111,7536424,2.6537785029080105e-06
DAL227,3p,20,G>-,12,12,24,3765308,3771082,7536390,3.184548570336726e-06
DAL227,3p,21,G>-,10,12,22,3765307,3771104,7536411,2.9191613886238424e-06
DAL227,3p,22,G>-,12,27,39,3765309,3771137,7536446,5.174852974465684e-06
DAL227,3p,23,G>-,9,22,31,3765319,3771112,7536431,4.113352858932829e-06
DAL227,3p,24,G>-,31,39,70,3765312,3771081,7536393,9.288262966116549e-06
DAL227,3p,25,G>-,46,52,98,3765249,3771100,7536349,1.300364407221587e-05
DAL227,5p,1,G>-,0,0,0,3765386,3771243,7536629,0.0
DAL227,5p,2,G>-,0,0,0,3765373,3771238,7536611,0.0
DAL227,5p,3,G>-,0,0,0,3765386,3771243,7536629,0.0
DAL227,5p,4,G>-,0,0,0,3765385,3771243,7536628,0.0
DAL227,5p,5,G>-,0,0,0,3765386,3771242,7536628,0.0
DAL227,5p,6,G>-,0,0,0,3765386,3771243,7536629,0.0
DAL227,5p,7,G>-,0,0,0,3765386,3771243,7536629,0.0
DAL227,5p,8,G>-,0,0,0,3765342,3771242,7536584,0.0
DAL227,5p,9,G>-,2,0,2,3765324,3771243,7536567,2.6537281496999893e-07
DAL227,5p,10,G>-,3,1,4,3765318,3771238,7536556,5.307464045911687e-07
DAL227,5p,11,G>-,4,1,5,3765365,3771237,7536602,6.634289564448275e-07
DAL227,5p,12,G>-,2,3,5,3765326,3771232,7536558,6.634328296816663e-07
DAL227,5p,13,G>-,0,1,1,3765325,3771231,7536556,1.3268660114779217e-07
DAL227,5p,14,G>-,4,21,25,3765297,3771226,7536523,3.317179553489056e-06
DAL227,5p,15,G>-,10,1,11,3765318,3771201,7536519,1.4595597781946812e-06
DAL227,5p,16,G>-,4,7,11,3765316,3771188,7536504,1.4595626831751169e-06
DAL227,5p,17,G>-,6,1,7,3765326,3771175,7536501,9.288129862916492e-07
DAL227,5p,18,G>-,8,4,12,3765280,3771169,7536449,1.5922618198570706e-06
DAL227,5p,19,G>-,9,4,13,3765279,3771164,7536443,1.7249516781325088e-06
DAL227,5p,20,G>-,22,9,31,3765254,3771167,7536421,4.113358316898698e-06
DAL227,5p,21,G>-,22,6,28,3765270,3771169,7536439,3.715282509418573e-06
DAL227,5p,22,G>-,13,5,18,3765253,3771158,7536411,2.3884047725104164e-06
DAL227,5p,23,G>-,22,13,35,3765254,3771157,7536411,4.644120390992477e-06
DAL227,5p,24,G>-,35,18,53,3765270,3771180,7536450,7.032488771238448e-06
DAL227,5p,25,G>-,50,38,88,3765247,3771148,7536395,1.1676670344375526e-05
WA02,3p,1,G>-,0,0,0,6552698,6754258,13306956,0.0
WA02,3p,2,G>-,0,0,0,6552698,6754258,13306956,0.0
WA02,3p,3,G>-,0,0,0,6552698,6754258,13306956,0.0
WA02,3p,4,G>-,0,0,0,6552698,6754256,13306954,0.0
WA02,3p,5,G>-,0,0,0,6552698,6754256,13306954,0.0
WA02,3p,6,G>-,0,0,0,6552698,6754257,13306955,0.0
WA02,3p,7,G>-,0,0,0,6552698,6754257,13306955,0.0
WA02,3p,8,G>-,1,3,4,6552692,6754207,13306899,3.005959540235482e-07
WA02,3p,9,G>-,12,25,37,6552688,6754191,13306879,2.7805167537782526e-06
WA02,3p,10,G>-,25,31,56,6552680,6754207,13306887,4.208347151366056e-06
WA02,3p,11,G>-,34,31,65,6552667,6754202,13306869,4.884695265279909e-06
WA02,3p,12,G>-,11,40,51,6552670,6754189,13306859,3.832609934470636e-06
WA02,3p,13,G>-,27,28,55,6552675,6754177,13306852,4.133208966328024e-06
WA02,3p,14,G>-,34,55,89,6552653,6754155,13306808,6.688305715390197e-06
WA02,3p,15,G>-,47,46,93,6552632,6754146,13306778,6.9889194814853e-06
WA02,3p,16,G>-,39,54,93,6552629,6754119,13306748,6.98893523797099e-06
WA02,3p,17,G>-,56,72,128,6552608,6754116,13306724,9.619197031515797e-06
WA02,3p,18,G>-,57,83,140,6552611,6754085,13306696,1.0521018891541522e-05
WA02,3p,19,G>-,63,73,136,6552605,6754056,13306661,1.022044523415754e-05
WA02,3p,20,G>-,68,91,159,6552618,6754033,13306651,1.1948911863698836e-05
WA02,3p,21,G>-,70,80,150,6552597,6754089,13306686,1.1272528712257883e-05
WA02,3p,22,G>-,58,92,150,6552593,6754062,13306655,1.1272554973432467e-05
WA02,3p,23,G>-,66,134,200,6552585,6754052,13306637,1.503009362921676e-05
WA02,3p,24,G>-,151,241,392,6552556,6754026,13306582,2.9459105275870243e-05
WA02,3p,25,G>-,204,215,419,6552517,6754038,13306555,3.148824019440043e-05
WA02,5p,1,G>-,0,0,0,6552698,6754258,13306956,0.0
WA02,5p,2,G>-,0,0,0,6552562,6754179,13306741,0.0
WA02,5p,3,G>-,0,0,0,6552698,6754258,13306956,0.0
WA02,5p,4,G>-,0,0,0,6552698,6754258,13306956,0.0
WA02,5p,5,G>-,1,0,1,6552698,6754258,13306956,7.514866660714894e-08
WA02,5p,6,G>-,1,0,1,6552697,6754258,13306955,7.514867225447144e-08
WA02,5p,7,G>-,3,0,3,6552685,6754258,13306943,2.2544622006722358e-07
WA02,5p,8,G>-,2,1,3,6552655,6754257,13306912,2.254467452704279e-07
WA02,5p,9,G>-,37,2,39,6552662,6754226,13306888,2.9308129744535317e-06
WA02,5p,10,G>-,31,12,43,6552618,6754222,13306840,3.23142083319556e-06
WA02,5p,11,G>-,40,17,57,6552625,6754225,13306850,4.283508117999376e-06
WA02,5p,12,G>-,23,29,52,6552628,6754236,13306864,3.907757680547423e-06
WA02,5p,13,G>-,45,20,65,6552614,6754205,13306819,4.88471361938567e-06
WA02,5p,14,G>-,40,31,71,6552607,6754183,13306790,5.335621889276076e-06
WA02,5p,15,G>-,49,15,64,6552586,6754168,13306754,4.809587672545836e-06
WA02,5p,16,G>-,53,26,79,6552525,6754178,13306703,5.936857537137487e-06
WA02,5p,17,G>-,60,33,93,6552567,6754148,13306715,6.988952570187308e-06
WA02,5p,18,G>-,47,46,93,6552548,6754087,13306635,6.988994588038223e-06
WA02,5p,19,G>-,52,54,106,6552516,6754124,13306640,7.965947827550757e-06
WA02,5p,20,G>-,64,62,126,6552507,6754132,13306639,9.46895756321337e-06
WA02,5p,21,G>-,59,53,112,6552521,6754152,13306673,8.416829661328568e-06
WA02,5p,22,G>-,77,47,124,6552516,6754117,13306633,9.318660851321292e-06
WA02,5p,23,G>-,85,74,159,6552465,6754131,13306596,1.1948961251998633e-05
WA02,5p,24,G>-,137,156,293,6552457,6754135,13306592,2.2019161630566265e-05
WA02,5p,25,G>-,208,217,425,6552470,6754083,13306553,3.1939150582423565e-05
WA03,3p,1,G>-,0,0,0,5399458,5543742,10943200,0.0
WA03,3p,2,G>-,0,0,0,5399458,5543742,10943200,0.0
WA03,3p,3,G>-,0,0,0,5399458,5543742,10943200,0.0
WA03,3p,4,G>-,0,0,0,5399458,5543736,10943194,0.0
WA03,3p,5,G>-,0,0,0,5399458,5543740,10943198,0.0
WA03,3p,6,G>-,0,0,0,5399458,5543741,10943199,0.0
WA03,3p,7,G>-,0,1,1,5399458,5543739,10943197,9.138097395121372e-08
WA03,3p,8,G>-,0,0,0,5399449,5543673,10943122,0.0
WA03,3p,9,G>-,12,24,36,5399436,5543670,10943106,3.289742418651524e-06
WA03,3p,10,G>-,13,30,43,5399438,5543654,10943092,3.929419582691985e-06
WA03,3p,11,G>-,19,27,46,5399404,5543644,10943048,4.2035820367415e-06
WA03,3p,12,G>-,25,29,54,5399397,5543595,10942992,4.934665034937429e-06
WA03,3p,13,G>-,26,37,63,5399378,5543551,10942929,5.757142351924243e-06
WA03,3p,14,G>-,30,34,64,5399356,5543493,10942849,5.848568320736218e-06
WA03,3p,15,G>-,33,67,100,5399349,5543505,10942854,9.138383825645485e-06
WA03,3p,16,G>-,52,72,124,5399342,5543495,10942837,1.1331613547748176e-05
WA03,3p,17,G>-,52,111,163,5399346,5543438,10942784,1.4895660921388926e-05
WA03,3p,18,G>-,47,141,188,5399325,5543443,10942768,1.7180296612337937e-05
WA03,3p,19,G>-,56,82,138,5399297,5543425,10942722,1.2611121803149162e-05
WA03,3p,20,G>-,58,107,165,5399252,5543409,10942661,1.5078599254788207e-05
WA03,3p,21,G>-,80,228,308,5399248,5543303,10942551,2.8147001553842423e-05
WA03,3p,22,G>-,79,144,223,5399256,5543263,10942519,2.037921981218401e-05
WA03,3p,23,G>-,100,218,318,5399255,5543267,10942522,2.906094225810101e-05
WA03,3p,24,G>-,152,290,442,5399198,5543130,10942328,4.03935981447458e-05
WA03,3p,25,G>-,167,200,367,5399050,5543142,10942192,3.35398976731536e-05
WA03,5p,1,G>-,0,0,0,5399457,5543742,10943199,0.0
WA03,5p,2,G>-,0,0,0,5399258,5543638,10942896,0.0
WA03,5p,3,G>-,0,0,0,5399457,5543742,10943199,0.0
WA03,5p,4,G>-,0,0,0,5399458,5543742,10943200,0.0
WA03,5p,5,G>-,0,0,0,5399456,5543740,10943196,0.0
WA03,5p,6,G>-,0,0,0,5399452,5543742,10943194,0.0
WA03,5p,7,G>-,6,0,6,5399453,5543742,10943195,5.482859439130894e-07
WA03,5p,8,G>-,3,1,4,5399403,5543732,10943135,3.655259667362232e-07
WA03,5p,9,G>-,35,5,40,5399319,5543732,10943051,3.655287725516403e-06
WA03,5p,10,G>-,37,4,41,5399344,5543717,10943061,3.746666494868301e-06
WA03,5p,11,G>-,53,19,72,5399321,5543705,10943026,6.579532937233266e-06
WA03,5p,12,G>-,29,18,47,5399213,5543665,10942878,4.295030978139389e-06
WA03,5p,13,G>-,40,29,69,5399156,5543662,10942818,6.30550558366227e-06
WA03,5p,14,G>-,47,20,67,5399124,5543629,10942753,6.122773674960954e-06
WA03,5p,15,G>-,85,36,121,5399092,5543505,10942597,1.1057704126360495e-05
WA03,5p,16,G>-,114,40,154,5399083,5543501,10942584,1.4073458334886897e-05
WA03,5p,17,G>-,98,31,129,5399113,5543491,10942604,1.1788784461175786e-05
WA03,5p,18,G>-,109,31,140,5399074,5543600,10942674,1.2793947804713912e-05
WA03,5p,19,G>-,163,36,199,5399071,5543546,10942617,1.818577768005588e-05
WA03,5p,20,G>-,138,57,195,5399050,5543533,10942583,1.7820289779844484e-05
WA03,5p,21,G>-,156,56,212,5399034,5543509,10942543,1.9373924324537723e-05
WA03,5p,22,G>-,150,59,209,5398989,5543454,10942443,1.909993956559792e-05
WA03,5p,23,G>-,182,56,238,5398935,5543457,10942392,2.175027178700964e-05
WA03,5p,24,G>-,175,109,284,5398952,5543428,10942380,2.595413429253965e-05
WA03,5p,25,G>-,157,151,308,5398991,5543444,10942435,2.8147299938267853e-05
WA07,3p,1,G>-,0,0,0,5691729,6013979,11705708,0.0
WA07,3p,2,G>-,0,0,0,5691729,6013979,11705708,0.0
WA07,3p,3,G>-,0,0,0,5691729,6013979,11705708,0.0
WA07,3p,4,G>-,0,0,0,5691729,6013979,11705708,0.0
WA07,3p,5,G>-,0,0,0,5691729,6013979,11705708,0.0
WA07,3p,6,G>-,0,0,0,5691729,6013979,11705708,0.0
WA07,3p,7,G>-,0,0,0,5691729,6013979,11705708,0.0
WA07,3p,8,G>-,0,0,0,5691713,6013800,11705513,0.0
WA07,3p,9,G>-,0,2,2,5691720,6013901,11705621,1.708580860425944e-07
WA07,3p,10,G>-,3,4,7,5691718,6013892,11705610,5.980038631049556e-07
WA07,3p,11,G>-,7,3,10,5691711,6013883,11705594,8.542924007102929e-07
WA07,3p,12,G>-,7,15,22,5691705,6013884,11705589,1.879444084360044e-06
WA07,3p,13,G>-,12,13,25,5691711,6013848,11705559,2.135737387680503e-06
WA07,3p,14,G>-,9,14,23,5691695,6013877,11705572,1.964876214507074e-06
WA07,3p,15,G>-,8,19,27,5691211,6013856,11705067,2.306693332041585e-06
WA07,3p,16,G>-,16,47,63,5691636,6013850,11705486,5.382091781580021e-06
WA07,3p,17,G>-,8,31,39,5691662,6013813,11705475,3.331774233852108e-06
WA07,3p,18,G>-,12,38,50,5691639,6013769,11705408,4.27152987747202e-06
WA07,3p,19,G>-,16,48,64,5691628,6013742,11705370,5.467575992898986e-06
WA07,3p,20,G>-,14,49,63,5691604,6013772,11705376,5.382142359203156e-06
WA07,3p,21,G>-,21,38,59,5691611,6013735,11705346,5.040431953058031e-06
WA07,3p,22,G>-,28,59,87,5691577,6013736,11705313,7.432522308459415e-06
WA07,3p,23,G>-,19,65,84,5691568,6013670,11705238,7.176274416632964e-06
WA07,3p,24,G>-,78,70,148,5691554,6013661,11705215,1.264393691188073e-05
WA07,3p,25,G>-,100,114,214,5691455,6013662,11705117,1.828260238663142e-05
WA07,5p,1,G>-,0,0,0,5691729,6013979,11705708,0.0
WA07,5p,2,G>-,0,0,0,5691636,6013923,11705559,0.0
WA07,5p,3,G>-,0,0,0,5691729,6013979,11705708,0.0
WA07,5p,4,G>-,0,0,0,5691728,6013979,11705707,0.0
WA07,5p,5,G>-,0,0,0,5691729,6013978,11705707,0.0
WA07,5p,6,G>-,0,0,0,5691728,6013979,11705707,0.0
WA07,5p,7,G>-,0,0,0,5691728,6013979,11705707,0.0
WA07,5p,8,G>-,0,0,0,5691579,6013975,11705554,0.0
WA07,5p,9,G>-,6,0,6,5691672,6013971,11705643,5.125732947775701e-07
WA07,5p,10,G>-,9,1,10,5691582,6013961,11705543,8.542961227855897e-07
WA07,5p,11,G>-,11,6,17,5691326,6013942,11705268,1.4523375287092957e-06
WA07,5p,12,G>-,17,11,28,5691520,6013938,11705458,2.3920465136861795e-06
WA07,5p,13,G>-,35,7,42,5691511,6013949,11705460,3.5880691574701035e-06
WA07,5p,14,G>-,18,6,24,5691556,6013950,11705506,2.050317175524065e-06
WA07,5p,15,G>-,31,8,39,5691563,6013633,11705196,3.3318536485847825e-06
WA07,5p,16,G>-,27,12,39,5691534,6013925,11705459,3.3317787879996846e-06
WA07,5p,17,G>-,40,14,54,5691561,6013916,11705477,4.613225074040127e-06
WA07,5p,18,G>-,30,13,43,5691474,6013905,11705379,3.673524795737071e-06
WA07,5p,19,G>-,29,11,40,5691482,6013884,11705366,3.4172361633117662e-06
WA07,5p,20,G>-,44,19,63,5691421,6013876,11705297,5.382178683719004e-06
WA07,5p,21,G>-,42,6,48,5691379,6013853,11705232,4.100730340073567e-06
WA07,5p,22,G>-,67,9,76,5691396,6013861,11705257,6.492809171127127e-06
WA07,5p,23,G>-,46,19,65,5691314,6013795,11705109,5.553130688488249e-06
WA07,5p,24,G>-,76,36,112,5691332,6013785,11705117,9.568464800479996e-06
WA07,5p,25,G>-,150,86,236,5691334,6013719,11705053,2.01622324990754e-05
WA08,3p,1,G>-,0,0,0,6798117,7189085,13987202,0.0
WA08,3p,2,G>-,0,0,0,6798117,7189085,13987202,0.0
WA08,3p,3,G>-,0,0,0,6798117,7189085,13987202,0.0
WA08,3p,4,G>-,0,0,0,6798117,7189081,13987198,0.0
WA08,3p,5,G>-,0,0,0,6798117,7189085,13987202,0.0
WA08,3p,6,G>-,0,0,0,6798117,7189085,13987202,0.0
WA08,3p,7,G>-,0,0,0,6798117,7189084,13987201,0.0
WA08,3p,8,G>-,0,1,1,6798110,7189053,13987163,7.149412643578974e-08
WA08,3p,9,G>-,6,18,24,6798103,7189051,13987154,1.7158601385242488e-06
WA08,3p,10,G>-,16,12,28,6798074,7189042,13987116,2.0018422668404268e-06
WA08,3p,11,G>-,12,11,23,6798109,7189046,13987155,1.6443658485231628e-06
WA08,3p,12,G>-,9,18,27,6798091,7189018,13987109,1.9303488662310418e-06
WA08,3p,13,G>-,16,29,45,6798090,7189013,13987103,3.217249490477049e-06
WA08,3p,14,G>-,20,23,43,6798067,7188981,13987048,3.074272712869792e-06
WA08,3p,15,G>-,21,39,60,6798069,7188978,13987047,4.289683161856824e-06
WA08,3p,16,G>-,17,44,61,6798049,7188961,13987010,4.361189417895604e-06
WA08,3p,17,G>-,52,62,114,6798000,7188943,13986943,8.15045860986207e-06
WA08,3p,18,G>-,26,48,74,6798023,7188956,13986979,5.290634954124118e-06
WA08,3p,19,G>-,37,77,114,6798028,7188946,13986974,8.150440545610508e-06
WA08,3p,20,G>-,41,39,80,6798009,7188917,13986926,5.719627028841076e-06
WA08,3p,21,G>-,39,69,108,6798010,7188926,13986936,7.721490968429397e-06
WA08,3p,22,G>-,36,91,127,6798012,7188920,13986932,9.079904013260376e-06
WA08,3p,23,G>-,36,100,136,6798009,7188864,13986873,9.723402793462126e-06
WA08,3p,24,G>-,67,158,225,6798015,7188867,13986882,1.6086501623449743e-05
WA08,3p,25,G>-,120,139,259,6797966,7188892,13986858,1.851738253151637e-05
WA08,5p,1,G>-,0,0,0,6798116,7189085,13987201,0.0
WA08,5p,2,G>-,0,0,0,6797941,7188997,13986938,0.0
WA08,5p,3,G>-,0,0,0,6798117,7189084,13987201,0.0
WA08,5p,4,G>-,1,0,1,6798115,7189085,13987200,7.149393731411576e-08
WA08,5p,5,G>-,0,0,0,6798116,7189084,13987200,0.0
WA08,5p,6,G>-,0,0,0,6798112,7189085,13987197,0.0
WA08,5p,7,G>-,0,0,0,6798110,7189085,13987195,0.0
WA08,5p,8,G>-,2,0,2,6798069,7189064,13987133,1.4298855955684414e-07
WA08,5p,9,G>-,21,5,26,6798054,7189067,13987121,1.8588528690071387e-06
WA08,5p,10,G>-,21,8,29,6798015,7189037,13987052,2.0733461203976364e-06
WA08,5p,11,G>-,26,4,30,6797997,7189047,13987044,2.1448420409630517e-06
WA08,5p,12,G>-,33,11,44,6798016,7189056,13987072,3.145762029394001e-06
WA08,5p,13,G>-,27,15,42,6797995,7189043,13987038,3.002780145446091e-06
WA08,5p,14,G>-,43,23,66,6797984,7189041,13987025,4.71865889994477e-06
WA08,5p,15,G>-,27,11,38,6797997,7189013,13987010,2.7168065226234918e-06
WA08,5p,16,G>-,37,21,58,6797921,7188997,13986918,4.1467319676858045e-06
WA08,5p,17,G>-,37,34,71,6797959,7188875,13986834,5.076202377178424e-06
WA08,5p,18,G>-,58,42,100,6797991,7188972,13986963,7.149514873243033e-06
WA08,5p,19,G>-,35,36,71,6797966,7188988,13986954,5.076158826289126e-06
WA08,5p,20,G>-,45,35,80,6797883,7188971,13986854,5.719656471712653e-06
WA08,5p,21,G>-,51,34,85,6797885,7188979,13986864,6.077130656307232e-06
WA08,5p,22,G>-,54,47,101,6797887,7188939,13986826,7.221080751272662e-06
WA08,5p,23,G>-,73,35,108,6797851,7188919,13986770,7.721582609852024e-06
WA08,5p,24,G>-,102,54,156,6797841,7188876,13986717,1.1153439366793509e-05
WA08,5p,25,G>-,138,122,260,6797835,7188817,13986652,1.858915200006406e-05
WA09,3p,1,G>-,0,0,0,4741672,4881751,9623423,0.0
WA09,3p,2,G>-,0,0,0,4741672,4881751,9623423,0.0
WA09,3p,3,G>-,0,0,0,4741672,4881751,9623423,0.0
WA09,3p,4,G>-,0,0,0,4741672,4881748,9623420,0.0
WA09,3p,5,G>-,0,0,0,4741672,4881751,9623423,0.0
WA09,3p,6,G>-,0,0,0,4741672,4881751,9623423,0.0
WA09,3p,7,G>-,0,0,0,4741672,4881748,9623420,0.0
WA09,3p,8,G>-,0,0,0,4741663,4881718,9623381,0.0
WA09,3p,9,G>-,6,13,19,4741664,4881723,9623387,1.9743568454640764e-06
WA09,3p,10,G>-,7,6,13,4741658,4881705,9623363,1.3508791053605688e-06
WA09,3p,11,G>-,5,7,12,4741648,4881712,9623360,1.246965716755894e-06
WA09,3p,12,G>-,9,12,21,4741642,4881680,9623322,2.1821986212245624e-06
WA09,3p,13,G>-,6,13,19,4741628,4881645,9623273,1.9743802342508625e-06
WA09,3p,14,G>-,9,23,32,4741616,4881571,9623187,3.325301690593771e-06
WA09,3p,15,G>-,12,24,36,4741598,4881557,9623155,3.740976841794609e-06
WA09,3p,16,G>-,9,46,55,4741586,4881546,9623132,5.715394946260739e-06
WA09,3p,17,G>-,20,56,76,4741582,4881528,9623110,7.897654708301163e-06
WA09,3p,18,G>-,27,60,87,4741560,4881490,9623050,9.040792680075445e-06
WA09,3p,19,G>-,29,69,98,4741552,4881442,9622994,1.0183940673765358e-05
WA09,3p,20,G>-,20,77,97,4741534,4881501,9623035,1.0079979964740851e-05
WA09,3p,21,G>-,39,79,118,4741546,4881493,9623039,1.2262238571411796e-05
WA09,3p,22,G>-,30,146,176,4741524,4881498,9623022,1.828947289115623e-05
WA09,3p,23,G>-,58,135,193,4741501,4881486,9622987,2.005614265092533e-05
WA09,3p,24,G>-,74,141,215,4741491,4881450,9622941,2.2342441879255e-05
WA09,3p,25,G>-,95,140,235,4741451,4881469,9622920,2.442086185897836e-05
WA09,5p,1,G>-,0,0,0,4741672,4881751,9623423,0.0
WA09,5p,2,G>-,0,0,0,4741495,4881667,9623162,0.0
WA09,5p,3,G>-,0,0,0,4741672,4881750,9623422,0.0
WA09,5p,4,G>-,0,0,0,4741672,4881751,9623423,0.0
WA09,5p,5,G>-,0,0,0,4741671,4881751,9623422,0.0
WA09,5p,6,G>-,0,0,0,4741669,4881751,9623420,0.0
WA09,5p,7,G>-,2,0,2,4741667,4881751,9623418,2.0782636688960202e-07
WA09,5p,8,G>-,0,0,0,4741639,4881744,9623383,0.0
WA09,5p,9,G>-,8,3,11,4741618,4881747,9623365,1.1430513131321528e-06
WA09,5p,10,G>-,10,11,21,4741622,4881737,9623359,2.182190231082515e-06
WA09,5p,11,G>-,14,3,17,4741614,4881733,9623347,1.7665371517830544e-06
WA09,5p,12,G>-,8,5,13,4741580,4881734,9623314,1.3508859837681697e-06
WA09,5p,13,G>-,21,8,29,4741530,4881708,9623238,3.013538686250927e-06
WA09,5p,14,G>-,23,16,39,4741498,4881705,9623203,4.052704697178268e-06
WA09,5p,15,G>-,46,11,57,4741496,4881672,9623168,5.9232053311341966e-06
WA09,5p,16,G>-,30,21,51,4741451,4881636,9623087,5.2997546421434205e-06
WA09,5p,17,G>-,33,14,47,4741476,4881638,9623114,4.884073907884704e-06
WA09,5p,18,G>-,30,16,46,4741455,4881610,9623065,4.78018178199981e-06
WA09,5p,19,G>-,36,87,123,4741379,4881580,9622959,1.2781931212634284e-05
WA09,5p,20,G>-,37,37,74,4741390,4881557,9622947,7.689951945074622e-06
WA09,5p,21,G>-,35,111,146,4741379,4881587,9622966,1.517203739470762e-05
WA09,5p,22,G>-,49,165,214,4741354,4881580,9622934,2.2238539721876925e-05
WA09,5p,23,G>-,55,102,157,4741312,4881565,9622877,1.631528699784898e-05
WA09,5p,24,G>-,69,106,175,4741363,4881548,9622911,1.8185765201403197e-05
WA09,5p,25,G>-,124,128,252,4741301,4881503,9622804,2.6187793079854896e-05
WA11,3p,1,G>-,0,0,0,9756642,10108269,19864911,0.0
WA11,3p,2,G>-,0,0,0,9756642,10108269,19864911,0.0
WA11,3p,3,G>-,0,0,0,9756642,10108269,19864911,0.0
WA11,3p,4,G>-,0,0,0,9756642,10108267,19864909,0.0
WA11,3p,5,G>-,0,0,0,9756642,10108269,19864911,0.0
WA11,3p,6,G>-,0,1,1,9756642,10108269,19864911,5.034001914229569e-08
WA11,3p,7,G>-,0,0,0,9756642,10108265,19864907,0.0
WA11,3p,8,G>-,0,0,0,9756629,10108160,19864789,0.0
WA11,3p,9,G>-,7,50,57,9756610,10108092,19864702,2.869411280370579e-06
WA11,3p,10,G>-,7,35,42,9756615,10107969,19864584,2.114315608119455e-06
WA11,3p,11,G>-,12,39,51,9756587,10107918,19864505,2.567393448767034e-06
WA11,3p,12,G>-,27,37,64,9756581,10108019,19864600,3.2218116649718595e-06
WA11,3p,13,G>-,28,54,82,9756565,10107963,19864528,4.127961157697782e-06
WA11,3p,14,G>-,45,38,83,9756515,10107914,19864429,4.178322971176267e-06
WA11,3p,15,G>-,48,87,135,9756471,10107972,19864443,6.796062693527324e-06
WA11,3p,16,G>-,64,105,169,9756477,10108011,19864488,8.507644395365237e-06
WA11,3p,17,G>-,65,102,167,9756469,10108044,19864513,8.406951632793616e-06
WA11,3p,18,G>-,59,152,211,9756421,10108016,19864437,1.062199749230245e-05
WA11,3p,19,G>-,73,122,195,9756438,10108000,19864438,9.816537472643324e-06
WA11,3p,20,G>-,83,112,195,9756433,10107963,19864396,9.816558228098151e-06
WA11,3p,21,G>-,94,140,234,9756421,10107904,19864325,1.1779911977879945e-05
WA11,3p,22,G>-,73,106,179,9756405,10107842,19864247,9.01116463161176e-06
WA11,3p,23,G>-,98,151,249,9756375,10107816,19864191,1.2535119099489126e-05
WA11,3p,24,G>-,161,187,348,9756358,10107704,19864062,1.75190754036108e-05
WA11,3p,25,G>-,191,262,453,9756281,10107693,19863974,2.280510435625822e-05
WA11,5p,1,G>-,0,0,0,9756641,10108269,19864910,0.0
WA11,5p,2,G>-,0,0,0,9756471,10108196,19864667,0.0
WA11,5p,3,G>-,0,0,0,9756642,10108269,19864911,0.0
WA11,5p,4,G>-,0,0,0,9756638,10108269,19864907,0.0
WA11,5p,5,G>-,0,0,0,9756638,10108267,19864905,0.0
WA11,5p,6,G>-,0,0,0,9756642,10108269,19864911,0.0
WA11,5p,7,G>-,0,0,0,9756629,10108269,19864898,0.0
WA11,5p,8,G>-,1,1,2,9756500,10108261,19864761,1.0068079852559013e-07
WA11,5p,9,G>-,53,3,56,9756493,10108240,19864733,2.819066332278415e-06
WA11,5p,10,G>-,32,7,39,9756446,10108197,19864643,1.963287233503265e-06
WA11,5p,11,G>-,47,8,55,9756457,10108195,19864652,2.768737151801099e-06
WA11,5p,12,G>-,43,20,63,9756411,10108221,19864632,3.171465748774002e-06
WA11,5p,13,G>-,44,28,72,9756334,10108178,19864512,3.62455417983588e-06
WA11,5p,14,G>-,69,24,93,9756261,10108167,19864428,4.681735613026461e-06
WA11,5p,15,G>-,50,35,85,9756237,10108096,19864333,4.279026131911905e-06
WA11,5p,16,G>-,71,49,120,9756275,10108079,19864354,6.04097168224046e-06
WA11,5p,17,G>-,111,64,175,9756369,10108078,19864447,8.809709125051405e-06
WA11,5p,18,G>-,118,31,149,9756327,10108075,19864402,7.500855047134064e-06
WA11,5p,19,G>-,103,44,147,9756284,10108088,19864372,7.4001836050996225e-06
WA11,5p,20,G>-,111,57,168,9756292,10108082,19864374,8.457351840032815e-06
WA11,5p,21,G>-,111,49,160,9756251,10108036,19864287,8.054656077008956e-06
WA11,5p,22,G>-,153,83,236,9756136,10108029,19864165,1.188069068093222e-05
WA11,5p,23,G>-,137,58,195,9756095,10108016,19864111,9.816699071002977e-06
WA11,5p,24,G>-,171,104,275,9756046,10108010,19864056,1.3844101124161148e-05
WA11,5p,25,G>-,236,156,392,9756056,10107943,19863999,1.973419350252686e-05
WA12,3p,1,G>-,0,0,0,6632243,6940679,13572922,0.0
WA12,3p,2,G>-,0,0,0,6632243,6940679,13572922,0.0
WA12,3p,3,G>-,0,0,0,6632243,6940679,13572922,0.0
WA12,3p,4,G>-,0,0,0,6632243,6940676,13572919,0.0
WA12,3p,5,G>-,0,0,0,6632243,6940678,13572921,0.0
WA12,3p,6,G>-,0,0,0,6632243,6940679,13572922,0.0
WA12,3p,7,G>-,0,0,0,6632243,6940676,13572919,0.0
WA12,3p,8,G>-,0,0,0,6632240,6940664,13572904,0.0
WA12,3p,9,G>-,10,14,24,6632231,6940656,13572887,1.7682310329408916e-06
WA12,3p,10,G>-,8,9,17,6632228,6940644,13572872,1.2524983658580145e-06
WA12,3p,11,G>-,8,6,14,6632231,6940642,13572873,1.0314691664763975e-06
WA12,3p,12,G>-,10,20,30,6632223,6940615,13572838,2.210296770653271e-06
WA12,3p,13,G>-,12,13,25,6632204,6940591,13572795,1.84191981091588e-06
WA12,3p,14,G>-,15,16,31,6632209,6940533,13572742,2.283989484217706e-06
WA12,3p,15,G>-,12,95,107,6632188,6940474,13572662,7.883494041183667e-06
WA12,3p,16,G>-,12,111,123,6632187,6940478,13572665,9.06233226857069e-06
WA12,3p,17,G>-,15,77,92,6632168,6940473,13572641,6.7783418127687896e-06
WA12,3p,18,G>-,30,74,104,6632160,6940482,13572642,7.662472789011897e-06
WA12,3p,19,G>-,28,69,97,6632121,6940435,13572556,7.146774712147071e-06
WA12,3p,20,G>-,37,86,123,6632105,6940432,13572537,9.062417733692676e-06
WA12,3p,21,G>-,47,61,108,6632096,6940454,13572550,7.957237217766743e-06
WA12,3p,22,G>-,55,66,121,6632039,6940438,13572477,8.91510075868981e-06
WA12,3p,23,G>-,44,82,126,6631950,6940459,13572409,9.28353986385173e-06
WA12,3p,24,G>-,70,137,207,6631933,6940411,13572344,1.5251602818201484e-05
WA12,3p,25,G>-,133,139,272,6631986,6940428,13572414,2.004065010100635e-05
WA12,5p,1,G>-,0,0,0,6632243,6940679,13572922,0.0
WA12,5p,2,G>-,0,0,0,6631949,6940524,13572473,0.0
WA12,5p,3,G>-,0,0,0,6632242,6940678,13572920,0.0
WA12,5p,4,G>-,0,0,0,6632242,6940679,13572921,0.0
WA12,5p,5,G>-,0,0,0,6632242,6940677,13572919,0.0
WA12,5p,6,G>-,0,0,0,6632242,6940679,13572921,0.0
WA12,5p,7,G>-,1,0,1,6632238,6940679,13572917,7.367613019367907e-08
WA12,5p,8,G>-,0,0,0,6632204,6940670,13572874,0.0
WA12,5p,9,G>-,14,1,15,6632209,6940675,13572884,1.1051446398569382e-06
WA12,5p,10,G>-,10,0,10,6632199,6940665,13572864,7.367641788792697e-07
WA12,5p,11,G>-,13,4,17,6632166,6940667,13572833,1.2525019647703614e-06
WA12,5p,12,G>-,17,5,22,6632126,6940660,13572786,1.6208905084040962e-06
WA12,5p,13,G>-,21,12,33,6632065,6940658,13572723,2.431347048046291e-06
WA12,5p,14,G>-,28,18,46,6632026,6940638,13572664,3.3891651631544108e-06
WA12,5p,15,G>-,64,19,83,6631987,6940631,13572618,6.1152535199915005e-06
WA12,5p,16,G>-,48,7,55,6631930,6940590,13572520,4.052305688258334e-06
WA12,5p,17,G>-,74,22,96,6631958,6940621,13572579,7.073084636309724e-06
WA12,5p,18,G>-,62,19,81,6632019,6940577,13572596,5.967907686930341e-06
WA12,5p,19,G>-,64,34,98,6631996,6940532,13572528,7.220467697690511e-06
WA12,5p,20,G>-,76,20,96,6631973,6940532,13572505,7.07312320017565e-06
WA12,5p,21,G>-,77,33,110,6631936,6940534,13572470,8.104641233320097e-06
WA12,5p,22,G>-,71,56,127,6631921,6940529,13572450,9.357190485137172e-06
WA12,5p,23,G>-,90,62,152,6631926,6940534,13572460,1.1199148864686283e-05
WA12,5p,24,G>-,117,120,237,6631934,6940518,13572452,1.7461841088109944e-05
WA12,5p,25,G>-,148,140,288,6631933,6940515,13572448,2.121945871518535e-05
WA13,3p,1,G>-,0,0,0,5896847,6081528,11978375,0.0
WA13,3p,2,G>-,0,0,0,5896847,6081528,11978375,0.0
WA13,3p,3,G>-,0,0,0,5896847,6081528,11978375,0.0
WA13,3p,4,G>-,0,0,0,5896847,6081522,11978369,0.0
WA13,3p,5,G>-,0,0,0,5896847,6081527,11978374,0.0
WA13,3p,6,G>-,0,0,0,5896847,6081528,11978375,0.0
WA13,3p,7,G>-,0,0,0,5896847,6081528,11978375,0.0
WA13,3p,8,G>-,0,0,0,5896845,6081521,11978366,0.0
WA13,3p,9,G>-,1,9,10,5896842,6081517,11978359,8.348388957118417e-07
WA13,3p,10,G>-,8,5,13,5896843,6081517,11978360,1.0852904738211242e-06
WA13,3p,11,G>-,8,2,10,5896841,6081492,11978333,8.348407078013276e-07
WA13,3p,12,G>-,7,9,16,5896836,6081505,11978341,1.3357442403751904e-06
WA13,3p,13,G>-,7,10,17,5896834,6081495,11978329,1.4192296771945405e-06
WA13,3p,14,G>-,4,7,11,5896832,6081501,11978333,9.183247785814604e-07
WA13,3p,15,G>-,13,10,23,5896825,6081505,11978330,1.920134108844889e-06
WA13,3p,16,G>-,8,17,25,5896830,6081509,11978339,2.087100724065332e-06
WA13,3p,17,G>-,6,20,26,5896823,6081499,11978322,2.170587833588044e-06
WA13,3p,18,G>-,13,14,27,5896827,6081499,11978326,2.2540712283168784e-06
WA13,3p,19,G>-,10,25,35,5896822,6081480,11978302,2.9219500393294474e-06
WA13,3p,20,G>-,11,15,26,5896818,6081448,11978266,2.1705979813772712e-06
WA13,3p,21,G>-,18,34,52,5896824,6081466,11978290,4.341187264626253e-06
WA13,3p,22,G>-,13,42,55,5896824,6081460,11978284,4.591642676029388e-06
WA13,3p,23,G>-,18,45,63,5896819,6081454,11978273,5.259522804330808e-06
WA13,3p,24,G>-,37,66,103,5896803,6081440,11978243,8.598923898939102e-06
WA13,3p,25,G>-,84,90,174,5896783,6081437,11978220,1.4526365353115906e-05
WA13,5p,1,G>-,0,0,0,5896847,6081528,11978375,0.0
WA13,5p,2,G>-,0,0,0,5896725,6081443,11978168,0.0
WA13,5p,3,G>-,0,0,0,5896847,6081528,11978375,0.0
WA13,5p,4,G>-,0,0,0,5896841,6081528,11978369,0.0
WA13,5p,5,G>-,0,0,0,5896841,6081528,11978369,0.0
WA13,5p,6,G>-,0,0,0,5896841,6081528,11978369,0.0
WA13,5p,7,G>-,0,0,0,5896845,6081528,11978373,0.0
WA13,5p,8,G>-,0,0,0,5896843,6081526,11978369,0.0
WA13,5p,9,G>-,7,2,9,5896837,6081518,11978355,7.513552570448947e-07
WA13,5p,10,G>-,11,3,14,5896833,6081518,11978351,1.1687752345877992e-06
WA13,5p,11,G>-,4,4,8,5896827,6081513,11978340,6.67872175944246e-07
WA13,5p,12,G>-,5,9,14,5896822,6081502,11978324,1.1687778690908678e-06
WA13,5p,13,G>-,6,4,10,5896809,6081508,11978317,8.34841822937229e-07
WA13,5p,14,G>-,4,8,12,5896802,6081520,11978322,1.0018097693483275e-06
WA13,5p,15,G>-,9,4,13,5896798,6081508,11978306,1.085295366473356e-06
WA13,5p,16,G>-,13,9,22,5896754,6081491,11978245,1.8366630503884331e-06
WA13,5p,17,G>-,10,4,14,5896805,6081514,11978319,1.1687783569631097e-06
WA13,5p,18,G>-,16,7,23,5896796,6081504,11978300,1.9201389178764933e-06
WA13,5p,19,G>-,23,12,35,5896797,6081472,11978269,2.921958089269827e-06
WA13,5p,20,G>-,21,12,33,5896788,6081482,11978270,2.7549888255983546e-06
WA13,5p,21,G>-,19,16,35,5896782,6081484,11978266,2.921958821084788e-06
WA13,5p,22,G>-,144,17,161,5896771,6081483,11978254,1.3441024042402172e-05
WA13,5p,23,G>-,38,19,57,5896768,6081501,11978269,4.758617459668004e-06
WA13,5p,24,G>-,85,47,132,5896781,6081498,11978279,1.1019947022439534e-05
WA13,5p,25,G>-,106,46,152,5896769,6081462,11978231,1.2689686816024838e-05
WA14,3p,1,G>-,0,0,0,6684341,7140972,13825313,0.0
WA14,3p,2,G>-,0,0,0,6684341,7140972,13825313,0.0
WA14,3p,3,G>-,0,0,0,6684341,7140972,13825313,0.0
WA14,3p,4,G>-,0,0,0,6684341,7140971,13825312,0.0
WA14,3p,5,G>-,0,0,0,6684341,7140970,13825311,0.0
WA14,3p,6,G>-,0,0,0,6684341,7140971,13825312,0.0
WA14,3p,7,G>-,0,0,0,6684341,7140969,13825310,0.0
WA14,3p,8,G>-,1,2,3,6684326,7140932,13825258,2.1699414217080078e-07
WA14,3p,9,G>-,11,14,25,6684323,7140920,13825243,1.8082864800278735e-06
WA14,3p,10,G>-,9,74,83,6684256,7140912,13825168,6.003543682073158e-06
WA14,3p,11,G>-,14,328,342,6684256,7140894,13825150,2.4737525451803417e-05
WA14,3p,12,G>-,14,305,319,6684291,7140849,13825140,2.307390738900293e-05
WA14,3p,13,G>-,22,131,153,6684289,7140794,13825083,1.1066841334695783e-05
WA14,3p,14,G>-,23,42,65,6684291,7140742,13825033,4.7016162637731135e-06
WA14,3p,15,G>-,31,71,102,6684271,7140702,13824973,7.377952926201013e-06
WA14,3p,16,G>-,19,94,113,6684263,7140648,13824911,8.173651172148595e-06
WA14,3p,17,G>-,35,151,186,6684212,7140653,13824865,1.3454019261670907e-05
WA14,3p,18,G>-,39,148,187,6684177,7140647,13824824,1.352639281339133e-05
WA14,3p,19,G>-,46,104,150,6684172,7140542,13824714,1.085013404255596e-05
WA14,3p,20,G>-,64,158,222,6684176,7140544,13824720,1.6058191413641652e-05
WA14,3p,21,G>-,54,169,223,6684132,7140443,13824575,1.6130694795319205e-05
WA14,3p,22,G>-,49,172,221,6684105,7140560,13824665,1.598592081616444e-05
WA14,3p,23,G>-,38,207,245,6683638,7140562,13824200,1.772254452337206e-05
WA14,3p,24,G>-,142,259,401,6683623,7140532,13824155,2.900719790829892e-05
WA14,3p,25,G>-,203,291,494,6683613,7140513,13824126,3.573462799745893e-05
WA14,5p,1,G>-,0,0,0,6684341,7140972,13825313,0.0
WA14,5p,2,G>-,0,0,0,6684184,7140911,13825095,0.0
WA14,5p,3,G>-,0,0,0,6684338,7140972,13825310,0.0
WA14,5p,4,G>-,0,0,0,6684341,7140972,13825313,0.0
WA14,5p,5,G>-,0,0,0,6684341,7140972,13825313,0.0
WA14,5p,6,G>-,0,0,0,6684340,7140972,13825312,0.0
WA14,5p,7,G>-,2,0,2,6684336,7140972,13825308,1.4466223826622885e-07
WA14,5p,8,G>-,3,0,3,6684277,7140970,13825247,2.169943148212831e-07
WA14,5p,9,G>-,29,3,32,6684241,7140959,13825200,2.3146138934698955e-06
WA14,5p,10,G>-,21,3,24,6684210,7140628,13824838,1.736005875801221e-06
WA14,5p,11,G>-,21,8,29,6684218,7140646,13824864,2.0976698215620783e-06
WA14,5p,12,G>-,31,14,45,6684139,7140917,13825056,3.254959690579192e-06
WA14,5p,13,G>-,31,18,49,6684018,7140931,13824949,3.544316872344339e-06
WA14,5p,14,G>-,32,6,38,6683951,7140942,13824893,2.748665034875857e-06
WA14,5p,15,G>-,51,7,58,6684030,7140908,13824938,4.19531718695592e-06
WA14,5p,16,G>-,76,19,95,6683910,7140868,13824778,6.87171974841115e-06
WA14,5p,17,G>-,87,13,100,6683904,7140873,13824777,7.233389732073074e-06
WA14,5p,18,G>-,67,44,111,6683891,7140646,13824537,8.029201990634478e-06
WA14,5p,19,G>-,69,42,111,6683958,7140595,13824553,8.029192697948353e-06
WA14,5p,20,G>-,67,46,113,6683860,7140558,13824418,8.173942657115836e-06
WA14,5p,21,G>-,115,63,178,6683480,7140494,13823974,1.2876181624762896e-05
WA14,5p,22,G>-,109,65,174,6683768,7140398,13824166,1.2586654413727382e-05
WA14,5p,23,G>-,139,128,267,6683762,7140257,13824019,1.9314209565250165e-05
WA14,5p,24,G>-,172,248,420,6683714,7140421,13824135,3.0381647748665648e-05
WA14,5p,25,G>-,188,239,427,6683731,7140511,13824242,3.0887769470470784e-05
WA18,3p,1,G>-,0,0,0,14112928,14131239,28244167,0.0
WA18,3p,2,G>-,0,0,0,14112928,14131239,28244167,0.0
WA18,3p,3,G>-,0,0,0,14112928,14131239,28244167,0.0
WA18,3p,4,G>-,0,0,0,14112928,14131238,28244166,0.0
WA18,3p,5,G>-,0,2,2,14112928,14131239,28244167,7.081108109862117e-08
WA18,3p,6,G>-,0,1,1,14112928,14131239,28244167,3.5405540549310586e-08
WA18,3p,7,G>-,0,0,0,14112928,14131237,28244165,0.0
WA18,3p,8,G>-,1,0,1,14112927,14131187,28244114,3.5405606987707246e-08
WA18,3p,9,G>-,10,10,20,14112909,14131177,28244086,7.081128417467643e-07
WA18,3p,10,G>-,9,8,17,14112909,14131197,28244106,6.018954892748242e-07
WA18,3p,11,G>-,17,13,30,14112900,14131167,28244067,1.0621699771495371e-06
WA18,3p,12,G>-,11,9,20,14112895,14131136,28244031,7.081142206648902e-07
WA18,3p,13,G>-,19,18,37,14112898,14131061,28243959,1.3100146477340515e-06
WA18,3p,14,G>-,13,24,37,14112830,14131006,28243836,1.310020352759448e-06
WA18,3p,15,G>-,18,47,65,14112809,14130957,28243766,2.3013928100098265e-06
WA18,3p,16,G>-,23,45,68,14112765,14130927,28243692,2.4076172477734144e-06
WA18,3p,17,G>-,21,76,97,14112743,14130850,28243593,3.434407229986638e-06
WA18,3p,18,G>-,24,47,71,14112708,14130769,28243477,2.513854792028616e-06
WA18,3p,19,G>-,39,65,104,14112724,14130771,28243495,3.682263827476026e-06
WA18,3p,20,G>-,75,99,174,14112697,14130797,28243494,6.160710852559532e-06
WA18,3p,21,G>-,53,79,132,14112659,14130783,28243442,4.673651320543721e-06
WA18,3p,22,G>-,34,83,117,14112575,14130715,28243290,4.1425768740114905e-06
WA18,3p,23,G>-,53,80,133,14112548,14130648,28243196,4.709098786128879e-06
WA18,3p,24,G>-,97,174,271,14112551,14130690,28243241,9.595216073112856e-06
WA18,3p,25,G>-,151,210,361,14112486,14130651,28243137,1.2781866263651945e-05
WA18,5p,1,G>-,0,0,0,14112926,14131239,28244165,0.0
WA18,5p,2,G>-,0,0,0,14112820,14131183,28244003,0.0
WA18,5p,3,G>-,0,0,0,14112928,14131239,28244167,0.0
WA18,5p,4,G>-,0,0,0,14112928,14131239,28244167,0.0
WA18,5p,5,G>-,1,0,1,14112925,14131239,28244164,3.5405544309967895e-08
WA18,5p,6,G>-,2,0,2,14112927,14131239,28244166,7.081108360572588e-08
WA18,5p,7,G>-,0,0,0,14112921,14131239,28244160,0.0
WA18,5p,8,G>-,1,1,2,14112828,14131230,28244058,7.081135437407755e-08
WA18,5p,9,G>-,19,11,30,14112833,14131230,28244063,1.0621701275769e-06
WA18,5p,10,G>-,17,3,20,14112791,14131213,28244004,7.081148975902991e-07
WA18,5p,11,G>-,18,11,29,14112776,14131211,28243987,1.0267672195147236e-06
WA18,5p,12,G>-,23,20,43,14112682,14131223,28243905,1.5224523662715904e-06
WA18,5p,13,G>-,18,14,32,14112608,14131206,28243814,1.1329914578817152e-06
WA18,5p,14,G>-,17,13,30,14112535,14131179,28243714,1.0621832525283326e-06
WA18,5p,15,G>-,57,6,63,14112545,14131148,28243693,2.2305864888136264e-06
WA18,5p,16,G>-,110,14,124,14112522,14131083,28243605,4.390374387405574e-06
WA18,5p,17,G>-,100,22,122,14112485,14130990,28243475,4.319581779508364e-06
WA18,5p,18,G>-,140,23,163,14112481,14130987,28243468,5.771245939061024e-06
WA18,5p,19,G>-,141,25,166,14112359,14130867,28243226,5.877515550100403e-06
WA18,5p,20,G>-,94,42,136,14112397,14130866,28243263,4.815307636373318e-06
WA18,5p,21,G>-,164,45,209,14112347,14130679,28243026,7.400056920246435e-06
WA18,5p,22,G>-,162,47,209,14112376,14129592,28241968,7.400334141020201e-06
WA18,5p,23,G>-,185,68,253,14112288,14129275,28241563,8.958427690422093e-06
WA18,5p,24,G>-,181,100,281,14112253,14129481,28241734,9.94981398805045e-06
WA18,5p,25,G>-,225,116,341,14112273,14130551,28242824,1.2073863435186226e-05
WA22,3p,1,G>-,0,0,0,1513709,1653397,3167106,0.0
WA22,3p,2,G>-,0,0,0,1513709,1653396,3167105,0.0
WA22,3p,3,G>-,0,0,0,1513709,1653396,3167105,0.0
WA22,3p,4,G>-,0,0,0,1513709,1653394,3167103,0.0
WA22,3p,5,G>-,0,0,0,1513709,1653397,3167106,0.0
WA22,3p,6,G>-,0,0,0,1513709,1653397,3167106,0.0
WA22,3p,7,G>-,0,0,0,1513709,1653397,3167106,0.0
WA22,3p,8,G>-,0,1,1,1513709,1653395,3167104,3.15745867518086e-07
WA22,3p,9,G>-,0,3,3,1513709,1653397,3167106,9.472370043819184e-07
WA22,3p,10,G>-,1,18,19,1513706,1653396,3167102,5.999175271273233e-06
WA22,3p,11,G>-,3,1,4,1513685,1653390,3167075,1.2629950348507692e-06
WA22,3p,12,G>-,10,20,30,1513662,1653379,3167041,9.472564453696684e-06
WA22,3p,13,G>-,30,18,48,1513689,1653380,3167069,1.5155969131079872e-05
WA22,3p,14,G>-,12,19,31,1513686,1653352,3167038,9.788325874208011e-06
WA22,3p,15,G>-,11,27,38,1513677,1653343,3167020,1.1998661202013247e-05
WA22,3p,16,G>-,31,51,82,1513637,1653341,3166978,2.5892191230883195e-05
WA22,3p,17,G>-,4,15,19,1513671,1653319,3166990,5.999387430967575e-06
WA22,3p,18,G>-,29,30,59,1513665,1653288,3166953,1.862989441270521e-05
WA22,3p,19,G>-,31,44,75,1513662,1653275,3166937,2.3682188815249563e-05
WA22,3p,20,G>-,49,26,75,1513684,1653304,3166988,2.3681807446065477e-05
WA22,3p,21,G>-,13,36,49,1513677,1653327,3167004,1.5472036031530116e-05
WA22,3p,22,G>-,16,57,73,1513684,1653356,3167040,2.3049914115388502e-05
WA22,3p,23,G>-,19,52,71,1513676,1653329,3167005,2.2418657375027827e-05
WA22,3p,24,G>-,25,28,53,1513672,1653285,3166957,1.6735307741784938e-05
WA22,3p,25,G>-,114,73,187,1513669,1653296,3166965,5.904706872352552e-05
WA22,5p,1,G>-,0,0,0,1513709,1653397,3167106,0.0
WA22,5p,2,G>-,0,0,0,1513674,1653378,3167052,0.0
WA22,5p,3,G>-,0,0,0,1513709,1653397,3167106,0.0
WA22,5p,4,G>-,0,0,0,1513709,1653397,3167106,0.0
WA22,5p,5,G>-,0,0,0,1513708,1653396,3167104,0.0
WA22,5p,6,G>-,0,0,0,1513704,1653397,3167101,0.0
WA22,5p,7,G>-,0,0,0,1513707,1653397,3167104,0.0
WA22,5p,8,G>-,0,0,0,1513692,1653397,3167089,0.0
WA22,5p,9,G>-,6,0,6,1513700,1653389,3167089,1.8944841777417685e-06
WA22,5p,10,G>-,10,0,10,1513705,1653389,3167094,3.157468644757623e-06
WA22,5p,11,G>-,7,0,7,1513699,1653381,3167080,2.210237821589603e-06
WA22,5p,12,G>-,38,5,43,1513692,1653345,3167037,1.3577359531953683e-05
WA22,5p,13,G>-,11,5,16,1513697,1653377,3167074,5.051981734560039e-06
WA22,5p,14,G>-,19,2,21,1513677,1653376,3167053,6.630769993429223e-06
WA22,5p,15,G>-,39,4,43,1513695,1653381,3167076,1.3577192337664142e-05
WA22,5p,16,G>-,11,4,15,1513668,1653368,3167036,4.736289704316591e-06
WA22,5p,17,G>-,39,17,56,1513675,1653395,3167070,1.7681958403192856e-05
WA22,5p,18,G>-,44,3,47,1513651,1653392,3167043,1.4840341605718647e-05
WA22,5p,19,G>-,38,25,63,1513674,1653350,3167024,1.9892492131414225e-05
WA22,5p,20,G>-,29,17,46,1513678,1653356,3167034,1.452463093228554e-05
WA22,5p,21,G>-,16,29,45,1513690,1653371,3167061,1.4208756951634338e-05
WA22,5p,22,G>-,36,30,66,1513691,1653380,3167071,2.083944439515249e-05
WA22,5p,23,G>-,51,27,78,1513634,1653393,3167027,2.462877645185848e-05
WA22,5p,24,G>-,68,11,79,1513632,1653375,3167007,2.494468752358299e-05
WA22,5p,25,G>-,102,44,146,1513644,1653364,3167008,4.61002940314644e-05
WA25,3p,1,G>-,0,0,0,3375244,3569089,6944333,0.0
WA25,3p,2,G>-,0,0,0,3375244,3569089,6944333,0.0
WA25,3p,3,G>-,0,0,0,3375244,3569089,6944333,0.0
WA25,3p,4,G>-,0,0,0,3375244,3569087,6944331,0.0
WA25,3p,5,G>-,0,0,0,3375244,3569089,6944333,0.0
WA25,3p,6,G>-,0,0,0,3375244,3569089,6944333,0.0
WA25,3p,7,G>-,0,0,0,3375244,3569089,6944333,0.0
WA25,3p,8,G>-,0,0,0,3375239,3569076,6944315,0.0
WA25,3p,9,G>-,2,12,14,3375240,3569076,6944316,2.0160372886256905e-06
WA25,3p,10,G>-,7,10,17,3375240,3569075,6944315,2.448045631570573e-06
WA25,3p,11,G>-,4,10,14,3375233,3569054,6944287,2.016045707788287e-06
WA25,3p,12,G>-,6,14,20,3375226,3569069,6944295,2.8800619789337866e-06
WA25,3p,13,G>-,2,11,13,3375230,3569053,6944283,1.8720435212677823e-06
WA25,3p,14,G>-,4,12,16,3375223,3569037,6944260,2.3040611958653624e-06
WA25,3p,15,G>-,16,11,27,3375218,3569039,6944257,3.888104947728749e-06
WA25,3p,16,G>-,12,27,39,3375196,3569030,6944226,5.616176662453094e-06
WA25,3p,17,G>-,17,30,47,3375198,3569022,6944220,6.768218748829962e-06
WA25,3p,18,G>-,12,34,46,3375213,3569006,6944219,6.624215048517335e-06
WA25,3p,19,G>-,15,19,34,3375204,3569005,6944209,4.896165999612051e-06
WA25,3p,20,G>-,32,20,52,3375190,3568979,6944169,7.4882970158128355e-06
WA25,3p,21,G>-,14,21,35,3375199,3568998,6944197,5.040179591679211e-06
WA25,3p,22,G>-,11,43,54,3375179,3568994,6944173,7.776303960169195e-06
WA25,3p,23,G>-,24,43,67,3375175,3568972,6944147,9.648413260836787e-06
WA25,3p,24,G>-,43,75,118,3375177,3568962,6944139,1.6992747409002038e-05
WA25,3p,25,G>-,65,86,151,3375156,3568970,6944126,2.1744997138588788e-05
WA25,5p,1,G>-,0,0,0,3375244,3569089,6944333,0.0
WA25,5p,2,G>-,0,0,0,3375147,3569045,6944192,0.0
WA25,5p,3,G>-,0,0,0,3375243,3569089,6944332,0.0
WA25,5p,4,G>-,0,0,0,3375243,3569089,6944332,0.0
WA25,5p,5,G>-,0,0,0,3375244,3569088,6944332,0.0
WA25,5p,6,G>-,0,0,0,3375244,3569089,6944333,0.0
WA25,5p,7,G>-,0,0,0,3375242,3569089,6944331,0.0
WA25,5p,8,G>-,0,0,0,3375221,3569088,6944309,0.0
WA25,5p,9,G>-,14,1,15,3375227,3569087,6944314,2.1600405742021458e-06
WA25,5p,10,G>-,7,2,9,3375217,3569085,6944302,1.296026584097293e-06
WA25,5p,11,G>-,11,3,14,3375193,3569088,6944281,2.016047449692776e-06
WA25,5p,12,G>-,6,11,17,3375142,3569084,6944226,2.4480770067103232e-06
WA25,5p,13,G>-,7,4,11,3375133,3569081,6944214,1.5840525652003237e-06
WA25,5p,14,G>-,6,10,16,3375151,3569071,6944222,2.3040738040920928e-06
WA25,5p,15,G>-,16,4,20,3375137,3569055,6944192,2.880104697565966e-06
WA25,5p,16,G>-,25,18,43,3375081,3569035,6944116,6.192292870683612e-06
WA25,5p,17,G>-,31,14,45,3375076,3568871,6943947,6.480464208612191e-06
WA25,5p,18,G>-,35,5,40,3375102,3568996,6944098,5.760287369216275e-06
WA25,5p,19,G>-,31,25,56,3375134,3569021,6944155,8.064336121529545e-06
WA25,5p,20,G>-,41,16,57,3375145,3569019,6944164,8.208331485258701e-06
WA25,5p,21,G>-,28,15,43,3375130,3569013,6944143,6.19226879400381e-06
WA25,5p,22,G>-,34,17,51,3375139,3569001,6944140,7.3443219750753875e-06
WA25,5p,23,G>-,38,10,48,3375144,3569002,6944146,6.912297062878574e-06
WA25,5p,24,G>-,57,38,95,3375124,3568967,6944091,1.3680696292718517e-05
WA25,5p,25,G>-,58,46,104,3375125,3568950,6944075,1.4976796765587928e-05
WA26,3p,1,G>-,0,0,0,2709623,2900126,5609749,0.0
WA26,3p,2,G>-,0,0,0,2709623,2900126,5609749,0.0
WA26,3p,3,G>-,0,0,0,2709623,2900126,5609749,0.0
WA26,3p,4,G>-,0,0,0,2709623,2900126,5609749,0.0
WA26,3p,5,G>-,0,0,0,2709623,2900126,5609749,0.0
WA26,3p,6,G>-,0,0,0,2709623,2900126,5609749,0.0
WA26,3p,7,G>-,0,0,0,2709623,2900126,5609749,0.0
WA26,3p,8,G>-,0,0,0,2709619,2900114,5609733,0.0
WA26,3p,9,G>-,6,25,31,2709613,2900111,5609724,5.526118575530632e-06
WA26,3p,10,G>-,10,9,19,2709609,2900074,5609683,3.387000655830285e-06
WA26,3p,11,G>-,24,26,50,2709594,2900076,5609670,8.91318027620163e-06
WA26,3p,12,G>-,18,25,43,2709607,2900081,5609688,7.665310441507621e-06
WA26,3p,13,G>-,31,33,64,2709604,2900084,5609688,1.1408834145499714e-05
WA26,3p,14,G>-,20,35,55,2709584,2900069,5609653,9.804528016260545e-06
WA26,3p,15,G>-,25,60,85,2709593,2900082,5609675,1.5152392963941762e-05
WA26,3p,16,G>-,34,57,91,2709580,2900075,5609655,1.6222031479654273e-05
WA26,3p,17,G>-,45,54,99,2709570,2900078,5609648,1.7648166159445298e-05
WA26,3p,18,G>-,39,57,96,2709582,2900059,5609641,1.7113394600474434e-05
WA26,3p,19,G>-,50,66,116,2709567,2900016,5609583,2.0678898948460163e-05
WA26,3p,20,G>-,45,62,107,2709563,2899983,5609546,1.9074627429742087e-05
WA26,3p,21,G>-,41,72,113,2709562,2900021,5609583,2.0144099837724123e-05
WA26,3p,22,G>-,46,80,126,2709522,2900007,5609529,2.2461778876622263e-05
WA26,3p,23,G>-,44,113,157,2709541,2899974,5609515,2.798815940415526e-05
WA26,3p,24,G>-,70,153,223,2709558,2899951,5609509,3.975392498701758e-05
WA26,3p,25,G>-,147,193,340,2709500,2900002,5609502,6.061144108692715e-05
WA26,5p,1,G>-,0,0,0,2709622,2900126,5609748,0.0
WA26,5p,2,G>-,0,0,0,2709554,2900092,5609646,0.0
WA26,5p,3,G>-,0,0,0,2709623,2900126,5609749,0.0
WA26,5p,4,G>-,0,0,0,2709623,2900126,5609749,0.0
WA26,5p,5,G>-,0,0,0,2709623,2900125,5609748,0.0
WA26,5p,6,G>-,0,0,0,2709621,2900126,5609747,0.0
WA26,5p,7,G>-,0,0,0,2709622,2900126,5609748,0.0
WA26,5p,8,G>-,0,0,0,2709609,2900124,5609733,0.0
WA26,5p,9,G>-,23,1,24,2709594,2900123,5609717,4.278290687391182e-06
WA26,5p,10,G>-,27,3,30,2709601,2900123,5609724,5.347856685997386e-06
WA26,5p,11,G>-,20,6,26,2709605,2900103,5609708,4.634822347259429e-06
WA26,5p,12,G>-,32,9,41,2709595,2900107,5609702,7.308766134101241e-06
WA26,5p,13,G>-,56,17,73,2709592,2900104,5609696,1.301318288905495e-05
WA26,5p,14,G>-,53,12,65,2709563,2900089,5609652,1.1587171539339697e-05
WA26,5p,15,G>-,33,24,57,2709545,2900085,5609630,1.016109796902826e-05
WA26,5p,16,G>-,42,24,66,2709540,2900076,5609616,1.1765511222158522e-05
WA26,5p,17,G>-,36,28,64,2709554,2900055,5609609,1.1408994815859716e-05
WA26,5p,18,G>-,53,22,75,2709554,2900082,5609636,1.336985144847188e-05
WA26,5p,19,G>-,58,44,102,2709570,2900086,5609656,1.818293314242442e-05
WA26,5p,20,G>-,33,55,88,2709563,2900082,5609645,1.5687267197835158e-05
WA26,5p,21,G>-,75,36,111,2709545,2900061,5609606,1.9787485966037545e-05
WA26,5p,22,G>-,31,38,69,2709542,2900059,5609601,1.2300340077663278e-05
WA26,5p,23,G>-,93,66,159,2709528,2900065,5609593,2.8344302340651096e-05
WA26,5p,24,G>-,120,63,183,2709495,2900057,5609552,3.262292603758732e-05
WA26,5p,25,G>-,135,151,286,2709506,2900041,5609547,5.098450908781048e-05
