Sample,End,Position,Substitution,Pos_Count,Neg_Count,Combined_Count,Pos_Total,Neg_Total,Combined_Total,Frequency
DAL192,3p,1,T>C,27,12,39,6350003,6167708,12517711,3.1155855890905296e-06
DAL192,3p,2,T>C,17,18,35,6350003,6167706,12517709,2.7960387959170485e-06
DAL192,3p,3,T>C,55,36,91,6350003,6167708,12517711,7.269699707877902e-06
DAL192,3p,4,T>C,85,118,203,6350003,6167708,12517711,1.621702242526609e-05
DAL192,3p,5,T>C,408,341,749,6350003,6167708,12517711,5.98352206725335e-05
DAL192,3p,6,T>C,484,488,972,6350003,6167708,12517711,7.76499792973332e-05
DAL192,3p,7,T>C,535,425,960,6350003,6167708,12517711,7.669133757761303e-05
DAL192,3p,8,T>C,547,475,1022,6350003,6167618,12517621,8.164490680777123e-05
DAL192,3p,9,T>C,751,764,1515,6350003,6167637,12517640,0.0001210292035878
DAL192,3p,10,T>C,644,643,1287,6350003,6167645,12517648,0.0001028148418936
DAL192,3p,11,T>C,1094,608,1702,6349987,6167644,12517631,0.0001359682195456
DAL192,3p,12,T>C,1060,1106,2166,6349997,6167646,12517643,0.0001730357703922
DAL192,3p,13,T>C,897,613,1510,6349992,6167621,12517613,0.000120630027466
DAL192,3p,14,T>C,812,651,1463,6349967,6167610,12517577,0.0001168756541301
DAL192,3p,15,T>C,1175,648,1823,6349968,6167615,12517583,0.0001456351437813
DAL192,3p,16,T>C,872,719,1591,6349943,6167587,12517530,0.0001271017525022
DAL192,3p,17,T>C,1115,722,1837,6349922,6167606,12517528,0.000146754215369
DAL192,3p,18,T>C,1021,710,1731,6349922,6167564,12517486,0.0001382865537057
DAL192,3p,19,T>C,1052,813,1865,6349921,6167519,12517440,0.0001489921261855
DAL192,3p,20,T>C,1369,982,2351,6349910,6167516,12517426,0.0001878181664505
DAL192,3p,21,T>C,1545,1122,2667,6349882,6167507,12517389,0.0002130636029606
DAL192,3p,22,T>C,1096,724,1820,6349894,6167488,12517382,0.0001453978156135
DAL192,3p,23,T>C,1442,998,2440,6349902,6167465,12517367,0.0001949291732039
DAL192,3p,24,T>C,1504,980,2484,6349899,6167465,12517364,0.0001984443370025
DAL192,3p,25,T>C,1177,829,2006,6349856,6167384,12517240,0.0001602589708274
DAL192,5p,1,T>C,21,62,83,6350003,6167708,12517711,6.63060522806446e-06
DAL192,5p,2,T>C,47,32,79,6349992,6167694,12517686,6.311070592440168e-06
DAL192,5p,3,T>C,199,164,363,6350003,6167707,12517710,2.899891433816569e-05
DAL192,5p,4,T>C,243,150,393,6350003,6167708,12517711,3.1395516320835337e-05
DAL192,5p,5,T>C,374,444,818,6350003,6167707,12517710,6.534741578132103e-05
DAL192,5p,6,T>C,523,400,923,6350002,6167707,12517709,7.373553738946959e-05
DAL192,5p,7,T>C,714,586,1300,6350002,6167708,12517710,0.0001038528612661
DAL192,5p,8,T>C,793,789,1582,6349926,6167708,12517634,0.0001263817107929
DAL192,5p,9,T>C,835,657,1492,6349914,6167708,12517622,0.0001191919679312
DAL192,5p,10,T>C,591,544,1135,6349896,6167708,12517604,9.067230438029514e-05
DAL192,5p,11,T>C,753,651,1404,6349942,6167706,12517648,0.0001121616457021
DAL192,5p,12,T>C,1071,1029,2100,6349906,6167700,12517606,0.0001677637081723
DAL192,5p,13,T>C,615,509,1124,6349906,6167705,12517611,8.979349174534982e-05
DAL192,5p,14,T>C,755,768,1523,6349889,6167679,12517568,0.0001216690015185
DAL192,5p,15,T>C,793,865,1658,6349890,6167649,12517539,0.0001324541509317
DAL192,5p,16,T>C,1103,666,1769,6349904,6167639,12517543,0.0001413216635245
DAL192,5p,17,T>C,795,756,1551,6349778,6167623,12517401,0.0001239075108323
DAL192,5p,18,T>C,1167,697,1864,6349859,6167631,12517490,0.0001489116428293
DAL192,5p,19,T>C,733,748,1481,6349822,6167638,12517460,0.0001183147379739
DAL192,5p,20,T>C,878,781,1659,6349836,6167621,12517457,0.0001325349070502
DAL192,5p,21,T>C,922,803,1725,6349784,6167624,12517408,0.0001378080829513
DAL192,5p,22,T>C,909,796,1705,6349783,6167584,12517367,0.0001362107542265
DAL192,5p,23,T>C,772,765,1537,6349801,6167567,12517368,0.0001227893915078
DAL192,5p,24,T>C,978,710,1688,6349759,6167564,12517323,0.0001348531151588
DAL192,5p,25,T>C,782,877,1659,6349777,6167551,12517328,0.000132536272917
DAL193,3p,1,T>C,90,21,111,6484405,6362696,12847101,8.64008152500708e-06
DAL193,3p,2,T>C,183,72,255,6484402,6362696,12847098,1.9848840570843314e-05
DAL193,3p,3,T>C,192,297,489,6484405,6362696,12847101,3.806306185340957e-05
DAL193,3p,4,T>C,402,399,801,6484405,6362696,12847101,6.234869641018624e-05
DAL193,3p,5,T>C,3326,2672,5998,6484405,6362696,12847101,0.0004668757566395
DAL193,3p,6,T>C,3192,3099,6291,6484405,6362696,12847101,0.0004896824583226
DAL193,3p,7,T>C,3097,3644,6741,6484405,6362696,12847101,0.0005247098158565
DAL193,3p,8,T>C,3290,3810,7100,6484400,6362644,12847044,0.000552656315336
DAL193,3p,9,T>C,4269,4003,8272,6484400,6362631,12847031,0.0006438841783755
DAL193,3p,10,T>C,3982,3835,7817,6484393,6362640,12847033,0.00060846734028
DAL193,3p,11,T>C,3465,3879,7344,6484398,6362639,12847037,0.0005716493227193
DAL193,3p,12,T>C,4329,4063,8392,6484368,6362594,12846962,0.0006532283663639
DAL193,3p,13,T>C,3686,3983,7669,6484385,6362543,12846928,0.0005969520495483
DAL193,3p,14,T>C,4130,3626,7756,6484363,6362486,12846849,0.0006037278090526
DAL193,3p,15,T>C,4426,4872,9298,6484332,6362438,12846770,0.0007237616926277
DAL193,3p,16,T>C,3640,3757,7397,6484341,6362460,12846801,0.0005757853647768
DAL193,3p,17,T>C,4003,4936,8939,6484294,6362445,12846739,0.0006958186042387
DAL193,3p,18,T>C,4579,5021,9600,6484244,6362380,12846624,0.0007472780397402
DAL193,3p,19,T>C,4004,4156,8160,6484265,6362400,12846665,0.0006351843065885
DAL193,3p,20,T>C,3810,3731,7541,6484261,6362382,12846643,0.0005870016003402
DAL193,3p,21,T>C,4511,4835,9346,6484248,6362443,12846691,0.0007275025140715
DAL193,3p,22,T>C,4001,3628,7629,6484224,6362407,12846631,0.0005938521936218
DAL193,3p,23,T>C,3821,4147,7968,6484218,6362399,12846617,0.0006202411109477
DAL193,3p,24,T>C,4601,4707,9308,6484164,6362319,12846483,0.0007245562851715
DAL193,3p,25,T>C,3927,3891,7818,6484128,6362355,12846483,0.000608571233076
DAL193,5p,1,T>C,22,91,113,6484405,6362696,12847101,8.795758669601803e-06
DAL193,5p,2,T>C,71,143,214,6484386,6362681,12847067,1.6657498555896067e-05
DAL193,5p,3,T>C,436,362,798,6484400,6362696,12847096,6.211520486808847e-05
DAL193,5p,4,T>C,479,333,812,6484403,6362696,12847099,6.320493054502032e-05
DAL193,5p,5,T>C,2745,2332,5077,6484403,6362696,12847099,0.0003951864930752
DAL193,5p,6,T>C,3036,2740,5776,6484404,6362696,12847100,0.0004495956285854
DAL193,5p,7,T>C,3888,2978,6866,6484404,6362696,12847100,0.0005344396789937
DAL193,5p,8,T>C,5474,3764,9238,6484314,6362693,12847007,0.0007190779922514
DAL193,5p,9,T>C,5681,5182,10863,6484295,6362695,12846990,0.0008455677166402
DAL193,5p,10,T>C,3387,3714,7101,6484284,6362694,12846978,0.0005527369938673
DAL193,5p,11,T>C,4407,4295,8702,6484315,6362677,12846992,0.0006773570031023
DAL193,5p,12,T>C,4978,4718,9696,6484218,6362670,12846888,0.0007547353102167
DAL193,5p,13,T>C,3230,3558,6788,6484143,6362652,12846795,0.0005283808140473
DAL193,5p,14,T>C,3913,4254,8167,6484145,6362627,12846772,0.0006357239001361
DAL193,5p,15,T>C,4990,4166,9156,6484166,6362534,12846700,0.0007127122140316
DAL193,5p,16,T>C,4190,3353,7543,6484111,6362519,12846630,0.000587157877202
DAL193,5p,17,T>C,4003,3113,7116,6484043,6362598,12846641,0.0005539191139536
DAL193,5p,18,T>C,4358,4147,8505,6483967,6362571,12846538,0.0006620460703109
DAL193,5p,19,T>C,4161,4844,9005,6483980,6362593,12846573,0.0007009651523406
DAL193,5p,20,T>C,4003,3998,8001,6483952,6362554,12846506,0.0006228152619864
DAL193,5p,21,T>C,5781,4951,10732,6484003,6362532,12846535,0.0008354003628215
DAL193,5p,22,T>C,4249,3648,7897,6484010,6362499,12846509,0.0006147195319755
DAL193,5p,23,T>C,3916,3832,7748,6483966,6362463,12846429,0.0006031248061231
DAL193,5p,24,T>C,4422,4966,9388,6483905,6362426,12846331,0.0007307923172772
DAL193,5p,25,T>C,4069,3597,7666,6483942,6362403,12846345,0.0005967456113003
DAL195,3p,1,T>C,5,3,8,2363278,2267461,4630739,1.7275860289254048e-06
DAL195,3p,2,T>C,10,11,21,2363278,2267460,4630738,4.534914305236012e-06
DAL195,3p,3,T>C,21,30,51,2363278,2267461,4630739,1.1013360934399457e-05
DAL195,3p,4,T>C,61,74,135,2363278,2267461,4630739,2.9153014238116207e-05
DAL195,3p,5,T>C,574,532,1106,2363278,2267461,4630739,0.0002388387684989
DAL195,3p,6,T>C,611,601,1212,2363278,2267461,4630739,0.0002617292833821
DAL195,3p,7,T>C,745,742,1487,2363278,2267461,4630739,0.0003211150531265
DAL195,3p,8,T>C,663,612,1275,2363278,2267413,4630691,0.0002753368773688
DAL195,3p,9,T>C,769,748,1517,2363276,2267438,4630714,0.0003275952693256
DAL195,3p,10,T>C,767,689,1456,2363274,2267432,4630706,0.0003144228979339
DAL195,3p,11,T>C,660,678,1338,2363274,2267431,4630705,0.0002889408848112
DAL195,3p,12,T>C,953,969,1922,2363273,2267414,4630687,0.000415057204255
DAL195,3p,13,T>C,636,693,1329,2363269,2267412,4630681,0.0002869988237151
DAL195,3p,14,T>C,632,666,1298,2363250,2267410,4630660,0.0002803056151822
DAL195,3p,15,T>C,753,722,1475,2363254,2267411,4630665,0.0003185287642271
DAL195,3p,16,T>C,800,624,1424,2363259,2267394,4630653,0.0003075160241978
DAL195,3p,17,T>C,834,603,1437,2363234,2267398,4630632,0.0003103248109545
DAL195,3p,18,T>C,1101,705,1806,2363236,2267374,4630610,0.0003900134107601
DAL195,3p,19,T>C,937,725,1662,2363215,2267369,4630584,0.0003589180112054
DAL195,3p,20,T>C,722,646,1368,2363222,2267380,4630602,0.0002954259510966
DAL195,3p,21,T>C,940,896,1836,2363235,2267382,4630617,0.0003964914394777
DAL195,3p,22,T>C,1169,812,1981,2363231,2267383,4630614,0.0004278050383815
DAL195,3p,23,T>C,824,767,1591,2363219,2267370,4630589,0.0003435848009832
DAL195,3p,24,T>C,869,702,1571,2363198,2267373,4630571,0.0003392670148022
DAL195,3p,25,T>C,754,797,1551,2363180,2267377,4630557,0.0003349489057147
DAL195,5p,1,T>C,8,15,23,2363278,2267461,4630739,4.966809833160539e-06
DAL195,5p,2,T>C,8,9,17,2363264,2267447,4630711,3.671142509217267e-06
DAL195,5p,3,T>C,42,73,115,2363278,2267459,4630737,2.483405989154642e-05
DAL195,5p,4,T>C,98,56,154,2363278,2267461,4630739,3.325603105681404e-05
DAL195,5p,5,T>C,393,353,746,2363277,2267461,4630738,0.000161097431986
DAL195,5p,6,T>C,537,589,1126,2363277,2267461,4630738,0.0002431577860807
DAL195,5p,7,T>C,493,541,1034,2363277,2267461,4630738,0.0002232905424578
DAL195,5p,8,T>C,882,645,1527,2363212,2267460,4630672,0.000329757754382
DAL195,5p,9,T>C,863,605,1468,2363181,2267461,4630642,0.0003170186768918
DAL195,5p,10,T>C,817,617,1434,2363146,2267458,4630604,0.000309678823756
DAL195,5p,11,T>C,850,851,1701,2362948,2267450,4630398,0.0003673550308202
DAL195,5p,12,T>C,943,836,1779,2362864,2267454,4630318,0.0003842068730484
DAL195,5p,13,T>C,739,742,1481,2363073,2267445,4630518,0.0003198346275729
DAL195,5p,14,T>C,1020,688,1708,2363094,2267434,4630528,0.0003688564241486
DAL195,5p,15,T>C,882,798,1680,2363178,2267432,4630610,0.0003628031728001
DAL195,5p,16,T>C,779,663,1442,2363170,2267429,4630599,0.0003114067963993
DAL195,5p,17,T>C,701,711,1412,2363159,2267431,4630590,0.000304928745581
DAL195,5p,18,T>C,851,645,1496,2363182,2267420,4630602,0.0003230681453512
DAL195,5p,19,T>C,949,734,1683,2363138,2267420,4630558,0.0003634551170722
DAL195,5p,20,T>C,822,736,1558,2363110,2267401,4630511,0.0003364639453399
DAL195,5p,21,T>C,908,743,1651,2363086,2267400,4630486,0.0003565500467985
DAL195,5p,22,T>C,833,742,1575,2363094,2267388,4630482,0.0003401373766273
DAL195,5p,23,T>C,918,757,1675,2363068,2267398,4630466,0.0003617346504649
DAL195,5p,24,T>C,1010,654,1664,2363067,2267402,4630469,0.0003593588468036
DAL195,5p,25,T>C,765,856,1621,2363135,2267374,4630509,0.0003500695063976
DAL212,3p,1,T>C,15,10,25,4131322,4008153,8139475,3.071451168533597e-06
DAL212,3p,2,T>C,18,9,27,4131322,4008153,8139475,3.317167262016285e-06
DAL212,3p,3,T>C,104,49,153,4131322,4008153,8139475,1.8797281151425613e-05
DAL212,3p,4,T>C,118,119,237,4131322,4008153,8139475,2.91173570776985e-05
DAL212,3p,5,T>C,1162,956,2118,4131322,4008151,8139473,0.0002602134069367
DAL212,3p,6,T>C,1118,1012,2130,4131322,4008151,8139473,0.0002616877038599
DAL212,3p,7,T>C,1210,947,2157,4131322,4008153,8139475,0.000265004806821
DAL212,3p,8,T>C,1362,1185,2547,4131319,4008093,8139412,0.0003129218670832
DAL212,3p,9,T>C,1426,1250,2676,4131316,4008115,8139431,0.0003287699103291
DAL212,3p,10,T>C,1232,1433,2665,4131317,4008102,8139419,0.0003274189472246
DAL212,3p,11,T>C,1452,1131,2583,4131313,4008105,8139418,0.0003173445570678
DAL212,3p,12,T>C,1452,1321,2773,4131314,4008034,8139348,0.0003406906794008
DAL212,3p,13,T>C,1390,1208,2598,4131307,4007923,8139230,0.0003191948132685
DAL212,3p,14,T>C,1405,1312,2717,4131271,4007904,8139175,0.0003338176166503
DAL212,3p,15,T>C,1481,1456,2937,4131254,4007935,8139189,0.0003608467624968
DAL212,3p,16,T>C,1374,1124,2498,4131236,4007982,8139218,0.0003069090912665
DAL212,3p,17,T>C,1313,1357,2670,4131249,4007981,8139230,0.0003280408589018
DAL212,3p,18,T>C,1531,1384,2915,4131222,4007954,8139176,0.0003581443625251
DAL212,3p,19,T>C,1677,1239,2916,4131233,4007956,8139189,0.0003582666528569
DAL212,3p,20,T>C,1465,1635,3100,4131221,4007928,8139149,0.0003808751996062
DAL212,3p,21,T>C,1597,1478,3075,4131228,4007917,8139145,0.0003778038110882
DAL212,3p,22,T>C,1495,1272,2767,4131183,4007898,8139081,0.0003399646716871
DAL212,3p,23,T>C,1441,1288,2729,4131172,4007904,8139076,0.0003352960458902
DAL212,3p,24,T>C,1679,1391,3070,4131124,4007904,8139028,0.0003771949181155
DAL212,3p,25,T>C,1573,1278,2851,4131071,4007924,8138995,0.0003502889484512
DAL212,5p,1,T>C,5,15,20,4131322,4008153,8139475,2.4571609348268777e-06
DAL212,5p,2,T>C,21,25,46,4131307,4008143,8139450,5.65148750836973e-06
DAL212,5p,3,T>C,197,209,406,4131321,4008153,8139474,4.988037310519083e-05
DAL212,5p,4,T>C,196,130,326,4131322,4008153,8139475,4.005172323767811e-05
DAL212,5p,5,T>C,1211,907,2118,4131322,4008153,8139475,0.0002602133429981
DAL212,5p,6,T>C,1306,974,2280,4131322,4008153,8139475,0.0002801163465702
DAL212,5p,7,T>C,1254,1086,2340,4131322,4008153,8139475,0.0002874878293747
DAL212,5p,8,T>C,1690,1438,3128,4131248,4008153,8139401,0.0003843034641001
DAL212,5p,9,T>C,1419,1130,2549,4131243,4008153,8139396,0.0003131682006871
DAL212,5p,10,T>C,1405,1015,2420,4131179,4008148,8139327,0.000297321879315
DAL212,5p,11,T>C,1948,1268,3216,4131234,4008143,8139377,0.0003951162355546
DAL212,5p,12,T>C,1971,1278,3249,4131187,4008141,8139328,0.00039917300298
DAL212,5p,13,T>C,1417,1364,2781,4131181,4008142,8139323,0.0003416746085638
DAL212,5p,14,T>C,1223,1204,2427,4131134,4008108,8139242,0.000298185015263
DAL212,5p,15,T>C,1612,1519,3131,4131156,4008091,8139247,0.0003846793198437
DAL212,5p,16,T>C,1425,1293,2718,4131154,4008081,8139235,0.0003339380175163
DAL212,5p,17,T>C,1500,1216,2716,4131159,4008081,8139240,0.0003336920891876
DAL212,5p,18,T>C,1496,1233,2729,4131113,4008066,8139179,0.0003352918027727
DAL212,5p,19,T>C,1521,1441,2962,4131040,4008052,8139092,0.0003639226586946
DAL212,5p,20,T>C,1535,1213,2748,4131020,4008040,8139060,0.000337631126936
DAL212,5p,21,T>C,1585,1398,2983,4130973,4008040,8139013,0.0003665063564832
DAL212,5p,22,T>C,1706,1432,3138,4131015,4007967,8138982,0.0003855519031741
DAL212,5p,23,T>C,1522,1312,2834,4131005,4007962,8138967,0.0003482014363739
DAL212,5p,24,T>C,1722,1515,3237,4131060,4007918,8138978,0.000397715782006
DAL212,5p,25,T>C,1459,1185,2644,4131016,4007614,8138630,0.0003248704020209
DAL218,3p,1,T>C,79,21,100,6952891,6658031,13610922,7.347040854396197e-06
DAL218,3p,2,T>C,80,61,141,6952891,6658031,13610922,1.035932760469864e-05
DAL218,3p,3,T>C,196,147,343,6952891,6658030,13610921,2.5200351982059116e-05
DAL218,3p,4,T>C,331,306,637,6952891,6658031,13610922,4.6800650242503775e-05
DAL218,3p,5,T>C,2699,2236,4935,6952891,6658031,13610922,0.0003625764661644
DAL218,3p,6,T>C,2791,2628,5419,6952891,6658030,13610921,0.0003981361731509
DAL218,3p,7,T>C,2797,2431,5228,6952891,6658026,13610917,0.000384103436969
DAL218,3p,8,T>C,2820,2832,5652,6952887,6657945,13610832,0.0004152574949128
DAL218,3p,9,T>C,3505,3293,6798,6952882,6657945,13610827,0.0004994553233245
DAL218,3p,10,T>C,4350,3618,7968,6952881,6657960,13610841,0.0005854156991474
DAL218,3p,11,T>C,3181,3855,7036,6952866,6657905,13610771,0.0005169435295032
DAL218,3p,12,T>C,3703,3257,6960,6952858,6657882,13610740,0.0005113608811864
DAL218,3p,13,T>C,4651,2893,7544,6952870,6657811,13610681,0.0005542705761746
DAL218,3p,14,T>C,3474,3342,6816,6952816,6657779,13610595,0.000500786335939
DAL218,3p,15,T>C,4579,3456,8035,6952788,6657738,13610526,0.0005903519085155
DAL218,3p,16,T>C,4069,3323,7392,6952760,6657689,13610449,0.00054311213392
DAL218,3p,17,T>C,3708,3060,6768,6952737,6657651,13610388,0.0004972672344094
DAL218,3p,18,T>C,4310,3709,8019,6952711,6657672,13610383,0.0005891825380667
DAL218,3p,19,T>C,3824,4014,7838,6952716,6657697,13610413,0.0005758825981254
DAL218,3p,20,T>C,3842,2775,6617,6952697,6657752,13610449,0.0004861705884941
DAL218,3p,21,T>C,5046,3299,8345,6952660,6657692,13610352,0.0006131362363001
DAL218,3p,22,T>C,4753,2653,7406,6952654,6657637,13610291,0.0005441470722411
DAL218,3p,23,T>C,4056,3277,7333,6952651,6657632,13610283,0.0005387838004544
DAL218,3p,24,T>C,4613,3105,7718,6952669,6657588,13610257,0.0005670723190605
DAL218,3p,25,T>C,4182,3492,7674,6952605,6657566,13610171,0.0005638430259252
DAL218,5p,1,T>C,42,130,172,6952891,6658031,13610922,1.263691026956146e-05
DAL218,5p,2,T>C,190,66,256,6952874,6658014,13610888,1.880847157070134e-05
DAL218,5p,3,T>C,1117,247,1364,6952891,6658031,13610922,0.0001002136372539
DAL218,5p,4,T>C,376,334,710,6952891,6658031,13610922,5.2163990066213e-05
DAL218,5p,5,T>C,2097,4125,6222,6952891,6658031,13610922,0.0004571328819605
DAL218,5p,6,T>C,2508,3314,5822,6952891,6658031,13610922,0.0004277447185429
DAL218,5p,7,T>C,2971,2216,5187,6952888,6658031,13610919,0.0003810910931142
DAL218,5p,8,T>C,4869,3324,8193,6952719,6658029,13610748,0.0006019507524494
DAL218,5p,9,T>C,3944,2673,6617,6952736,6658029,13610765,0.000486159301112
DAL218,5p,10,T>C,2935,2707,5642,6952716,6658028,13610744,0.0004145254660582
DAL218,5p,11,T>C,4165,3484,7649,6952715,6658016,13610731,0.0005619830411753
DAL218,5p,12,T>C,5480,5854,11334,6952625,6658005,13610630,0.0008327314753248
DAL218,5p,13,T>C,3226,2605,5831,6952475,6658005,13610480,0.0004284198646925
DAL218,5p,14,T>C,4477,2952,7429,6952554,6657955,13610509,0.0005458282272911
DAL218,5p,15,T>C,4493,3672,8165,6952449,6657923,13610372,0.0005999101273646
DAL218,5p,16,T>C,4289,2809,7098,6952253,6657920,13610173,0.0005215216588356
DAL218,5p,17,T>C,3700,3014,6714,6952350,6657874,13610224,0.0004933056208332
DAL218,5p,18,T>C,5010,2869,7879,6952457,6657843,13610300,0.000578899803825
DAL218,5p,19,T>C,4029,3420,7449,6952296,6657770,13610066,0.0005473154942819
DAL218,5p,20,T>C,4944,2970,7914,6952289,6657772,13610061,0.0005814815965924
DAL218,5p,21,T>C,4819,3486,8305,6952371,6657729,13610100,0.0006102085950874
DAL218,5p,22,T>C,5526,3317,8843,6952322,6657786,13610108,0.0006497376802594
DAL218,5p,23,T>C,4097,3298,7395,6952288,6657745,13610033,0.0005433491601379
DAL218,5p,24,T>C,4680,3373,8053,6952375,6657772,13610147,0.0005916908906274
DAL218,5p,25,T>C,4002,3311,7313,6952272,6657720,13609992,0.0005373258118006
DAL224,3p,1,T>C,59,9,68,4609472,4586477,9195949,7.39456036565666e-06
DAL224,3p,2,T>C,72,29,101,4609471,4586476,9195947,1.0983099402378028e-05
DAL224,3p,3,T>C,195,100,295,4609472,4586477,9195949,3.207934276277522e-05
DAL224,3p,4,T>C,208,200,408,4609472,4586477,9195949,4.436736219393997e-05
DAL224,3p,5,T>C,698,890,1588,4609472,4586477,9195949,0.000172684733245
DAL224,3p,6,T>C,1208,1252,2460,4609472,4586477,9195949,0.0002675090955811
DAL224,3p,7,T>C,843,846,1689,4609472,4586476,9195948,0.0001836678502314
DAL224,3p,8,T>C,1377,1234,2611,4609469,4586423,9195892,0.0002839311292477
DAL224,3p,9,T>C,1175,985,2160,4609466,4586431,9195897,0.0002348873633534
DAL224,3p,10,T>C,1531,1245,2776,4609461,4586371,9195832,0.0003018758933395
DAL224,3p,11,T>C,1050,1070,2120,4609461,4586382,9195843,0.0002305389511325
DAL224,3p,12,T>C,1789,941,2730,4609458,4586384,9195842,0.0002968733042607
DAL224,3p,13,T>C,1665,1174,2839,4609454,4586364,9195818,0.0003087272932108
DAL224,3p,14,T>C,1324,1299,2623,4609412,4586293,9195705,0.0002852418601945
DAL224,3p,15,T>C,1898,1862,3760,4609400,4586272,9195672,0.0004088880073147
DAL224,3p,16,T>C,2067,5910,7977,4609379,4586240,9195619,0.0008674783067893
DAL224,3p,17,T>C,1805,1797,3602,4609381,4586216,9195597,0.0003917092060471
DAL224,3p,18,T>C,1916,1812,3728,4609363,4586282,9195645,0.0004054092997282
DAL224,3p,19,T>C,1536,1088,2624,4609353,4586195,9195548,0.0002853554785424
DAL224,3p,20,T>C,1337,1767,3104,4609344,4586225,9195569,0.00033755388057
DAL224,3p,21,T>C,1994,1955,3949,4609343,4586223,9195566,0.0004294461047857
DAL224,3p,22,T>C,1765,1451,3216,4609324,4586172,9195496,0.0003497364361857
DAL224,3p,23,T>C,2286,1971,4257,4609323,4586083,9195406,0.0004629485636632
DAL224,3p,24,T>C,3554,1681,5235,4609325,4586202,9195527,0.0005692985296003
DAL224,3p,25,T>C,2248,1363,3611,4609265,4586173,9195438,0.0003926947253627
DAL224,5p,1,T>C,11,32,43,4609472,4586477,9195949,4.675971995929947e-06
DAL224,5p,2,T>C,21,40,61,4609461,4586469,9195930,6.633369327517717e-06
DAL224,5p,3,T>C,402,326,728,4609468,4586477,9195945,7.916532776131218e-05
DAL224,5p,4,T>C,339,317,656,4609471,4586477,9195948,7.133576657893238e-05
DAL224,5p,5,T>C,582,699,1281,4609471,4586477,9195948,0.0001393004832128
DAL224,5p,6,T>C,771,689,1460,4609472,4586477,9195949,0.000158765560792
DAL224,5p,7,T>C,743,816,1559,4609471,4586477,9195948,0.0001695311891715
DAL224,5p,8,T>C,1271,1147,2418,4609397,4586477,9195874,0.0002629440116295
DAL224,5p,9,T>C,1755,1027,2782,4609357,4586473,9195830,0.0003025284286464
DAL224,5p,10,T>C,1015,904,1919,4609338,4586470,9195808,0.0002086820429482
DAL224,5p,11,T>C,2553,1217,3770,4609388,4586469,9195857,0.000409967227633
DAL224,5p,12,T>C,1606,1284,2890,4609357,4586464,9195821,0.0003142731899631
DAL224,5p,13,T>C,1543,1003,2546,4609320,4586461,9195781,0.0002768660976158
DAL224,5p,14,T>C,922,1087,2009,4609270,4586428,9195698,0.0002184717244955
DAL224,5p,15,T>C,1153,1293,2446,4609299,4586416,9195715,0.00026599345456
DAL224,5p,16,T>C,1747,1010,2757,4609292,4586373,9195665,0.0002998151846549
DAL224,5p,17,T>C,1104,1222,2326,4609285,4586385,9195670,0.0002529451361347
DAL224,5p,18,T>C,1540,1301,2841,4609226,4586351,9195577,0.0003089528802814
DAL224,5p,19,T>C,2589,1210,3799,4609203,4586337,9195540,0.0004131350633024
DAL224,5p,20,T>C,939,981,1920,4609148,4586313,9195461,0.0002087986670815
DAL224,5p,21,T>C,1232,1194,2426,4609195,4586347,9195542,0.0002638234918615
DAL224,5p,22,T>C,1450,1078,2528,4609138,4586312,9195450,0.0002749185738598
DAL224,5p,23,T>C,1493,1186,2679,4609100,4586313,9195413,0.000291340910952
DAL224,5p,24,T>C,2295,1547,3842,4609109,4586316,9195425,0.0004178164685155
DAL224,5p,25,T>C,1154,1147,2301,4609125,4586257,9195382,0.0002502343023922
DAL227,3p,1,T>C,35,18,53,3765386,3771243,7536629,7.032321744907438e-06
DAL227,3p,2,T>C,67,45,112,3765386,3771243,7536629,1.4860755385464774e-05
DAL227,3p,3,T>C,52,64,116,3765386,3771243,7536629,1.5391496649231373e-05
DAL227,3p,4,T>C,70,101,171,3765386,3771243,7536629,2.2689189026022112e-05
DAL227,3p,5,T>C,447,464,911,3765386,3771243,7536629,0.0001208763228228
DAL227,3p,6,T>C,519,564,1083,3765386,3771243,7536629,0.0001436981971648
DAL227,3p,7,T>C,387,681,1068,3765386,3771243,7536629,0.0001417079174256
DAL227,3p,8,T>C,600,496,1096,3765386,3771207,7536593,0.0001454238009137
DAL227,3p,9,T>C,658,798,1456,3765384,3771218,7536602,0.0001931905121167
DAL227,3p,10,T>C,714,856,1570,3765382,3771209,7536591,0.0002083169963714
DAL227,3p,11,T>C,699,576,1275,3765378,3771214,7536592,0.000169174608364
DAL227,3p,12,T>C,738,690,1428,3765377,3771173,7536550,0.000189476617285
DAL227,3p,13,T>C,653,669,1322,3765373,3771183,7536556,0.0001754116867173
DAL227,3p,14,T>C,1169,569,1738,3765341,3771166,7536507,0.0002306108121441
DAL227,3p,15,T>C,823,759,1582,3765341,3771186,7536527,0.0002099110107347
DAL227,3p,16,T>C,756,695,1451,3765340,3771079,7536419,0.0001925317581201
DAL227,3p,17,T>C,690,601,1291,3765328,3771049,7536377,0.0001713024706699
DAL227,3p,18,T>C,1199,690,1889,3765321,3771036,7536357,0.000250651607932
DAL227,3p,19,T>C,862,530,1392,3765313,3771111,7536424,0.0001847029838023
DAL227,3p,20,T>C,898,637,1535,3765308,3771082,7536390,0.0002036784189777
DAL227,3p,21,T>C,943,584,1527,3765307,3771104,7536411,0.0002026163382013
DAL227,3p,22,T>C,952,698,1650,3765309,3771137,7536446,0.0002189360873812
DAL227,3p,23,T>C,957,717,1674,3765319,3771112,7536431,0.0002221210543823
DAL227,3p,24,T>C,994,888,1882,3765312,3771081,7536393,0.0002497215843175
DAL227,3p,25,T>C,1306,736,2042,3765249,3771100,7536349,0.0002709534815863
DAL227,5p,1,T>C,138,47,185,3765386,3771243,7536629,2.4546783449205208e-05
DAL227,5p,2,T>C,24,26,50,3765373,3771238,7536611,6.634281641974091e-06
DAL227,5p,3,T>C,185,182,367,3765386,3771243,7536629,4.8695510950585465e-05
DAL227,5p,4,T>C,142,87,229,3765385,3771243,7536628,3.0384941382273345e-05
DAL227,5p,5,T>C,649,519,1168,3765386,3771242,7536628,0.0001549764695829
DAL227,5p,6,T>C,697,449,1146,3765386,3771243,7536629,0.0001520573720691
DAL227,5p,7,T>C,760,434,1194,3765386,3771243,7536629,0.0001584262672343
DAL227,5p,8,T>C,915,731,1646,3765342,3771242,7536584,0.0002184013340792
DAL227,5p,9,T>C,1161,738,1899,3765324,3771243,7536567,0.000251971487814
DAL227,5p,10,T>C,953,471,1424,3765318,3771238,7536556,0.0001889457200344
DAL227,5p,11,T>C,1070,710,1780,3765365,3771237,7536602,0.0002361807084943
DAL227,5p,12,T>C,1038,843,1881,3765326,3771232,7536558,0.0002495834305262
DAL227,5p,13,T>C,779,613,1392,3765325,3771231,7536556,0.0001846997487977
DAL227,5p,14,T>C,944,614,1558,3765297,3771226,7536523,0.0002067266297734
DAL227,5p,15,T>C,1463,772,2235,3765318,3771201,7536519,0.0002965560094786
DAL227,5p,16,T>C,861,576,1437,3765316,3771188,7536504,0.0001906719614293
DAL227,5p,17,T>C,815,796,1611,3765326,3771175,7536501,0.0002137596744165
DAL227,5p,18,T>C,871,615,1486,3765280,3771169,7536449,0.0001971750886923
DAL227,5p,19,T>C,904,635,1539,3765279,3771164,7536443,0.0002042077409727
DAL227,5p,20,T>C,942,506,1448,3765254,3771167,7536421,0.0001921336400925
DAL227,5p,21,T>C,1457,732,2189,3765270,3771169,7536439,0.0002904554790399
DAL227,5p,22,T>C,1083,611,1694,3765253,3771158,7536411,0.000224775426924
DAL227,5p,23,T>C,980,663,1643,3765254,3771157,7536411,0.0002180082800685
DAL227,5p,24,T>C,1612,612,2224,3765270,3771180,7536450,0.0002950991514572
DAL227,5p,25,T>C,1126,553,1679,3765247,3771148,7536395,0.0002227855625932
WA02,3p,1,T>C,72,39,111,6552698,6754258,13306956,8.341501993393531e-06
WA02,3p,2,T>C,96,73,169,6552698,6754258,13306956,1.2700124656608168e-05
WA02,3p,3,T>C,201,258,459,6552698,6754258,13306956,3.449323797268136e-05
WA02,3p,4,T>C,326,352,678,6552698,6754256,13306954,5.095080361741688e-05
WA02,3p,5,T>C,1295,1274,2569,6552698,6754256,13306954,0.0001930569535297
WA02,3p,6,T>C,1275,1277,2552,6552698,6754257,13306955,0.0001917794115934
WA02,3p,7,T>C,1415,1385,2800,6552698,6754257,13306955,0.0002104162823125
WA02,3p,8,T>C,1634,1586,3220,6552692,6754207,13306899,0.0002419797429889
WA02,3p,9,T>C,1784,2080,3864,6552688,6754191,13306879,0.0002903761280161
WA02,3p,10,T>C,2018,1973,3991,6552680,6754207,13306887,0.0002999198835911
WA02,3p,11,T>C,2061,1666,3727,6552667,6754202,13306869,0.0002800809115953
WA02,3p,12,T>C,1965,1866,3831,6552670,6754189,13306859,0.0002878966403717
WA02,3p,13,T>C,1907,1576,3483,6552675,6754177,13306852,0.0002617448514494
WA02,3p,14,T>C,2026,2060,4086,6552653,6754155,13306808,0.0003070608668885
WA02,3p,15,T>C,2060,1865,3925,6552632,6754146,13306778,0.0002949624619874
WA02,3p,16,T>C,1947,1862,3809,6552629,6754119,13306748,0.0002862457453917
WA02,3p,17,T>C,1943,1769,3712,6552608,6754116,13306724,0.0002789567139139
WA02,3p,18,T>C,2083,1829,3912,6552611,6754085,13306696,0.0002939873278836
WA02,3p,19,T>C,1884,1897,3781,6552605,6754056,13306661,0.0002841434075761
WA02,3p,20,T>C,2176,2044,4220,6552618,6754033,13306651,0.000317134641917
WA02,3p,21,T>C,2098,1780,3878,6552597,6754089,13306686,0.0002914324423075
WA02,3p,22,T>C,1971,2037,4008,6552593,6754062,13306655,0.0003012026688901
WA02,3p,23,T>C,2105,1716,3821,6552585,6754052,13306637,0.0002871499387861
WA02,3p,24,T>C,1977,2139,4116,6552556,6754026,13306582,0.0003093206053966
WA02,3p,25,T>C,2040,1954,3994,6552517,6754038,13306555,0.0003001528194187
WA02,5p,1,T>C,86,105,191,6552698,6754258,13306956,1.4353395321965445e-05
WA02,5p,2,T>C,112,114,226,6552562,6754179,13306741,1.6983873061029745e-05
WA02,5p,3,T>C,443,298,741,6552698,6754258,13306956,5.568516195589735e-05
WA02,5p,4,T>C,397,239,636,6552698,6754258,13306956,4.779455196214672e-05
WA02,5p,5,T>C,1311,810,2121,6552698,6754258,13306956,0.0001593903218737
WA02,5p,6,T>C,1499,795,2294,6552697,6754258,13306955,0.0001723910541517
WA02,5p,7,T>C,1692,767,2459,6552685,6754258,13306943,0.0001847907517151
WA02,5p,8,T>C,2318,1407,3725,6552655,6754257,13306912,0.0002799297087107
WA02,5p,9,T>C,2809,1350,4159,6552662,6754226,13306888,0.0003125449015577
WA02,5p,10,T>C,2106,1270,3376,6552618,6754222,13306840,0.0002537041100667
WA02,5p,11,T>C,2620,1634,4254,6552625,6754225,13306850,0.0003196849742801
WA02,5p,12,T>C,2761,2113,4874,6552628,6754236,13306864,0.0003662771333651
WA02,5p,13,T>C,1927,1306,3233,6552614,6754205,13306819,0.0002429581404842
WA02,5p,14,T>C,2077,1324,3401,6552607,6754183,13306790,0.0002555838034567
WA02,5p,15,T>C,2230,1555,3785,6552586,6754168,13306754,0.0002844420209466
WA02,5p,16,T>C,2203,1692,3895,6552525,6754178,13306703,0.0002927096216095
WA02,5p,17,T>C,2170,1789,3959,6552567,6754148,13306715,0.0002975189594125
WA02,5p,18,T>C,2509,1547,4056,6552548,6754087,13306635,0.0003048103446137
WA02,5p,19,T>C,2210,1741,3951,6552516,6754124,13306640,0.0002969194327042
WA02,5p,20,T>C,2160,1616,3776,6552507,6754132,13306639,0.0002837681250689
WA02,5p,21,T>C,2506,1749,4255,6552521,6754152,13306673,0.0003197643768656
WA02,5p,22,T>C,2214,1743,3957,6552516,6754117,13306633,0.0002973704918441
WA02,5p,23,T>C,2195,1624,3819,6552465,6754131,13306596,0.000287000522147
WA02,5p,24,T>C,2609,1871,4480,6552457,6754135,13306592,0.000336675235853
WA02,5p,25,T>C,2195,1634,3829,6552470,6754083,13306553,0.0002877529590119
WA03,3p,1,T>C,172,39,211,5399458,5543742,10943200,1.928138021785218e-05
WA03,3p,2,T>C,191,162,353,5399458,5543742,10943200,3.225747496162e-05
WA03,3p,3,T>C,477,380,857,5399458,5543742,10943200,7.831347320710578e-05
WA03,3p,4,T>C,744,592,1336,5399458,5543736,10943194,0.0001220850146675
WA03,3p,5,T>C,3822,3832,7654,5399458,5543740,10943198,0.000699429910708
WA03,3p,6,T>C,3633,4134,7767,5399458,5543741,10943199,0.0007097558949627
WA03,3p,7,T>C,4005,3779,7784,5399458,5543739,10943197,0.0007113095012362
WA03,3p,8,T>C,4892,4445,9337,5399449,5543673,10943122,0.0008532300014566
WA03,3p,9,T>C,5291,5483,10774,5399436,5543670,10943106,0.0009845468005153
WA03,3p,10,T>C,5239,4980,10219,5399438,5543654,10943092,0.0009338311329192
WA03,3p,11,T>C,4817,4734,9551,5399404,5543644,10943048,0.000872791565933
WA03,3p,12,T>C,4983,5584,10567,5399397,5543595,10942992,0.0009656408411885
WA03,3p,13,T>C,4833,4999,9832,5399378,5543551,10942929,0.0008984797397479
WA03,3p,14,T>C,4598,4914,9512,5399356,5543493,10942849,0.0008692434666694
WA03,3p,15,T>C,5132,6164,11296,5399349,5543505,10942854,0.0010322718369449
WA03,3p,16,T>C,4982,5005,9987,5399342,5543495,10942837,0.0009126518104948
WA03,3p,17,T>C,4902,4801,9703,5399346,5543438,10942784,0.0008867030547253
WA03,3p,18,T>C,5299,5777,11076,5399325,5543443,10942768,0.0010121753472247
WA03,3p,19,T>C,5179,5260,10439,5399297,5543425,10942722,0.0009539673949498
WA03,3p,20,T>C,5421,5015,10436,5399252,5543409,10942661,0.0009536985565028
WA03,3p,21,T>C,5287,6080,11367,5399248,5543303,10942551,0.0010387888528004
WA03,3p,22,T>C,5479,5168,10647,5399256,5543263,10942519,0.0009729935127368
WA03,3p,23,T>C,5042,4929,9971,5399255,5543267,10942522,0.0009112158970299
WA03,3p,24,T>C,5419,5747,11166,5399198,5543130,10942328,0.0010204409884258
WA03,3p,25,T>C,5165,5168,10333,5399050,5543142,10942192,0.0009443263287648
WA03,5p,1,T>C,114,216,330,5399457,5543742,10943199,3.0155715892583148e-05
WA03,5p,2,T>C,228,213,441,5399258,5543638,10942896,4.030011799435908e-05
WA03,5p,3,T>C,918,704,1622,5399457,5543742,10943199,0.0001482199126599
WA03,5p,4,T>C,930,679,1609,5399458,5543742,10943200,0.0001470319467797
WA03,5p,5,T>C,3456,3336,6792,5399456,5543740,10943196,0.0006206596317931
WA03,5p,6,T>C,4214,3424,7638,5399452,5543742,10943194,0.0006979680703823
WA03,5p,7,T>C,4484,3394,7878,5399453,5543742,10943195,0.0007198994443578
WA03,5p,8,T>C,6116,5333,11449,5399403,5543732,10943135,0.0010462266982907
WA03,5p,9,T>C,6650,5849,12499,5399319,5543732,10943051,0.0011421860320307
WA03,5p,10,T>C,4858,4309,9167,5399344,5543717,10943061,0.0008376997989867
WA03,5p,11,T>C,5974,5442,11416,5399321,5543705,10943026,0.001043221500159
WA03,5p,12,T>C,6710,5579,12289,5399213,5543665,10942878,0.0011230135253267
WA03,5p,13,T>C,5482,4532,10014,5399156,5543662,10942818,0.000915120766881
WA03,5p,14,T>C,5020,4392,9412,5399124,5543629,10942753,0.0008601126243094
WA03,5p,15,T>C,6530,5395,11925,5399092,5543505,10942597,0.0010897778653458
WA03,5p,16,T>C,5556,5029,10585,5399083,5543501,10942584,0.0009673217952907
WA03,5p,17,T>C,5116,4741,9857,5399113,5543491,10942604,0.0009007910731303
WA03,5p,18,T>C,6372,5621,11993,5399074,5543600,10942674,0.0010959844001566
WA03,5p,19,T>C,5422,5368,10790,5399071,5543546,10942617,0.0009860529706924
WA03,5p,20,T>C,4825,5142,9967,5399050,5543533,10942583,0.0009108452730036
WA03,5p,21,T>C,6695,5596,12291,5399034,5543509,10942543,0.0011232306786457
WA03,5p,22,T>C,5766,5397,11163,5398989,5543454,10942443,0.0010201561022524
WA03,5p,23,T>C,5328,5002,10330,5398935,5543457,10942392,0.0009440349057134
WA03,5p,24,T>C,6719,5666,12385,5398952,5543428,10942380,0.0011318378634264
WA03,5p,25,T>C,5421,4996,10417,5398991,5543444,10942435,0.0009519818943407
WA07,3p,1,T>C,47,12,59,5691729,6013979,11705708,5.040276077277855e-06
WA07,3p,2,T>C,42,73,115,5691729,6013979,11705708,9.824266930287343e-06
WA07,3p,3,T>C,125,162,287,5691729,6013979,11705708,2.4517953121673636e-05
WA07,3p,4,T>C,252,161,413,5691729,6013979,11705708,3.528193254094498e-05
WA07,3p,5,T>C,877,1285,2162,5691729,6013979,11705708,0.0001846962182894
WA07,3p,6,T>C,1028,1044,2072,5691729,6013979,11705708,0.0001770076615613
WA07,3p,7,T>C,1077,998,2075,5691729,6013979,11705708,0.0001772639467856
WA07,3p,8,T>C,1332,1128,2460,5691713,6013800,11705513,0.0002101573848151
WA07,3p,9,T>C,1173,1042,2215,5691720,6013901,11705621,0.0001892253302921
WA07,3p,10,T>C,1500,1279,2779,5691718,6013892,11705610,0.0002374075336526
WA07,3p,11,T>C,1555,1601,3156,5691711,6013883,11705594,0.0002696146816641
WA07,3p,12,T>C,1270,1516,2786,5691705,6013884,11705589,0.0002380059645012
WA07,3p,13,T>C,1339,1192,2531,5691711,6013848,11705559,0.0002162220531287
WA07,3p,14,T>C,1409,1182,2591,5691695,6013877,11705572,0.0002213475770342
WA07,3p,15,T>C,1329,1324,2653,5691211,6013856,11705067,0.0002266539781446
WA07,3p,16,T>C,1501,1714,3215,5691636,6013850,11705486,0.0002746575409171
WA07,3p,17,T>C,1435,1247,2682,5691662,6013813,11705475,0.0002291235511587
WA07,3p,18,T>C,1193,1273,2466,5691639,6013769,11705408,0.0002106718535569
WA07,3p,19,T>C,1770,1582,3352,5691628,6013742,11705370,0.000286364292628
WA07,3p,20,T>C,1403,1190,2593,5691604,6013772,11705376,0.0002215221450383
WA07,3p,21,T>C,1404,1368,2772,5691611,6013735,11705346,0.0002368148707436
WA07,3p,22,T>C,1633,1584,3217,5691577,6013736,11705313,0.0002748324628311
WA07,3p,23,T>C,1385,1325,2710,5691568,6013670,11705238,0.0002315202817747
WA07,3p,24,T>C,1593,1382,2975,5691554,6013661,11705215,0.00025416021833
WA07,3p,25,T>C,1344,1396,2740,5691455,6013662,11705117,0.000234085656726
WA07,5p,1,T>C,43,36,79,5691729,6013979,11705708,6.748844239066958e-06
WA07,5p,2,T>C,74,81,155,5691636,6013923,11705559,1.3241571803619118e-05
WA07,5p,3,T>C,279,559,838,5691729,6013979,11705708,7.158900597896343e-05
WA07,5p,4,T>C,271,150,421,5691728,6013979,11705707,3.596536287812432e-05
WA07,5p,5,T>C,807,622,1429,5691729,6013978,11705707,0.0001220772055886
WA07,5p,6,T>C,1005,605,1610,5691728,6013979,11705707,0.0001375397487738
WA07,5p,7,T>C,1220,732,1952,5691728,6013979,11705707,0.0001667562668363
WA07,5p,8,T>C,1353,910,2263,5691579,6013975,11705554,0.0001933270309119
WA07,5p,9,T>C,1470,874,2344,5691672,6013971,11705643,0.0002002453004931
WA07,5p,10,T>C,1456,712,2168,5691582,6013961,11705543,0.0001852113994199
WA07,5p,11,T>C,1922,1118,3040,5691326,6013942,11705268,0.0002597121227809
WA07,5p,12,T>C,1805,1008,2813,5691520,6013938,11705458,0.0002403152443928
WA07,5p,13,T>C,1483,901,2384,5691511,6013949,11705460,0.0002036656397954
WA07,5p,14,T>C,1284,1243,2527,5691556,6013950,11705506,0.0002158813126062
WA07,5p,15,T>C,1633,1078,2711,5691563,6013633,11705196,0.000231606544649
WA07,5p,16,T>C,1611,1495,3106,5691534,6013925,11705459,0.0002653462798853
WA07,5p,17,T>C,1625,1008,2633,5691561,6013916,11705477,0.0002249374374064
WA07,5p,18,T>C,1568,1503,3071,5691474,6013905,11705379,0.0002623580150629
WA07,5p,19,T>C,1383,906,2289,5691482,6013884,11705366,0.0001955513394455
WA07,5p,20,T>C,1467,1305,2772,5691421,6013876,11705297,0.0002368158620836
WA07,5p,21,T>C,1826,1427,3253,5691379,6013853,11705232,0.000277909912422
WA07,5p,22,T>C,1879,1037,2916,5691396,6013861,11705257,0.0002491188360921
WA07,5p,23,T>C,1750,957,2707,5691314,6013795,11705109,0.0002312665349805
WA07,5p,24,T>C,1466,1093,2559,5691332,6013785,11705117,0.0002186223341466
WA07,5p,25,T>C,1588,1273,2861,5691334,6013719,11705053,0.000244424352457
WA08,3p,1,T>C,82,50,132,6798117,7189085,13987202,9.437198376058342e-06
WA08,3p,2,T>C,94,110,204,6798117,7189085,13987202,1.458476112663562e-05
WA08,3p,3,T>C,272,197,469,6798117,7189085,13987202,3.353065180584366e-05
WA08,3p,4,T>C,382,300,682,6798117,7189081,13987198,4.8758872220154456e-05
WA08,3p,5,T>C,1566,1391,2957,6798117,7189085,13987202,0.0002114075424091
WA08,3p,6,T>C,1680,1657,3337,6798117,7189085,13987202,0.0002385752347038
WA08,3p,7,T>C,2164,1665,3829,6798117,7189084,13987201,0.0002737502664042
WA08,3p,8,T>C,2150,1913,4063,6798110,7189053,13987163,0.0002904806357086
WA08,3p,9,T>C,2258,2290,4548,6798103,7189051,13987154,0.0003251554962503
WA08,3p,10,T>C,2390,2094,4484,6798074,7189042,13987116,0.0003205807401611
WA08,3p,11,T>C,2416,1994,4410,6798109,7189046,13987155,0.0003152892779124
WA08,3p,12,T>C,2347,1921,4268,6798091,7189018,13987109,0.0003051381096694
WA08,3p,13,T>C,2690,1814,4504,6798090,7189013,13987103,0.0003220109267801
WA08,3p,14,T>C,2608,2259,4867,6798067,7188981,13987048,0.0003479647742683
WA08,3p,15,T>C,2712,1874,4586,6798069,7188978,13987047,0.0003278747830045
WA08,3p,16,T>C,2842,2020,4862,6798049,7188961,13987010,0.0003476082450788
WA08,3p,17,T>C,2866,1864,4730,6798000,7188943,13986943,0.0003381725370583
WA08,3p,18,T>C,3038,2235,5273,6798023,7188956,13986979,0.0003769934880148
WA08,3p,19,T>C,2682,1910,4592,6798028,7188946,13986974,0.0003283054647845
WA08,3p,20,T>C,2671,2199,4870,6798009,7188917,13986926,0.0003481822953807
WA08,3p,21,T>C,3291,2061,5352,6798010,7188926,13986936,0.0003826427746577
WA08,3p,22,T>C,2892,2099,4991,6798012,7188920,13986932,0.0003568330781904
WA08,3p,23,T>C,5048,2212,7260,6798009,7188864,13986873,0.0005190581197098
WA08,3p,24,T>C,3639,2378,6017,6798015,7188867,13986882,0.0004301888011924
WA08,3p,25,T>C,3303,2446,5749,6797966,7188892,13986858,0.0004110286956513
WA08,5p,1,T>C,69,162,231,6798116,7189085,13987201,1.6515098338831334e-05
WA08,5p,2,T>C,101,122,223,6797941,7188997,13986938,1.5943446664309228e-05
WA08,5p,3,T>C,382,395,777,6798117,7189084,13987201,5.555078532152359e-05
WA08,5p,4,T>C,360,364,724,6798115,7189085,13987200,5.176161061541981e-05
WA08,5p,5,T>C,1428,949,2377,6798116,7189084,13987200,0.0001699410889956
WA08,5p,6,T>C,1598,1019,2617,6798112,7189085,13987197,0.0001870996740805
WA08,5p,7,T>C,1684,901,2585,6798110,7189085,13987195,0.0001848118940216
WA08,5p,8,T>C,2358,1627,3985,6798069,7189064,13987133,0.000284904704917
WA08,5p,9,T>C,2774,1436,4210,6798054,7189067,13987121,0.0003009911760969
WA08,5p,10,T>C,2406,1310,3716,6798015,7189037,13987052,0.0002656742821861
WA08,5p,11,T>C,2676,1489,4165,6797997,7189047,13987044,0.0002977755700203
WA08,5p,12,T>C,2843,1568,4411,6798016,7189056,13987072,0.0003153626434467
WA08,5p,13,T>C,2404,1229,3633,6797995,7189043,13987038,0.000259740482581
WA08,5p,14,T>C,2335,1604,3939,6797984,7189041,13987025,0.0002816181425285
WA08,5p,15,T>C,2545,1523,4068,6797997,7189013,13987010,0.0002908412877376
WA08,5p,16,T>C,2636,1541,4177,6797921,7188997,13986918,0.0002986361970521
WA08,5p,17,T>C,2548,1773,4321,6797959,7188875,13986834,0.0003089333869265
WA08,5p,18,T>C,3091,1842,4933,6797991,7188972,13986963,0.000352685568697
WA08,5p,19,T>C,2527,1913,4440,6797966,7188988,13986954,0.0003174386646299
WA08,5p,20,T>C,2411,1843,4254,6797883,7188971,13986854,0.0003041427328833
WA08,5p,21,T>C,2652,1948,4600,6797885,7188979,13986864,0.0003288800119883
WA08,5p,22,T>C,2249,1948,4197,6797887,7188939,13986826,0.0003000680783474
WA08,5p,23,T>C,2405,1993,4398,6797851,7188919,13986770,0.0003144400029456
WA08,5p,24,T>C,2462,1999,4461,6797841,7188876,13986717,0.0003189454680465
WA08,5p,25,T>C,2308,1823,4131,6797835,7188817,13986652,0.0002953530265856
WA09,3p,1,T>C,180,52,232,4741672,4881751,9623423,2.4107846033578696e-05
WA09,3p,2,T>C,160,120,280,4741672,4881751,9623423,2.9095676247422563e-05
WA09,3p,3,T>C,400,250,650,4741672,4881751,9623423,6.754353414580238e-05
WA09,3p,4,T>C,713,506,1219,4741672,4881748,9623420,0.0001266701442938
WA09,3p,5,T>C,3866,3485,7351,4741672,4881751,9623423,0.0007638654146242
WA09,3p,6,T>C,3639,3650,7289,4741672,4881751,9623423,0.000757422800598
WA09,3p,7,T>C,4034,3461,7495,4741672,4881748,9623420,0.0007788291480575
WA09,3p,8,T>C,4548,4089,8637,4741663,4881718,9623381,0.0008975016161159
WA09,3p,9,T>C,5098,4416,9514,4741664,4881723,9623387,0.0009886332119865
WA09,3p,10,T>C,5150,5374,10524,4741658,4881705,9623363,0.001093588592678
WA09,3p,11,T>C,4879,4734,9613,4741648,4881712,9623360,0.0009989234529312
WA09,3p,12,T>C,5070,4861,9931,4741642,4881680,9623322,0.0010319721193991
WA09,3p,13,T>C,5518,4642,10160,4741628,4881645,9623273,0.0010557738515783
WA09,3p,14,T>C,5083,4610,9693,4741616,4881571,9623187,0.0010072546652164
WA09,3p,15,T>C,5420,5231,10651,4741598,4881557,9623155,0.0011068095650542
WA09,3p,16,T>C,5320,4733,10053,4741586,4881546,9623132,0.0010446702799047
WA09,3p,17,T>C,5249,4458,9707,4741582,4881528,9623110,0.0010087175559668
WA09,3p,18,T>C,5165,4655,9820,4741560,4881490,9623050,0.0010204664841188
WA09,3p,19,T>C,5301,4666,9967,4741552,4881442,9622994,0.0010357483336267
WA09,3p,20,T>C,5088,5561,10649,4741534,4881501,9623035,0.0011066155324177
WA09,3p,21,T>C,5249,5025,10274,4741546,4881493,9623039,0.001067646093921
WA09,3p,22,T>C,5381,5403,10784,4741524,4881498,9623022,0.0011206458844217
WA09,3p,23,T>C,5471,5164,10635,4741501,4881486,9622987,0.0011051662025522
WA09,3p,24,T>C,5438,5004,10442,4741491,4881450,9622941,0.0010851152469915
WA09,3p,25,T>C,5149,5324,10473,4741451,4881469,9622920,0.0010883390904216
WA09,5p,1,T>C,98,194,292,4741672,4881751,9623423,3.0342633800883533e-05
WA09,5p,2,T>C,214,170,384,4741495,4881667,9623162,3.990372395268832e-05
WA09,5p,3,T>C,505,429,934,4741672,4881750,9623422,9.705487299632085e-05
WA09,5p,4,T>C,680,365,1045,4741672,4881751,9623423,0.0001085892202805
WA09,5p,5,T>C,3335,2019,5354,4741671,4881751,9623422,0.0005563509529146
WA09,5p,6,T>C,3745,2043,5788,4741669,4881751,9623420,0.0006014493807814
WA09,5p,7,T>C,3986,1948,5934,4741667,4881751,9623418,0.0006166208305614
WA09,5p,8,T>C,5542,3492,9034,4741639,4881744,9623383,0.0009387551134564
WA09,5p,9,T>C,6081,3590,9671,4741618,4881747,9623365,0.0010049499317546
WA09,5p,10,T>C,4908,3015,7923,4741622,4881737,9623359,0.0008233092000412
WA09,5p,11,T>C,6053,4279,10332,4741614,4881733,9623347,0.0010736389324836
WA09,5p,12,T>C,6323,4412,10735,4741580,4881734,9623314,0.0011155200796731
WA09,5p,13,T>C,5302,3937,9239,4741530,4881708,9623238,0.0009600718593887
WA09,5p,14,T>C,5013,3941,8954,4741498,4881705,9623203,0.0009304594322701
WA09,5p,15,T>C,5850,4277,10127,4741496,4881672,9623168,0.0010523561471648
WA09,5p,16,T>C,5414,4431,9845,4741451,4881636,9623087,0.001023060479449
WA09,5p,17,T>C,5444,4751,10195,4741476,4881638,9623114,0.0010594283721464
WA09,5p,18,T>C,6204,4708,10912,4741455,4881610,9623065,0.0011339422522865
WA09,5p,19,T>C,5174,4680,9854,4741379,4881580,9622959,0.0010240093509699
WA09,5p,20,T>C,5039,4777,9816,4741390,4881557,9622947,0.0010200617336871
WA09,5p,21,T>C,6050,4544,10594,4741379,4881587,9622966,0.0011009079736954
WA09,5p,22,T>C,5122,4827,9949,4741354,4881580,9622934,0.0010338842602474
WA09,5p,23,T>C,5152,5218,10370,4741312,4881565,9622877,0.0010776402940617
WA09,5p,24,T>C,6079,4858,10937,4741363,4881548,9622911,0.0011365583657585
WA09,5p,25,T>C,5452,4439,9891,4741301,4881503,9622804,0.0010278708783843
WA11,3p,1,T>C,131,50,181,9756642,10108269,19864911,9.111543464755518e-06
WA11,3p,2,T>C,137,126,263,9756642,10108269,19864911,1.3239425034423764e-05
WA11,3p,3,T>C,419,386,805,9756642,10108269,19864911,4.052371540954802e-05
WA11,3p,4,T>C,565,594,1159,9756642,10108267,19864909,5.834408806000572e-05
WA11,3p,5,T>C,2923,3544,6467,9756642,10108269,19864911,0.0003255489037932
WA11,3p,6,T>C,2872,3701,6573,9756642,10108269,19864911,0.0003308849458223
WA11,3p,7,T>C,3135,3587,6722,9756642,10108265,19864907,0.0003383856768118
WA11,3p,8,T>C,3397,3927,7324,9756629,10108160,19864789,0.000368692564517
WA11,3p,9,T>C,3752,4119,7871,9756610,10108092,19864702,0.000396230459435
WA11,3p,10,T>C,3940,4252,8192,9756615,10107969,19864584,0.0004123922252789
WA11,3p,11,T>C,3799,4207,8006,9756587,10107918,19864505,0.0004030304304084
WA11,3p,12,T>C,4929,4030,8959,9756581,10108019,19864600,0.0004510032922887
WA11,3p,13,T>C,3819,3943,7762,9756565,10107963,19864528,0.0003907467622689
WA11,3p,14,T>C,3823,3582,7405,9756515,10107914,19864429,0.0003727768867657
WA11,3p,15,T>C,3947,3830,7777,9756471,10107972,19864443,0.0003915035523523
WA11,3p,16,T>C,3911,3859,7770,9756477,10108011,19864488,0.0003911502778224
WA11,3p,17,T>C,4173,4125,8298,9756469,10108044,19864513,0.0004177298481971
WA11,3p,18,T>C,3854,3718,7572,9756421,10108016,19864437,0.0003811837204346
WA11,3p,19,T>C,4018,4019,8037,9756438,10108000,19864438,0.0004045923675263
WA11,3p,20,T>C,4257,3930,8187,9756433,10107963,19864396,0.0004121444216073
WA11,3p,21,T>C,3961,4387,8348,9756421,10107904,19864325,0.000420250876886
WA11,3p,22,T>C,4233,4260,8493,9756405,10107842,19864247,0.0004275520738339
WA11,3p,23,T>C,4020,4099,8119,9756375,10107816,19864191,0.0004087254295933
WA11,3p,24,T>C,4207,3793,8000,9756358,10107704,19864062,0.0004027373656002
WA11,3p,25,T>C,4237,3839,8076,9756281,10107693,19863974,0.0004065651717022
WA11,5p,1,T>C,104,365,469,9756641,10108269,19864910,2.360947016623785e-05
WA11,5p,2,T>C,138,3593,3731,9756471,10108196,19864667,0.0001878209184176
WA11,5p,3,T>C,976,728,1704,9756642,10108269,19864911,8.577939261847184e-05
WA11,5p,4,T>C,793,472,1265,9756638,10108269,19864907,6.36801370376413e-05
WA11,5p,5,T>C,2856,2119,4975,9756638,10108267,19864905,0.0002504416708763
WA11,5p,6,T>C,3374,2475,5849,9756642,10108269,19864911,0.0002944387719632
WA11,5p,7,T>C,3973,2314,6287,9756629,10108269,19864898,0.0003164879074637
WA11,5p,8,T>C,4324,2625,6949,9756500,10108261,19864761,0.0003498154344771
WA11,5p,9,T>C,4983,2941,7924,9756493,10108240,19864733,0.0003988978860173
WA11,5p,10,T>C,4131,2386,6517,9756446,10108197,19864643,0.0003280703307882
WA11,5p,11,T>C,5406,3550,8956,9756457,10108195,19864652,0.0004508510896641
WA11,5p,12,T>C,6631,3235,9866,9756411,10108221,19864632,0.0004966616044032
WA11,5p,13,T>C,4731,3080,7811,9756334,10108178,19864512,0.0003932137874819
WA11,5p,14,T>C,6536,3157,9693,9756261,10108167,19864428,0.0004879576698609
WA11,5p,15,T>C,6650,3547,10197,9756237,10108096,19864333,0.0005133321113777
WA11,5p,16,T>C,4431,3386,7817,9756275,10108079,19864354,0.0003935189636672
WA11,5p,17,T>C,4420,3653,8073,9756369,10108078,19864447,0.0004064044672373
WA11,5p,18,T>C,4798,3998,8796,9756327,10108075,19864402,0.0004428021543261
WA11,5p,19,T>C,3916,4571,8487,9756284,10108088,19864372,0.000427247335078
WA11,5p,20,T>C,4949,4041,8990,9756292,10108082,19864374,0.0004525690062017
WA11,5p,21,T>C,5281,4072,9353,9756251,10108036,19864287,0.0004708449893016
WA11,5p,22,T>C,4361,7297,11658,9756136,10108029,19864165,0.0005868859828741
WA11,5p,23,T>C,4017,4285,8302,9756095,10108016,19864111,0.0004179396701921
WA11,5p,24,T>C,4630,4228,8858,9756046,10108010,19864056,0.0004459310827557
WA11,5p,25,T>C,4062,3929,7991,9756056,10107943,19863999,0.0004022855619354
WA12,3p,1,T>C,412,41,453,6632243,6940679,13572922,3.3375274682931204e-05
WA12,3p,2,T>C,274,111,385,6632243,6940679,13572922,2.836529967533889e-05
WA12,3p,3,T>C,573,316,889,6632243,6940679,13572922,6.549805561396434e-05
WA12,3p,4,T>C,854,383,1237,6632243,6940676,13572919,9.113735962028508e-05
WA12,3p,5,T>C,3507,2431,5938,6632243,6940678,13572921,0.0004374887321601
WA12,3p,6,T>C,3331,2430,5761,6632243,6940679,13572922,0.0004244480296873
WA12,3p,7,T>C,3500,2466,5966,6632243,6940676,13572919,0.0004395517279665
WA12,3p,8,T>C,3662,2571,6233,6632240,6940664,13572904,0.0004592237593369
WA12,3p,9,T>C,4065,3207,7272,6632231,6940656,13572887,0.000535774002981
WA12,3p,10,T>C,4511,3230,7741,6632228,6940644,13572872,0.0005703288147121
WA12,3p,11,T>C,3921,2869,6790,6632231,6940642,13572873,0.000500262545741
WA12,3p,12,T>C,3955,3166,7121,6632223,6940615,13572838,0.000524650776794
WA12,3p,13,T>C,4057,3046,7103,6632204,6940591,13572795,0.0005233262566774
WA12,3p,14,T>C,3909,2981,6890,6632209,6940533,13572742,0.0005076350821374
WA12,3p,15,T>C,4038,3381,7419,6632188,6940474,13572662,0.0005466134793602
WA12,3p,16,T>C,4153,3259,7412,6632187,6940478,13572665,0.000546097616054
WA12,3p,17,T>C,3824,3013,6837,6632168,6940473,13572641,0.0005037339453684
WA12,3p,18,T>C,4061,3298,7359,6632160,6940482,13572642,0.0005421936274455
WA12,3p,19,T>C,4000,3040,7040,6632121,6940435,13572556,0.0005186937523042
WA12,3p,20,T>C,3780,2914,6694,6632105,6940432,13572537,0.0004932018236531
WA12,3p,21,T>C,3932,3124,7056,6632096,6940454,13572550,0.0005198728315607
WA12,3p,22,T>C,4221,3048,7269,6632039,6940438,13572477,0.0005355691521893
WA12,3p,23,T>C,3926,2814,6740,6631950,6940459,13572409,0.0004965957038282
WA12,3p,24,T>C,4115,3383,7498,6631933,6940411,13572344,0.0005524469465259
WA12,3p,25,T>C,4316,3065,7381,6631986,6940428,13572414,0.0005438236705717
WA12,5p,1,T>C,79,147,226,6632243,6940679,13572922,1.665079928993919e-05
WA12,5p,2,T>C,112,139,251,6631949,6940524,13572473,1.849331363562116e-05
WA12,5p,3,T>C,527,219,746,6632242,6940678,13572920,5.496238097623798e-05
WA12,5p,4,T>C,686,279,965,6632242,6940679,13572921,7.109744468416194e-05
WA12,5p,5,T>C,2638,1612,4250,6632242,6940677,13572919,0.0003131235071836
WA12,5p,6,T>C,3204,1776,4980,6632242,6940679,13572921,0.0003669070202353
WA12,5p,7,T>C,3438,1615,5053,6632238,6940679,13572917,0.0003722854858686
WA12,5p,8,T>C,4274,2412,6686,6632204,6940670,13572874,0.0004926001670685
WA12,5p,9,T>C,4575,2208,6783,6632209,6940675,13572884,0.0004997464061433
WA12,5p,10,T>C,3792,2058,5850,6632199,6940665,13572864,0.0004310070446443
WA12,5p,11,T>C,4543,2723,7266,6632166,6940667,13572833,0.00053533407506
WA12,5p,12,T>C,5119,2716,7835,6632126,6940660,13572786,0.0005772580515157
WA12,5p,13,T>C,4078,2718,6796,6632065,6940658,13572723,0.0005007101375309
WA12,5p,14,T>C,3737,2607,6344,6632026,6940638,13572664,0.0004674100825011
WA12,5p,15,T>C,4689,2947,7636,6631987,6940631,13572618,0.0005626033238392
WA12,5p,16,T>C,4052,3096,7148,6631930,6940590,13572520,0.0005266523829031
WA12,5p,17,T>C,4070,2834,6904,6631958,6940621,13572579,0.0005086726700946
WA12,5p,18,T>C,4774,3441,8215,6632019,6940577,13572596,0.000605263724051
WA12,5p,19,T>C,4950,3418,8368,6631996,6940532,13572528,0.0006165395274925
WA12,5p,20,T>C,3803,3205,7008,6631973,6940532,13572505,0.0005163379936128
WA12,5p,21,T>C,4512,3309,7821,6631936,6940534,13572470,0.000576239991689
WA12,5p,22,T>C,4274,3442,7716,6631921,6940529,13572450,0.000568504580971
WA12,5p,23,T>C,3887,3113,7000,6631926,6940534,13572460,0.0005157502766631
WA12,5p,24,T>C,4433,3322,7755,6631934,6940518,13572452,0.0005713779647185
WA12,5p,25,T>C,4288,3061,7349,6631933,6940515,13572448,0.0005414645906176
WA13,3p,1,T>C,25,14,39,5896847,6081528,11978375,3.2558673442766653e-06
WA13,3p,2,T>C,24,28,52,5896847,6081528,11978375,4.341156459035554e-06
WA13,3p,3,T>C,53,40,93,5896847,6081528,11978375,7.76399135942897e-06
WA13,3p,4,T>C,183,63,246,5896847,6081522,11978369,2.0537019689408463e-05
WA13,3p,5,T>C,354,256,610,5896847,6081527,11978374,5.092510886702986e-05
WA13,3p,6,T>C,305,248,553,5896847,6081528,11978375,4.616652926628194e-05
WA13,3p,7,T>C,394,241,635,5896847,6081528,11978375,5.301219906706878e-05
WA13,3p,8,T>C,461,313,774,5896845,6081521,11978366,6.461649276704352e-05
WA13,3p,9,T>C,363,331,694,5896842,6081517,11978359,5.793781936240181e-05
WA13,3p,10,T>C,468,533,1001,5896843,6081517,11978360,8.356736648422656e-05
WA13,3p,11,T>C,407,400,807,5896841,6081492,11978333,6.737164511956714e-05
WA13,3p,12,T>C,465,448,913,5896836,6081505,11978341,7.622090571640931e-05
WA13,3p,13,T>C,581,457,1038,5896834,6081495,11978329,8.665649440752546e-05
WA13,3p,14,T>C,349,271,620,5896832,6081501,11978333,5.176012388368231e-05
WA13,3p,15,T>C,405,392,797,5896825,6081505,11978330,6.653682107605985e-05
WA13,3p,16,T>C,444,338,782,5896830,6081509,11978339,6.528451064876357e-05
WA13,3p,17,T>C,710,245,955,5896823,6081499,11978322,7.972736081063775e-05
WA13,3p,18,T>C,540,394,934,5896827,6081499,11978326,7.797416767585054e-05
WA13,3p,19,T>C,605,388,993,5896822,6081480,11978302,8.289989683011833e-05
WA13,3p,20,T>C,575,366,941,5896818,6081448,11978266,7.855895001830816e-05
WA13,3p,21,T>C,525,359,884,5896824,6081466,11978290,7.38001834986463e-05
WA13,3p,22,T>C,471,499,970,5896824,6081460,11978284,8.097987992270012e-05
WA13,3p,23,T>C,415,400,815,5896819,6081454,11978273,6.803985850046998e-05
WA13,3p,24,T>C,664,778,1442,5896803,6081440,11978243,0.0001203849345851
WA13,3p,25,T>C,491,410,901,5896783,6081437,11978220,7.5219857374468e-05
WA13,5p,1,T>C,23,42,65,5896847,6081528,11978375,5.426445573794442e-06
WA13,5p,2,T>C,40,64,104,5896725,6081443,11978168,8.682462960946949e-06
WA13,5p,3,T>C,134,141,275,5896847,6081528,11978375,2.295803896605341e-05
WA13,5p,4,T>C,146,48,194,5896841,6081528,11978369,1.619586105587497e-05
WA13,5p,5,T>C,211,136,347,5896841,6081528,11978369,2.896888549684853e-05
WA13,5p,6,T>C,326,168,494,5896841,6081528,11978369,4.124100701856822e-05
WA13,5p,7,T>C,401,246,647,5896845,6081528,11978373,5.401401342235711e-05
WA13,5p,8,T>C,525,286,811,5896843,6081526,11978369,6.770537791914742e-05
WA13,5p,9,T>C,575,293,868,5896837,6081518,11978355,7.246404034610763e-05
WA13,5p,10,T>C,715,382,1097,5896833,6081518,11978351,9.158188802448683e-05
WA13,5p,11,T>C,515,235,750,5896827,6081513,11978340,6.261301649477307e-05
WA13,5p,12,T>C,435,270,705,5896822,6081502,11978324,5.885631412207584e-05
WA13,5p,13,T>C,416,201,617,5896809,6081508,11978317,5.150974047522703e-05
WA13,5p,14,T>C,498,329,827,5896802,6081520,11978322,6.904138993758892e-05
WA13,5p,15,T>C,423,245,668,5896798,6081508,11978306,5.5767484984938606e-05
WA13,5p,16,T>C,443,314,757,5896754,6081491,11978245,6.319790587018382e-05
WA13,5p,17,T>C,384,311,695,5896805,6081514,11978319,5.802149700638295e-05
WA13,5p,18,T>C,522,342,864,5896796,6081504,11978300,7.213043587153436e-05
WA13,5p,19,T>C,384,318,702,5896797,6081472,11978269,5.86061308190691e-05
WA13,5p,20,T>C,380,326,706,5896788,6081482,11978270,5.894006396583146e-05
WA13,5p,21,T>C,585,258,843,5896782,6081484,11978266,7.037746531927075e-05
WA13,5p,22,T>C,425,377,802,5896771,6081483,11978254,6.695466634786672e-05
WA13,5p,23,T>C,468,396,864,5896768,6081501,11978269,7.213062254654658e-05
WA13,5p,24,T>C,486,265,751,5896781,6081498,11978279,6.269681980190977e-05
WA13,5p,25,T>C,485,616,1101,5896769,6081462,11978231,9.19167446344957e-05
WA14,3p,1,T>C,53,30,83,6684341,7140972,13825313,6.003480716856103e-06
WA14,3p,2,T>C,68,59,127,6684341,7140972,13825313,9.18604880771958e-06
WA14,3p,3,T>C,183,252,435,6684341,7140972,13825313,3.146402544376391e-05
WA14,3p,4,T>C,338,372,710,6684341,7140971,13825312,5.1355079726229686e-05
WA14,3p,5,T>C,1841,2123,3964,6684341,7140970,13825311,0.0002867204940272
WA14,3p,6,T>C,2506,2122,4628,6684341,7140971,13825312,0.0003347483224971
WA14,3p,7,T>C,2133,2118,4251,6684341,7140969,13825310,0.0003074795429541
WA14,3p,8,T>C,2575,2086,4661,6684326,7140932,13825258,0.0003371365655527
WA14,3p,9,T>C,2535,2087,4622,6684323,7140920,13825243,0.0003343160044275
WA14,3p,10,T>C,2949,2166,5115,6684256,7140912,13825168,0.0003699774208892
WA14,3p,11,T>C,2419,2225,4644,6684256,7140894,13825150,0.000335909556135
WA14,3p,12,T>C,2945,2850,5795,6684291,7140849,13825140,0.0004191639289005
WA14,3p,13,T>C,2658,2867,5525,6684289,7140794,13825083,0.0003996359370862
WA14,3p,14,T>C,3021,2731,5752,6684291,7140742,13825033,0.0004160568730649
WA14,3p,15,T>C,3192,2869,6061,6684271,7140702,13824973,0.0004384095361343
WA14,3p,16,T>C,3808,3036,6844,6684263,7140648,13824911,0.0004950483948865
WA14,3p,17,T>C,3130,3066,6196,6684212,7140653,13824865,0.0004481779749748
WA14,3p,18,T>C,2987,3039,6026,6684177,7140647,13824824,0.0004358825833876
WA14,3p,19,T>C,2821,3022,5843,6684172,7140542,13824714,0.000422648888071
WA14,3p,20,T>C,3018,3035,6053,6684176,7140544,13824720,0.0004378388857061
WA14,3p,21,T>C,4117,2598,6715,6684132,7140443,13824575,0.0004857292177155
WA14,3p,22,T>C,4388,2555,6943,6684105,7140560,13824665,0.0005022183177675
WA14,3p,23,T>C,3002,3260,6262,6683638,7140562,13824200,0.0004529737706341
WA14,3p,24,T>C,2961,2880,5841,6683623,7140532,13824155,0.0004225213041954
WA14,3p,25,T>C,3102,3081,6183,6683613,7140513,13824126,0.0004472615483973
WA14,5p,1,T>C,97,63,160,6684341,7140972,13825313,1.1572974875867189e-05
WA14,5p,2,T>C,116,105,221,6684184,7140911,13825095,1.5985423608300703e-05
WA14,5p,3,T>C,797,705,1502,6684338,7140972,13825310,0.0001086413252216
WA14,5p,4,T>C,636,187,823,6684341,7140972,13825313,5.952848951774184e-05
WA14,5p,5,T>C,2259,1281,3540,6684341,7140972,13825313,0.0002560520691285
WA14,5p,6,T>C,2165,1170,3335,6684340,7140972,13825312,0.0002412242125168
WA14,5p,7,T>C,2823,1318,4141,6684336,7140972,13825308,0.0002995231643302
WA14,5p,8,T>C,3575,1963,5538,6684277,7140970,13825247,0.00040057150516
WA14,5p,9,T>C,3542,1605,5147,6684241,7140959,13825200,0.0003722911784277
WA14,5p,10,T>C,2843,1484,4327,6684210,7140628,13824838,0.0003129873926913
WA14,5p,11,T>C,4037,2152,6189,6684218,7140646,13824864,0.0004476716732981
WA14,5p,12,T>C,3153,2806,5959,6684139,7140917,13825056,0.0004310289954702
WA14,5p,13,T>C,4361,2163,6524,6684018,7140931,13824949,0.0004719004750035
WA14,5p,14,T>C,2725,2049,4774,6683951,7140942,13824893,0.0003453191283288
WA14,5p,15,T>C,3478,2759,6237,6684030,7140908,13824938,0.0004511412637076
WA14,5p,16,T>C,2896,2601,5497,6683910,7140868,13824778,0.0003976194048106
WA14,5p,17,T>C,2800,2312,5112,6683904,7140873,13824777,0.0003697708831035
WA14,5p,18,T>C,3484,2507,5991,6683891,7140646,13824537,0.000433359902035
WA14,5p,19,T>C,3167,2291,5458,6683958,7140595,13824553,0.0003948048085171
WA14,5p,20,T>C,3087,2403,5490,6683860,7140558,13824418,0.0003971234087395
WA14,5p,21,T>C,3664,2413,6077,6683480,7140494,13823974,0.0004395986277173
WA14,5p,22,T>C,3444,2629,6073,6683768,7140398,13824166,0.0004393031738768
WA14,5p,23,T>C,3489,2412,5901,6683762,7140257,13824019,0.000426865732751
WA14,5p,24,T>C,3648,2557,6205,6683714,7140421,13824135,0.0004488526768582
WA14,5p,25,T>C,2997,2324,5321,6683731,7140511,13824242,0.0003849035628861
WA18,3p,1,T>C,194,102,296,14112928,14131239,28244167,1.0480040002595936e-05
WA18,3p,2,T>C,172,165,337,14112928,14131239,28244167,1.1931667165117668e-05
WA18,3p,3,T>C,581,395,976,14112928,14131239,28244167,3.4555807576127136e-05
WA18,3p,4,T>C,1236,1391,2627,14112928,14131238,28244166,9.301035831612092e-05
WA18,3p,5,T>C,5032,5289,10321,14112928,14131239,28244167,0.0003654205840094
WA18,3p,6,T>C,5645,4475,10120,14112928,14131239,28244167,0.000358304070359
WA18,3p,7,T>C,4981,4670,9651,14112928,14131237,28244165,0.0003416988960374
WA18,3p,8,T>C,5669,4445,10114,14112927,14131187,28244114,0.0003580923090736
WA18,3p,9,T>C,7510,5211,12721,14112909,14131177,28244086,0.000450395172993
WA18,3p,10,T>C,7481,4937,12418,14112909,14131197,28244106,0.0004396669521067
WA18,3p,11,T>C,6784,4791,11575,14112900,14131167,28244067,0.0004098205828501
WA18,3p,12,T>C,7108,6674,13782,14112895,14131136,28244031,0.0004879615094601
WA18,3p,13,T>C,7650,5691,13341,14112898,14131061,28243959,0.0004723487950113
WA18,3p,14,T>C,7164,5101,12265,14112830,14131006,28243836,0.000434254043962
WA18,3p,15,T>C,6897,5651,12548,14112809,14130957,28243766,0.0004442750304615
WA18,3p,16,T>C,7736,5133,12869,14112765,14130927,28243692,0.0004556415641411
WA18,3p,17,T>C,6543,4933,11476,14112743,14130850,28243593,0.0004063222409415
WA18,3p,18,T>C,7006,5539,12545,14112708,14130769,28243477,0.0004441733572675
WA18,3p,19,T>C,6776,5228,12004,14112724,14130771,28243495,0.0004250182210098
WA18,3p,20,T>C,7660,5018,12678,14112697,14130797,28243494,0.0004488821390158
WA18,3p,21,T>C,7223,5648,12871,14112659,14130783,28243442,0.0004557164102024
WA18,3p,22,T>C,8704,6784,15488,14112575,14130715,28243290,0.0005483780395272
WA18,3p,23,T>C,7664,4811,12475,14112548,14130648,28243196,0.0004416993034357
WA18,3p,24,T>C,9777,6247,16024,14112551,14130690,28243241,0.0005673569828618
WA18,3p,25,T>C,8067,6115,14182,14112486,14130651,28243137,0.0005021396879532
WA18,5p,1,T>C,197,325,522,14112926,14131239,28244165,1.8481693475448823e-05
WA18,5p,2,T>C,270,254,524,14112820,14131183,28244003,1.855261097373485e-05
WA18,5p,3,T>C,2086,870,2956,14112928,14131239,28244167,0.0001046587778637
WA18,5p,4,T>C,1776,1033,2809,14112928,14131239,28244167,9.945416340301344e-05
WA18,5p,5,T>C,4518,2767,7285,14112925,14131239,28244164,0.0002579293902981
WA18,5p,6,T>C,5056,3141,8197,14112927,14131239,28244166,0.000290219226158
WA18,5p,7,T>C,6165,3162,9327,14112921,14131239,28244160,0.0003302275585466
WA18,5p,8,T>C,7227,4268,11495,14112828,14131230,28244058,0.000406988259265
WA18,5p,9,T>C,8125,4093,12218,14112833,14131230,28244063,0.0004325864872911
WA18,5p,10,T>C,7084,3662,10746,14112791,14131213,28244004,0.0003804701344752
WA18,5p,11,T>C,7614,4684,12298,14112776,14131211,28243987,0.0004354201126066
WA18,5p,12,T>C,8143,5075,13218,14112682,14131223,28243905,0.000467994776218
WA18,5p,13,T>C,7096,6655,13751,14112608,14131206,28243814,0.0004868676730416
WA18,5p,14,T>C,7259,5855,13114,14112535,14131179,28243714,0.0004643157057885
WA18,5p,15,T>C,8967,5718,14685,14112545,14131148,28243693,0.000519939088702
WA18,5p,16,T>C,7225,6517,13742,14112522,14131083,28243605,0.0004865526196107
WA18,5p,17,T>C,5736,5241,10977,14112485,14130990,28243475,0.0003886561409316
WA18,5p,18,T>C,7643,5345,12988,14112481,14130987,28243468,0.000459858541451
WA18,5p,19,T>C,6403,5560,11963,14112359,14130867,28243226,0.0004235705935292
WA18,5p,20,T>C,6595,5570,12165,14112397,14130866,28243263,0.0004307221867388
WA18,5p,21,T>C,7514,5838,13352,14112347,14130679,28243026,0.0004727538755939
WA18,5p,22,T>C,7202,6616,13818,14112376,14129592,28241968,0.0004892718524431
WA18,5p,23,T>C,6909,7906,14815,14112288,14129275,28241563,0.0005245814475636
WA18,5p,24,T>C,7779,6095,13874,14112253,14129481,28241734,0.0004912587874384
WA18,5p,25,T>C,6684,5419,12103,14112273,14130551,28242824,0.0004285336338887
WA22,3p,1,T>C,6,2,8,1513709,1653397,3167106,2.525965345018449e-06
WA22,3p,2,T>C,3,4,7,1513709,1653396,3167105,2.210220374758652e-06
WA22,3p,3,T>C,47,8,55,1513709,1653396,3167105,1.736601723024655e-05
WA22,3p,4,T>C,31,54,85,1513709,1653394,3167103,2.6838407213153472e-05
WA22,3p,5,T>C,325,292,617,1513709,1653397,3167106,0.0001948150772345
WA22,3p,6,T>C,284,151,435,1513709,1653397,3167106,0.0001373493656353
WA22,3p,7,T>C,281,224,505,1513709,1653397,3167106,0.0001594515624042
WA22,3p,8,T>C,420,212,632,1513709,1653395,3167104,0.0001995513882714
WA22,3p,9,T>C,272,311,583,1513709,1653397,3167106,0.0001840797245182
WA22,3p,10,T>C,397,334,731,1513706,1653396,3167102,0.0002308103749105
WA22,3p,11,T>C,332,280,612,1513685,1653390,3167075,0.0001932382403321
WA22,3p,12,T>C,391,247,638,1513662,1653379,3167041,0.0002014498707152
WA22,3p,13,T>C,476,283,759,1513689,1653380,3167069,0.0002396537618852
WA22,3p,14,T>C,453,313,766,1513686,1653352,3167038,0.0002418663748272
WA22,3p,15,T>C,453,330,783,1513677,1653343,3167020,0.0002472355716099
WA22,3p,16,T>C,478,283,761,1513637,1653341,3166978,0.0002402921649597
WA22,3p,17,T>C,409,366,775,1513671,1653319,3166990,0.0002447118557368
WA22,3p,18,T>C,499,249,748,1513665,1653288,3166953,0.0002361891698424
WA22,3p,19,T>C,373,404,777,1513662,1653275,3166937,0.0002453474761259
WA22,3p,20,T>C,583,350,933,1513684,1653304,3166988,0.000294601684629
WA22,3p,21,T>C,288,245,533,1513677,1653327,3167004,0.0001682978613225
WA22,3p,22,T>C,446,283,729,1513684,1653356,3167040,0.0002301833889057
WA22,3p,23,T>C,422,284,706,1513676,1653329,3167005,0.0002229235507995
WA22,3p,24,T>C,437,275,712,1513672,1653285,3166957,0.000224821492682
WA22,3p,25,T>C,334,300,634,1513669,1653296,3166965,0.0002001916661535
WA22,5p,1,T>C,9,25,34,1513709,1653397,3167106,1.0735352716328409e-05
WA22,5p,2,T>C,32,26,58,1513674,1653378,3167052,1.83135610024717e-05
WA22,5p,3,T>C,110,70,180,1513709,1653397,3167106,5.6834220262915103e-05
WA22,5p,4,T>C,80,29,109,1513709,1653397,3167106,3.441627782587637e-05
WA22,5p,5,T>C,251,198,449,1513708,1653396,3167104,0.0001417698945156
WA22,5p,6,T>C,381,170,551,1513704,1653397,3167101,0.0001739761377992
WA22,5p,7,T>C,560,275,835,1513707,1653397,3167104,0.0002636477993776
WA22,5p,8,T>C,579,252,831,1513692,1653397,3167089,0.0002623860586172
WA22,5p,9,T>C,673,281,954,1513700,1653389,3167089,0.0003012229842609
WA22,5p,10,T>C,529,226,755,1513705,1653389,3167094,0.0002383888826792
WA22,5p,11,T>C,567,265,832,1513699,1653381,3167080,0.0002627025525089
WA22,5p,12,T>C,469,246,715,1513692,1653345,3167037,0.0002257630712871
WA22,5p,13,T>C,482,187,669,1513697,1653377,3167074,0.0002112359862762
WA22,5p,14,T>C,464,156,620,1513677,1653376,3167053,0.0001957655902821
WA22,5p,15,T>C,587,279,866,1513695,1653381,3167076,0.0002734383387073
WA22,5p,16,T>C,534,190,724,1513668,1653368,3167036,0.000228604916395
WA22,5p,17,T>C,395,230,625,1513675,1653395,3167070,0.0001973432857499
WA22,5p,18,T>C,593,219,812,1513651,1653392,3167043,0.0002563905826349
WA22,5p,19,T>C,620,362,982,1513674,1653350,3167024,0.0003100702741753
WA22,5p,20,T>C,625,164,789,1513678,1653356,3167034,0.0002491289957733
WA22,5p,21,T>C,676,261,937,1513690,1653371,3167061,0.0002958578947484
WA22,5p,22,T>C,405,283,688,1513691,1653380,3167071,0.0002172354203615
WA22,5p,23,T>C,386,223,609,1513634,1653393,3167027,0.000192293908451
WA22,5p,24,T>C,492,358,850,1513632,1653375,3167007,0.0002683922075322
WA22,5p,25,T>C,470,336,806,1513644,1653364,3167008,0.0002544988834887
WA25,3p,1,T>C,23,1,24,3375244,3569089,6944333,3.4560554627780665e-06
WA25,3p,2,T>C,28,57,85,3375244,3569089,6944333,1.224019643067232e-05
WA25,3p,3,T>C,90,84,174,3375244,3569089,6944333,2.5056402105140985e-05
WA25,3p,4,T>C,154,143,297,3375244,3569087,6944331,4.2768698669461466e-05
WA25,3p,5,T>C,597,719,1316,3375244,3569089,6944333,0.0001895070412089
WA25,3p,6,T>C,696,652,1348,3375244,3569089,6944333,0.0001941151151593
WA25,3p,7,T>C,755,965,1720,3375244,3569089,6944333,0.0002476839748324
WA25,3p,8,T>C,887,775,1662,3375239,3569076,6944315,0.000239332461157
WA25,3p,9,T>C,835,821,1656,3375240,3569076,6944316,0.0002384684107117
WA25,3p,10,T>C,1067,897,1964,3375240,3569075,6944315,0.0002828212717885
WA25,3p,11,T>C,1113,889,2002,3375233,3569054,6944287,0.0002882945362137
WA25,3p,12,T>C,1183,701,1884,3375226,3569069,6944295,0.0002713018384155
WA25,3p,13,T>C,940,787,1727,3375230,3569053,6944283,0.000248693781633
WA25,3p,14,T>C,1071,827,1898,3375223,3569037,6944260,0.0002733192593595
WA25,3p,15,T>C,1084,1095,2179,3375218,3569039,6944257,0.0003137844696704
WA25,3p,16,T>C,975,860,1835,3375196,3569030,6944226,0.0002642483121949
WA25,3p,17,T>C,853,894,1747,3375198,3569022,6944220,0.0002515761309405
WA25,3p,18,T>C,1269,1112,2381,3375213,3569006,6944219,0.0003428751310982
WA25,3p,19,T>C,1173,901,2074,3375204,3569005,6944209,0.0002986661259763
WA25,3p,20,T>C,1205,924,2129,3375190,3568979,6944169,0.0003065881605127
WA25,3p,21,T>C,1304,1129,2433,3375199,3568998,6944197,0.0003503644841873
WA25,3p,22,T>C,1025,988,2013,3375179,3568994,6944173,0.0002898833309596
WA25,3p,23,T>C,962,940,1902,3375175,3568972,6944147,0.0002738997316733
WA25,3p,24,T>C,995,884,1879,3375177,3568962,6944139,0.0002705879015382
WA25,3p,25,T>C,1043,1117,2160,3375156,3568970,6944126,0.0003110542637043
WA25,5p,1,T>C,16,26,42,3375244,3569089,6944333,6.0480970598616165e-06
WA25,5p,2,T>C,18,77,95,3375147,3569045,6944192,1.3680497313438336e-05
WA25,5p,3,T>C,317,287,604,3375243,3569089,6944332,8.697740833819581e-05
WA25,5p,4,T>C,194,214,408,3375243,3569089,6944332,5.87529513277879e-05
WA25,5p,5,T>C,566,455,1021,3375244,3569088,6944332,0.0001470263806511
WA25,5p,6,T>C,687,597,1284,3375244,3569089,6944333,0.0001848989672586
WA25,5p,7,T>C,739,560,1299,3375242,3569089,6944331,0.0001870590557967
WA25,5p,8,T>C,1062,636,1698,3375221,3569088,6944309,0.000244516769055
WA25,5p,9,T>C,1015,635,1650,3375227,3569087,6944314,0.0002376044631622
WA25,5p,10,T>C,782,989,1771,3375217,3569085,6944302,0.0002550292311595
WA25,5p,11,T>C,1002,718,1720,3375193,3569088,6944281,0.0002476858295336
WA25,5p,12,T>C,1051,729,1780,3375142,3569084,6944226,0.0002563280630555
WA25,5p,13,T>C,915,647,1562,3375133,3569081,6944214,0.0002249354642584
WA25,5p,14,T>C,1083,618,1701,3375151,3569071,6944222,0.0002449518462975
WA25,5p,15,T>C,876,833,1709,3375137,3569055,6944192,0.000246104946407
WA25,5p,16,T>C,955,920,1875,3375081,3569035,6944116,0.0002700127705239
WA25,5p,17,T>C,949,820,1769,3375076,3568871,6943947,0.0002547542485563
WA25,5p,18,T>C,1139,929,2068,3375102,3568996,6944098,0.0002978068569884
WA25,5p,19,T>C,1089,1166,2255,3375134,3569021,6944155,0.0003247335348937
WA25,5p,20,T>C,886,1045,1931,3375145,3569019,6944164,0.00027807522979
WA25,5p,21,T>C,1045,879,1924,3375130,3569013,6944143,0.0002770680269689
WA25,5p,22,T>C,1096,754,1850,3375139,3569001,6944140,0.000266411679488
WA25,5p,23,T>C,964,963,1927,3375144,3569002,6944146,0.0002774999258368
WA25,5p,24,T>C,1072,1068,2140,3375124,3568967,6944091,0.0003081756849096
WA25,5p,25,T>C,1164,805,1969,3375125,3568950,6944075,0.0002835510849177
WA26,3p,1,T>C,31,6,37,2709623,2900126,5609749,6.595660518857439e-06
WA26,3p,2,T>C,25,61,86,2709623,2900126,5609749,1.5330454178965938e-05
WA26,3p,3,T>C,72,49,121,2709623,2900126,5609749,2.1569592507614867e-05
WA26,3p,4,T>C,221,119,340,2709623,2900126,5609749,6.0608772335446736e-05
WA26,3p,5,T>C,640,510,1150,2709623,2900126,5609749,0.0002050002593698
WA26,3p,6,T>C,706,632,1338,2709623,2900126,5609749,0.0002385133452494
WA26,3p,7,T>C,649,981,1630,2709623,2900126,5609749,0.0002905655850199
WA26,3p,8,T>C,717,663,1380,2709619,2900114,5609733,0.0002460010128824
WA26,3p,9,T>C,830,725,1555,2709613,2900111,5609724,0.0002771972382241
WA26,3p,10,T>C,759,631,1390,2709609,2900074,5609683,0.0002477858374528
WA26,3p,11,T>C,971,1011,1982,2709594,2900076,5609670,0.0003533184661486
WA26,3p,12,T>C,724,797,1521,2709607,2900081,5609688,0.0002711380739891
WA26,3p,13,T>C,928,1050,1978,2709604,2900084,5609688,0.0003526042803093
WA26,3p,14,T>C,948,781,1729,2709584,2900069,5609653,0.000308218708002
WA26,3p,15,T>C,1108,731,1839,2709593,2900082,5609675,0.000327826478361
WA26,3p,16,T>C,900,888,1788,2709580,2900075,5609655,0.0003187361789628
WA26,3p,17,T>C,1403,758,2161,2709570,2900078,5609648,0.0003852291623289
WA26,3p,18,T>C,1162,782,1944,2709582,2900059,5609641,0.0003465462406596
WA26,3p,19,T>C,1056,978,2034,2709567,2900016,5609583,0.000362593797079
WA26,3p,20,T>C,851,1089,1940,2709563,2899983,5609546,0.0003458390393803
WA26,3p,21,T>C,935,1145,2080,2709562,2900021,5609583,0.0003707940501103
WA26,3p,22,T>C,887,1621,2508,2709522,2900007,5609529,0.0004470963604965
WA26,3p,23,T>C,1124,1268,2392,2709541,2899974,5609515,0.000426418326718
WA26,3p,24,T>C,994,916,1910,2709558,2899951,5609509,0.0003404932588574
WA26,3p,25,T>C,1233,975,2208,2709500,2900002,5609502,0.0003936178291762
WA26,5p,1,T>C,21,51,72,2709622,2900126,5609748,1.2834801135452072e-05
WA26,5p,2,T>C,18,83,101,2709554,2900092,5609646,1.8004701187918098e-05
WA26,5p,3,T>C,198,103,301,2709623,2900126,5609749,5.365658962638079e-05
WA26,5p,4,T>C,169,156,325,2709623,2900126,5609749,5.793485590888291e-05
WA26,5p,5,T>C,543,403,946,2709623,2900125,5609748,0.0001686350260296
WA26,5p,6,T>C,679,412,1091,2709621,2900126,5609747,0.0001944829240962
WA26,5p,7,T>C,746,508,1254,2709622,2900126,5609748,0.0002235394531091
WA26,5p,8,T>C,927,667,1594,2709609,2900124,5609733,0.0002841489960395
WA26,5p,9,T>C,898,600,1498,2709594,2900123,5609717,0.0002670366437379
WA26,5p,10,T>C,955,748,1703,2709601,2900123,5609724,0.0003035799978751
WA26,5p,11,T>C,867,761,1628,2709605,2900103,5609708,0.0002902111838976
WA26,5p,12,T>C,889,698,1587,2709595,2900107,5609702,0.0002829027281663
WA26,5p,13,T>C,832,659,1491,2709592,2900104,5609696,0.0002657898039394
WA26,5p,14,T>C,925,910,1835,2709563,2900089,5609652,0.0003271147657644
WA26,5p,15,T>C,1001,923,1924,2709545,2900085,5609630,0.0003429816226738
WA26,5p,16,T>C,846,861,1707,2709540,2900076,5609616,0.0003042989038821
WA26,5p,17,T>C,810,985,1795,2709554,2900055,5609609,0.000319986651476
WA26,5p,18,T>C,1044,1038,2082,2709554,2900082,5609636,0.0003711470762095
WA26,5p,19,T>C,962,796,1758,2709570,2900086,5609656,0.0003133882006311
WA26,5p,20,T>C,844,845,1689,2709563,2900082,5609645,0.0003010885715584
WA26,5p,21,T>C,941,831,1772,2709545,2900061,5609606,0.0003158867128992
WA26,5p,22,T>C,883,825,1708,2709542,2900059,5609601,0.0003044779833717
WA26,5p,23,T>C,800,886,1686,2709528,2900065,5609593,0.0003005565644423
WA26,5p,24,T>C,861,828,1689,2709495,2900057,5609552,0.0003010935632649
WA26,5p,25,T>C,806,941,1747,2709506,2900041,5609547,0.0003114333474699
