Sample,End,Position,Substitution,Pos_Count,Neg_Count,Combined_Count,Pos_Total,Neg_Total,Combined_Total,Frequency
DAL192,3p,1,T>-,0,0,0,6350003,6167708,12517711,0.0
DAL192,3p,2,T>-,0,0,0,6350003,6167706,12517709,0.0
DAL192,3p,3,T>-,0,0,0,6350003,6167708,12517711,0.0
DAL192,3p,4,T>-,0,0,0,6350003,6167708,12517711,0.0
DAL192,3p,5,T>-,0,0,0,6350003,6167708,12517711,0.0
DAL192,3p,6,T>-,0,0,0,6350003,6167708,12517711,0.0
DAL192,3p,7,T>-,0,0,0,6350003,6167708,12517711,0.0
DAL192,3p,8,T>-,0,0,0,6350003,6167618,12517621,0.0
DAL192,3p,9,T>-,0,13,13,6350003,6167637,12517640,1.0385344202261769e-06
DAL192,3p,10,T>-,2,12,14,6350003,6167645,12517648,1.1184209685397768e-06
DAL192,3p,11,T>-,10,6,16,6349987,6167644,12517631,1.2781971285141734e-06
DAL192,3p,12,T>-,10,14,24,6349997,6167646,12517643,1.9172938547616357e-06
DAL192,3p,13,T>-,5,14,19,6349992,6167621,12517613,1.517861272752241e-06
DAL192,3p,14,T>-,4,80,84,6349967,6167610,12517577,6.710563873503634e-06
DAL192,3p,15,T>-,6,17,23,6349968,6167615,12517583,1.8374154179764576e-06
DAL192,3p,16,T>-,7,22,29,6349943,6167587,12517530,2.3167509884138485e-06
DAL192,3p,17,T>-,5,39,44,6349922,6167606,12517528,3.5150710268033758e-06
DAL192,3p,18,T>-,9,36,45,6349922,6167564,12517486,3.5949710668739717e-06
DAL192,3p,19,T>-,13,32,45,6349921,6167519,12517440,3.594984277935425e-06
DAL192,3p,20,T>-,13,36,49,6349910,6167516,12517426,3.914542814153645e-06
DAL192,3p,21,T>-,15,44,59,6349882,6167507,12517389,4.713443035124977e-06
DAL192,3p,22,T>-,10,54,64,6349894,6167488,12517382,5.112890219376543e-06
DAL192,3p,23,T>-,7,50,57,6349902,6167465,12517367,4.5536733084521685e-06
DAL192,3p,24,T>-,30,69,99,6349899,6167465,12517364,7.909013431262365e-06
DAL192,3p,25,T>-,42,91,133,6349856,6167384,12517240,1.0625345523454052e-05
DAL192,5p,1,T>-,0,0,0,6350003,6167708,12517711,0.0
DAL192,5p,2,T>-,0,0,0,6349992,6167694,12517686,0.0
DAL192,5p,3,T>-,0,0,0,6350003,6167707,12517710,0.0
DAL192,5p,4,T>-,2,0,2,6350003,6167708,12517711,1.597736199533605e-07
DAL192,5p,5,T>-,0,0,0,6350003,6167707,12517710,0.0
DAL192,5p,6,T>-,0,0,0,6350002,6167707,12517709,0.0
DAL192,5p,7,T>-,0,0,0,6350002,6167708,12517710,0.0
DAL192,5p,8,T>-,0,0,0,6349926,6167708,12517634,0.0
DAL192,5p,9,T>-,7,0,7,6349914,6167708,12517622,5.592116457902308e-07
DAL192,5p,10,T>-,8,2,10,6349896,6167708,12517604,7.988749284607501e-07
DAL192,5p,11,T>-,9,3,12,6349942,6167706,12517648,9.586465444626658e-07
DAL192,5p,12,T>-,8,3,11,6349906,6167700,12517606,8.787622809025943e-07
DAL192,5p,13,T>-,9,4,13,6349906,6167705,12517611,1.0385368262362524e-06
DAL192,5p,14,T>-,16,1,17,6349889,6167679,12517568,1.3580912841855543e-06
DAL192,5p,15,T>-,8,2,10,6349890,6167649,12517539,7.988790767897747e-07
DAL192,5p,16,T>-,14,8,22,6349904,6167639,12517543,1.757533407314838e-06
DAL192,5p,17,T>-,8,16,24,6349778,6167623,12517401,1.917330921970144e-06
DAL192,5p,18,T>-,16,9,25,6349859,6167631,12517490,1.997205510050337e-06
DAL192,5p,19,T>-,14,21,35,6349822,6167638,12517460,2.79609441532068e-06
DAL192,5p,20,T>-,16,14,30,6349836,6167621,12517457,2.396652930383544e-06
DAL192,5p,21,T>-,17,26,43,6349784,6167624,12517408,3.435215980816476e-06
DAL192,5p,22,T>-,45,13,58,6349783,6167584,12517367,4.63356231386361e-06
DAL192,5p,23,T>-,52,37,89,6349801,6167567,12517368,7.11012091359781e-06
DAL192,5p,24,T>-,47,49,96,6349759,6167564,12517323,7.66937147823061e-06
DAL192,5p,25,T>-,55,70,125,6349777,6167551,12517328,9.986156790011417e-06
DAL193,3p,1,T>-,0,0,0,6484405,6362696,12847101,0.0
DAL193,3p,2,T>-,0,0,0,6484402,6362696,12847098,0.0
DAL193,3p,3,T>-,0,0,0,6484405,6362696,12847101,0.0
DAL193,3p,4,T>-,0,0,0,6484405,6362696,12847101,0.0
DAL193,3p,5,T>-,0,0,0,6484405,6362696,12847101,0.0
DAL193,3p,6,T>-,0,0,0,6484405,6362696,12847101,0.0
DAL193,3p,7,T>-,0,1,1,6484405,6362696,12847101,7.78385722973611e-08
DAL193,3p,8,T>-,0,13,13,6484400,6362644,12847044,1.011905929488527e-06
DAL193,3p,9,T>-,1,16,17,6484400,6362631,12847031,1.3232629391179955e-06
DAL193,3p,10,T>-,0,17,17,6484393,6362640,12847033,1.3232627331151091e-06
DAL193,3p,11,T>-,3,29,32,6484398,6362639,12847037,2.4908467220885253e-06
DAL193,3p,12,T>-,5,26,31,6484368,6362594,12846962,2.4130218490566097e-06
DAL193,3p,13,T>-,3,21,24,6484385,6362543,12846928,1.868150891792964e-06
DAL193,3p,14,T>-,19,14,33,6484363,6362486,12846849,2.568723272142453e-06
DAL193,3p,15,T>-,13,37,50,6484332,6362438,12846770,3.892028891308866e-06
DAL193,3p,16,T>-,19,44,63,6484341,6362460,12846801,4.903944569546925e-06
DAL193,3p,17,T>-,18,61,79,6484294,6362445,12846739,6.149420487175773e-06
DAL193,3p,18,T>-,20,53,73,6484244,6362380,12846624,5.682426760524788e-06
DAL193,3p,19,T>-,33,64,97,6484265,6362400,12846665,7.550597762142937e-06
DAL193,3p,20,T>-,34,56,90,6484261,6362382,12846643,7.005721261188624e-06
DAL193,3p,21,T>-,36,59,95,6484248,6362443,12846691,7.394900367728935e-06
DAL193,3p,22,T>-,61,47,108,6484224,6362407,12846631,8.406873366254546e-06
DAL193,3p,23,T>-,29,59,88,6484218,6362399,12846617,6.850052430145617e-06
DAL193,3p,24,T>-,61,95,156,6484164,6362319,12846483,1.2143401427456838e-05
DAL193,3p,25,T>-,102,100,202,6484128,6362355,12846483,1.572414800221975e-05
DAL193,5p,1,T>-,0,0,0,6484405,6362696,12847101,0.0
DAL193,5p,2,T>-,0,0,0,6484386,6362681,12847067,0.0
DAL193,5p,3,T>-,0,0,0,6484400,6362696,12847096,0.0
DAL193,5p,4,T>-,0,0,0,6484403,6362696,12847099,0.0
DAL193,5p,5,T>-,0,0,0,6484403,6362696,12847099,0.0
DAL193,5p,6,T>-,1,0,1,6484404,6362696,12847100,7.78385783562049e-08
DAL193,5p,7,T>-,0,0,0,6484404,6362696,12847100,0.0
DAL193,5p,8,T>-,1,0,1,6484314,6362693,12847007,7.7839141832802e-08
DAL193,5p,9,T>-,4,0,4,6484295,6362695,12846990,3.113569793391293e-07
DAL193,5p,10,T>-,9,4,13,6484284,6362694,12846978,1.0119111280489466e-06
DAL193,5p,11,T>-,18,12,30,6484315,6362677,12846992,2.335176981506644e-06
DAL193,5p,12,T>-,21,1,22,6484218,6362670,12846888,1.7124769827525543e-06
DAL193,5p,13,T>-,22,5,27,6484143,6362652,12846795,2.101691511384746e-06
DAL193,5p,14,T>-,33,4,37,6484145,6362627,12846772,2.8801009311911197e-06
DAL193,5p,15,T>-,110,18,128,6484166,6362534,12846700,9.9636482520803e-06
DAL193,5p,16,T>-,30,23,53,6484111,6362519,12846630,4.12559558421158e-06
DAL193,5p,17,T>-,29,21,50,6484043,6362598,12846641,3.892067973254643e-06
DAL193,5p,18,T>-,47,35,82,6483967,6362571,12846538,6.383042653203532e-06
DAL193,5p,19,T>-,38,53,91,6483980,6362593,12846573,7.0836012063295015e-06
DAL193,5p,20,T>-,27,44,71,6483952,6362554,12846506,5.526794600804297e-06
DAL193,5p,21,T>-,37,43,80,6484003,6362532,12846535,6.227360140302424e-06
DAL193,5p,22,T>-,29,38,67,6484010,6362499,12846509,5.21542467295979e-06
DAL193,5p,23,T>-,44,97,141,6483966,6362463,12846429,1.0975812811482477e-05
DAL193,5p,24,T>-,72,115,187,6483905,6362426,12846331,1.455668548475047e-05
DAL193,5p,25,T>-,209,70,279,6483942,6362403,12846345,2.171823970164276e-05
DAL195,3p,1,T>-,0,0,0,2363278,2267461,4630739,0.0
DAL195,3p,2,T>-,0,0,0,2363278,2267460,4630738,0.0
DAL195,3p,3,T>-,0,0,0,2363278,2267461,4630739,0.0
DAL195,3p,4,T>-,0,0,0,2363278,2267461,4630739,0.0
DAL195,3p,5,T>-,0,0,0,2363278,2267461,4630739,0.0
DAL195,3p,6,T>-,0,1,1,2363278,2267461,4630739,2.159482536156756e-07
DAL195,3p,7,T>-,0,0,0,2363278,2267461,4630739,0.0
DAL195,3p,8,T>-,0,0,0,2363278,2267413,4630691,0.0
DAL195,3p,9,T>-,0,8,8,2363276,2267438,4630714,1.7275953557054052e-06
DAL195,3p,10,T>-,0,18,18,2363274,2267432,4630706,3.887096265666617e-06
DAL195,3p,11,T>-,1,7,8,2363274,2267431,4630705,1.7275987133708582e-06
DAL195,3p,12,T>-,0,7,7,2363273,2267414,4630687,1.511654750148304e-06
DAL195,3p,13,T>-,2,15,17,2363269,2267412,4630681,3.671166292819566e-06
DAL195,3p,14,T>-,6,13,19,2363250,2267410,4630660,4.103086816998009e-06
DAL195,3p,15,T>-,5,32,37,2363254,2267411,4630665,7.990213068749305e-06
DAL195,3p,16,T>-,7,14,21,2363259,2267394,4630653,4.53499754786204e-06
DAL195,3p,17,T>-,1,13,14,2363234,2267398,4630632,3.023345409438712e-06
DAL195,3p,18,T>-,14,22,36,2363236,2267374,4630610,7.774353702859882e-06
DAL195,3p,19,T>-,16,18,34,2363215,2267369,4630584,7.34248639048552e-06
DAL195,3p,20,T>-,11,23,34,2363222,2267380,4630602,7.342457848893081e-06
DAL195,3p,21,T>-,6,19,25,2363235,2267382,4630617,5.398848576766336e-06
DAL195,3p,22,T>-,15,21,36,2363231,2267383,4630614,7.774346987246184e-06
DAL195,3p,23,T>-,7,30,37,2363219,2267370,4630589,7.990344208911653e-06
DAL195,3p,24,T>-,19,28,47,2363198,2267373,4630571,1.0149936152582478e-05
DAL195,3p,25,T>-,28,47,75,2363180,2267377,4630557,1.6196755595493155e-05
DAL195,5p,1,T>-,0,0,0,2363278,2267461,4630739,0.0
DAL195,5p,2,T>-,0,0,0,2363264,2267447,4630711,0.0
DAL195,5p,3,T>-,0,0,0,2363278,2267459,4630737,0.0
DAL195,5p,4,T>-,0,0,0,2363278,2267461,4630739,0.0
DAL195,5p,5,T>-,0,0,0,2363277,2267461,4630738,0.0
DAL195,5p,6,T>-,0,0,0,2363277,2267461,4630738,0.0
DAL195,5p,7,T>-,0,0,0,2363277,2267461,4630738,0.0
DAL195,5p,8,T>-,1,0,1,2363212,2267460,4630672,2.1595137811531458e-07
DAL195,5p,9,T>-,6,0,6,2363181,2267461,4630642,1.2957166630458585e-06
DAL195,5p,10,T>-,3,2,5,2363146,2267458,4630604,1.0797727467086367e-06
DAL195,5p,11,T>-,4,1,5,2362948,2267450,4630398,1.0798207843040709e-06
DAL195,5p,12,T>-,6,0,6,2362864,2267454,4630318,1.2958073289998657e-06
DAL195,5p,13,T>-,5,1,6,2363073,2267445,4630518,1.2957513608628666e-06
DAL195,5p,14,T>-,20,6,26,2363094,2267434,4630528,5.614910437859355e-06
DAL195,5p,15,T>-,8,6,14,2363178,2267432,4630610,3.0233597733343987e-06
DAL195,5p,16,T>-,18,5,23,2363170,2267429,4630599,4.966959998047768e-06
DAL195,5p,17,T>-,9,18,27,2363159,2267431,4630590,5.830790460826807e-06
DAL195,5p,18,T>-,10,13,23,2363182,2267420,4630602,4.966956780133555e-06
DAL195,5p,19,T>-,10,10,20,2363138,2267420,4630558,4.319133892718761e-06
DAL195,5p,20,T>-,13,5,18,2363110,2267401,4630511,3.887259958998046e-06
DAL195,5p,21,T>-,20,14,34,2363086,2267400,4630486,7.342641787492716e-06
DAL195,5p,22,T>-,18,14,32,2363094,2267388,4630482,6.910727652110515e-06
DAL195,5p,23,T>-,17,18,35,2363068,2267398,4630466,7.558634487328057e-06
DAL195,5p,24,T>-,28,15,43,2363067,2267402,4630469,9.286316353699808e-06
DAL195,5p,25,T>-,27,43,70,2363135,2267374,4630509,1.5117128592126698e-05
DAL212,3p,1,T>-,0,0,0,4131322,4008153,8139475,0.0
DAL212,3p,2,T>-,0,0,0,4131322,4008153,8139475,0.0
DAL212,3p,3,T>-,0,0,0,4131322,4008153,8139475,0.0
DAL212,3p,4,T>-,0,0,0,4131322,4008153,8139475,0.0
DAL212,3p,5,T>-,0,0,0,4131322,4008151,8139473,0.0
DAL212,3p,6,T>-,0,0,0,4131322,4008151,8139473,0.0
DAL212,3p,7,T>-,0,0,0,4131322,4008153,8139475,0.0
DAL212,3p,8,T>-,0,0,0,4131319,4008093,8139412,0.0
DAL212,3p,9,T>-,0,10,10,4131316,4008115,8139431,1.2285871088531864e-06
DAL212,3p,10,T>-,0,4,4,4131317,4008102,8139419,4.91435568066959e-07
DAL212,3p,11,T>-,6,7,13,4131313,4008105,8139418,1.5971657924436366e-06
DAL212,3p,12,T>-,5,13,18,4131314,4008034,8139348,2.2114793469943783e-06
DAL212,3p,13,T>-,11,9,20,4131307,4007923,8139230,2.4572348981414703e-06
DAL212,3p,14,T>-,10,14,24,4131271,4007904,8139175,2.948701803315446e-06
DAL212,3p,15,T>-,12,24,36,4131254,4007935,8139189,4.423045096999222e-06
DAL212,3p,16,T>-,18,28,46,4131236,4007982,8139218,5.651648598182282e-06
DAL212,3p,17,T>-,18,38,56,4131249,4007981,8139230,6.880257714796117e-06
DAL212,3p,18,T>-,12,69,81,4131222,4007954,8139176,9.95186736347758e-06
DAL212,3p,19,T>-,20,64,84,4131233,4007956,8139189,1.032043855966485e-05
DAL212,3p,20,T>-,24,60,84,4131221,4007928,8139149,1.0320489279653191e-05
DAL212,3p,21,T>-,31,68,99,4131228,4007917,8139145,1.2163439771622205e-05
DAL212,3p,22,T>-,15,45,60,4131183,4007898,8139081,7.3718396462696465e-06
DAL212,3p,23,T>-,19,101,120,4131172,4007904,8139076,1.4743688349881483e-05
DAL212,3p,24,T>-,55,106,161,4131124,4007904,8139028,1.978123186208476e-05
DAL212,3p,25,T>-,81,126,207,4131071,4007924,8138995,2.543311551364757e-05
DAL212,5p,1,T>-,0,0,0,4131322,4008153,8139475,0.0
DAL212,5p,2,T>-,0,0,0,4131307,4008143,8139450,0.0
DAL212,5p,3,T>-,0,0,0,4131321,4008153,8139474,0.0
DAL212,5p,4,T>-,0,0,0,4131322,4008153,8139475,0.0
DAL212,5p,5,T>-,0,0,0,4131322,4008153,8139475,0.0
DAL212,5p,6,T>-,0,0,0,4131322,4008153,8139475,0.0
DAL212,5p,7,T>-,2,0,2,4131322,4008153,8139475,2.457160934826878e-07
DAL212,5p,8,T>-,0,0,0,4131248,4008153,8139401,0.0
DAL212,5p,9,T>-,7,0,7,4131243,4008153,8139396,8.600146743075284e-07
DAL212,5p,10,T>-,6,0,6,4131179,4008148,8139327,7.371616842522729e-07
DAL212,5p,11,T>-,5,6,11,4131234,4008143,8139377,1.3514547857901165e-06
DAL212,5p,12,T>-,10,2,12,4131187,4008141,8139328,1.4743231873687852e-06
DAL212,5p,13,T>-,10,7,17,4131181,4008142,8139323,2.088625798484714e-06
DAL212,5p,14,T>-,12,10,22,4131134,4008108,8139242,2.702954402879285e-06
DAL212,5p,15,T>-,10,14,24,4131156,4008091,8139247,2.948675719019217e-06
DAL212,5p,16,T>-,13,26,39,4131154,4008081,8139235,4.791605107851045e-06
DAL212,5p,17,T>-,24,17,41,4131159,4008081,8139240,5.03732535224419e-06
DAL212,5p,18,T>-,47,42,89,4131113,4008066,8139179,1.093476381340182e-05
DAL212,5p,19,T>-,38,33,71,4131040,4008052,8139092,8.723331791801837e-06
DAL212,5p,20,T>-,30,45,75,4131020,4008040,8139060,9.214823333407052e-06
DAL212,5p,21,T>-,48,64,112,4130973,4008040,8139013,1.3760882308456812e-05
DAL212,5p,22,T>-,37,78,115,4131015,4007967,8138982,1.4129531187069833e-05
DAL212,5p,23,T>-,60,39,99,4131005,4007962,8138967,1.2163705787233196e-05
DAL212,5p,24,T>-,101,86,187,4131060,4007918,8138978,2.2975857656821288e-05
DAL212,5p,25,T>-,125,106,231,4131016,4007614,8138630,2.838315539593273e-05
DAL218,3p,1,T>-,0,0,0,6952891,6658031,13610922,0.0
DAL218,3p,2,T>-,0,0,0,6952891,6658031,13610922,0.0
DAL218,3p,3,T>-,0,0,0,6952891,6658030,13610921,0.0
DAL218,3p,4,T>-,0,0,0,6952891,6658031,13610922,0.0
DAL218,3p,5,T>-,0,0,0,6952891,6658031,13610922,0.0
DAL218,3p,6,T>-,0,0,0,6952891,6658030,13610921,0.0
DAL218,3p,7,T>-,0,0,0,6952891,6658026,13610917,0.0
DAL218,3p,8,T>-,2,1,3,6952887,6657945,13610832,2.2041268307477455e-07
DAL218,3p,9,T>-,0,13,13,6952882,6657945,13610827,9.55121977525686e-07
DAL218,3p,10,T>-,2,28,30,6952881,6657960,13610841,2.2041253732961835e-06
DAL218,3p,11,T>-,7,12,19,6952866,6657905,13610771,1.3959532490848608e-06
DAL218,3p,12,T>-,12,20,32,6952858,6657882,13610740,2.351084511202183e-06
DAL218,3p,13,T>-,5,28,33,6952870,6657811,13610681,2.424566412216993e-06
DAL218,3p,14,T>-,10,44,54,6952816,6657779,13610595,3.967497379798605e-06
DAL218,3p,15,T>-,17,69,86,6952788,6657738,13610526,6.318638971043441e-06
DAL218,3p,16,T>-,9,71,80,6952760,6657689,13610449,5.87783694718668e-06
DAL218,3p,17,T>-,6,97,103,6952737,6657651,13610388,7.567748987023735e-06
DAL218,3p,18,T>-,14,94,108,6952711,6657672,13610383,7.935118357800805e-06
DAL218,3p,19,T>-,22,93,115,6952716,6657697,13610413,8.449412960503109e-06
DAL218,3p,20,T>-,26,237,263,6952697,6657752,13610449,1.932338896387621e-05
DAL218,3p,21,T>-,23,104,127,6952660,6657692,13610352,9.331132655496343e-06
DAL218,3p,22,T>-,31,148,179,6952654,6657637,13610291,1.3151812845147838e-05
DAL218,3p,23,T>-,33,143,176,6952651,6657632,13610283,1.293139900176947e-05
DAL218,3p,24,T>-,51,111,162,6952669,6657588,13610257,1.190278772840219e-05
DAL218,3p,25,T>-,78,146,224,6952605,6657566,13610171,1.6458279620439742e-05
DAL218,5p,1,T>-,0,0,0,6952891,6658031,13610922,0.0
DAL218,5p,2,T>-,0,0,0,6952874,6658014,13610888,0.0
DAL218,5p,3,T>-,0,0,0,6952891,6658031,13610922,0.0
DAL218,5p,4,T>-,0,0,0,6952891,6658031,13610922,0.0
DAL218,5p,5,T>-,0,0,0,6952891,6658031,13610922,0.0
DAL218,5p,6,T>-,0,0,0,6952891,6658031,13610922,0.0
DAL218,5p,7,T>-,1,0,1,6952888,6658031,13610919,7.347042473766835e-08
DAL218,5p,8,T>-,0,0,0,6952719,6658029,13610748,0.0
DAL218,5p,9,T>-,7,3,10,6952736,6658029,13610765,7.34712560241838e-07
DAL218,5p,10,T>-,11,2,13,6952716,6658028,13610744,9.551278019776142e-07
DAL218,5p,11,T>-,16,4,20,6952715,6658016,13610731,1.4694287911501597e-06
DAL218,5p,12,T>-,90,5,95,6952625,6658005,13610630,6.979838552660678e-06
DAL218,5p,13,T>-,139,3,142,6952475,6658005,13610480,1.0433136818098997e-05
DAL218,5p,14,T>-,174,8,182,6952554,6657955,13610509,1.337202010593432e-05
DAL218,5p,15,T>-,52,22,74,6952449,6657923,13610372,5.437029935699039e-06
DAL218,5p,16,T>-,90,21,111,6952253,6657920,13610173,8.155664149162541e-06
DAL218,5p,17,T>-,150,37,187,6952350,6657874,13610224,1.373967100027156e-05
DAL218,5p,18,T>-,197,39,236,6952457,6657843,13610300,1.733980882126037e-05
DAL218,5p,19,T>-,119,34,153,6952296,6657770,13610066,1.1241679503978892e-05
DAL218,5p,20,T>-,164,38,202,6952289,6657772,13610061,1.4841961398997404e-05
DAL218,5p,21,T>-,182,85,267,6952371,6657729,13610100,1.961778385169837e-05
DAL218,5p,22,T>-,224,56,280,6952322,6657786,13610108,2.0572944755471448e-05
DAL218,5p,23,T>-,179,45,224,6952288,6657745,13610033,1.6458446500460358e-05
DAL218,5p,24,T>-,197,86,283,6952375,6657772,13610147,2.079330957997735e-05
DAL218,5p,25,T>-,188,82,270,6952272,6657720,13609992,1.983836581241194e-05
DAL224,3p,1,T>-,0,0,0,4609472,4586477,9195949,0.0
DAL224,3p,2,T>-,0,0,0,4609471,4586476,9195947,0.0
DAL224,3p,3,T>-,0,0,0,4609472,4586477,9195949,0.0
DAL224,3p,4,T>-,0,0,0,4609472,4586477,9195949,0.0
DAL224,3p,5,T>-,0,0,0,4609472,4586477,9195949,0.0
DAL224,3p,6,T>-,0,0,0,4609472,4586477,9195949,0.0
DAL224,3p,7,T>-,0,0,0,4609472,4586476,9195948,0.0
DAL224,3p,8,T>-,0,0,0,4609469,4586423,9195892,0.0
DAL224,3p,9,T>-,1,10,11,4609466,4586431,9195897,1.1961856467074393e-06
DAL224,3p,10,T>-,2,13,15,4609461,4586371,9195832,1.6311737752494823e-06
DAL224,3p,11,T>-,3,10,13,4609461,4586382,9195843,1.4136822475111852e-06
DAL224,3p,12,T>-,10,18,28,4609458,4586384,9195842,3.0448544026746e-06
DAL224,3p,13,T>-,4,14,18,4609454,4586364,9195818,1.9574115103191477e-06
DAL224,3p,14,T>-,5,12,17,4609412,4586293,9195705,1.8486891434642584e-06
DAL224,3p,15,T>-,5,24,29,4609400,4586272,9195672,3.1536575032254303e-06
DAL224,3p,16,T>-,8,28,36,4609379,4586240,9195619,3.914907740305465e-06
DAL224,3p,17,T>-,28,39,67,4609381,4586216,9195597,7.286095726030621e-06
DAL224,3p,18,T>-,22,48,70,4609363,4586282,9195645,7.612299082881081e-06
DAL224,3p,19,T>-,12,41,53,4609353,4586195,9195548,5.763658674828298e-06
DAL224,3p,20,T>-,17,52,69,4609344,4586225,9195569,7.503613968858262e-06
DAL224,3p,21,T>-,16,42,58,4609343,4586223,9195566,6.307387712730244e-06
DAL224,3p,22,T>-,44,79,123,4609324,4586172,9195496,1.3376113697401424e-05
DAL224,3p,23,T>-,37,83,120,4609323,4586083,9195406,1.3049994747377114e-05
DAL224,3p,24,T>-,46,84,130,4609325,4586202,9195527,1.4137308280428082e-05
DAL224,3p,25,T>-,66,86,152,4609265,4586173,9195438,1.652993582252417e-05
DAL224,5p,1,T>-,0,0,0,4609472,4586477,9195949,0.0
DAL224,5p,2,T>-,0,0,0,4609461,4586469,9195930,0.0
DAL224,5p,3,T>-,0,0,0,4609468,4586477,9195945,0.0
DAL224,5p,4,T>-,0,0,0,4609471,4586477,9195948,0.0
DAL224,5p,5,T>-,0,0,0,4609471,4586477,9195948,0.0
DAL224,5p,6,T>-,0,0,0,4609472,4586477,9195949,0.0
DAL224,5p,7,T>-,0,0,0,4609471,4586477,9195948,0.0
DAL224,5p,8,T>-,0,0,0,4609397,4586477,9195874,0.0
DAL224,5p,9,T>-,14,10,24,4609357,4586473,9195830,2.6098786080212445e-06
DAL224,5p,10,T>-,5,3,8,4609338,4586470,9195808,8.69961617293445e-07
DAL224,5p,11,T>-,8,6,14,4609388,4586469,9195857,1.5224247180007258e-06
DAL224,5p,12,T>-,14,6,20,4609357,4586464,9195821,2.174900968603021e-06
DAL224,5p,13,T>-,27,12,39,4609320,4586461,9195781,4.241075336613605e-06
DAL224,5p,14,T>-,25,13,38,4609270,4586428,9195698,4.132367113404551e-06
DAL224,5p,15,T>-,26,46,72,4609299,4586416,9195715,7.829733740117e-06
DAL224,5p,16,T>-,28,32,60,4609292,4586373,9195665,6.52481359423163e-06
DAL224,5p,17,T>-,29,19,48,4609285,4586385,9195670,5.219848037174018e-06
DAL224,5p,18,T>-,39,16,55,4609226,4586351,9195577,5.981136365885469e-06
DAL224,5p,19,T>-,38,13,51,4609203,4586337,9195540,5.546166946149981e-06
DAL224,5p,20,T>-,59,22,81,4609148,4586313,9195461,8.808693767501161e-06
DAL224,5p,21,T>-,31,35,66,4609195,4586347,9195542,7.177390957487879e-06
DAL224,5p,22,T>-,29,39,68,4609138,4586312,9195450,7.3949616386365e-06
DAL224,5p,23,T>-,47,43,90,4609100,4586313,9195413,9.78748860981013e-06
DAL224,5p,24,T>-,57,63,120,4609109,4586316,9195425,1.3049967782892036e-05
DAL224,5p,25,T>-,79,82,161,4609125,4586257,9195382,1.7508788650650945e-05
DAL227,3p,1,T>-,0,0,0,3765386,3771243,7536629,0.0
DAL227,3p,2,T>-,0,0,0,3765386,3771243,7536629,0.0
DAL227,3p,3,T>-,0,0,0,3765386,3771243,7536629,0.0
DAL227,3p,4,T>-,0,0,0,3765386,3771243,7536629,0.0
DAL227,3p,5,T>-,0,0,0,3765386,3771243,7536629,0.0
DAL227,3p,6,T>-,0,0,0,3765386,3771243,7536629,0.0
DAL227,3p,7,T>-,0,0,0,3765386,3771243,7536629,0.0
DAL227,3p,8,T>-,0,0,0,3765386,3771207,7536593,0.0
DAL227,3p,9,T>-,0,5,5,3765384,3771218,7536602,6.634289564448275e-07
DAL227,3p,10,T>-,4,8,12,3765382,3771209,7536591,1.5922318193995136e-06
DAL227,3p,11,T>-,1,6,7,3765378,3771214,7536592,9.288017714107384e-07
DAL227,3p,12,T>-,2,12,14,3765377,3771173,7536550,1.8576138949519344e-06
DAL227,3p,13,T>-,0,8,8,3765373,3771183,7536556,1.0614928091823374e-06
DAL227,3p,14,T>-,2,10,12,3765341,3771166,7536507,1.5922495660124776e-06
DAL227,3p,15,T>-,10,15,25,3765341,3771186,7536527,3.31717779290116e-06
DAL227,3p,16,T>-,5,9,14,3765340,3771079,7536419,1.857646184480985e-06
DAL227,3p,17,T>-,9,14,23,3765328,3771049,7536377,3.051864310928182e-06
DAL227,3p,18,T>-,5,25,30,3765321,3771036,7536357,3.980703143441851e-06
DAL227,3p,19,T>-,7,33,40,3765313,3771111,7536424,5.307557005816021e-06
DAL227,3p,20,T>-,6,22,28,3765308,3771082,7536390,3.7153066653928473e-06
DAL227,3p,21,T>-,10,27,37,3765307,3771104,7536411,4.9094986990491895e-06
DAL227,3p,22,T>-,6,29,35,3765309,3771137,7536446,4.644098823238434e-06
DAL227,3p,23,T>-,8,43,51,3765319,3771112,7536431,6.767128896954009e-06
DAL227,3p,24,T>-,26,45,71,3765312,3771081,7536393,9.420952437061071e-06
DAL227,3p,25,T>-,36,66,102,3765249,3771100,7536349,1.3534405054755294e-05
DAL227,5p,1,T>-,0,0,0,3765386,3771243,7536629,0.0
DAL227,5p,2,T>-,0,0,0,3765373,3771238,7536611,0.0
DAL227,5p,3,T>-,0,0,0,3765386,3771243,7536629,0.0
DAL227,5p,4,T>-,0,0,0,3765385,3771243,7536628,0.0
DAL227,5p,5,T>-,0,0,0,3765386,3771242,7536628,0.0
DAL227,5p,6,T>-,0,0,0,3765386,3771243,7536629,0.0
DAL227,5p,7,T>-,2,0,2,3765386,3771243,7536629,2.653706318832996e-07
DAL227,5p,8,T>-,0,2,2,3765342,3771242,7536584,2.653722163781363e-07
DAL227,5p,9,T>-,3,5,8,3765324,3771243,7536567,1.0614912598799955e-06
DAL227,5p,10,T>-,9,0,9,3765318,3771238,7536556,1.1941794103301296e-06
DAL227,5p,11,T>-,7,4,11,3765365,3771237,7536602,1.4595437041786205e-06
DAL227,5p,12,T>-,2,4,6,3765326,3771232,7536558,7.961193956179996e-07
DAL227,5p,13,T>-,11,3,14,3765325,3771231,7536556,1.8576124160690903e-06
DAL227,5p,14,T>-,4,3,7,3765297,3771226,7536523,9.288102749769356e-07
DAL227,5p,15,T>-,7,6,13,3765318,3771201,7536519,1.724934283320987e-06
DAL227,5p,16,T>-,9,7,16,3765316,3771188,7536504,2.123000266436533e-06
DAL227,5p,17,T>-,14,2,16,3765326,3771175,7536501,2.1230011115237693e-06
DAL227,5p,18,T>-,5,13,18,3765280,3771169,7536449,2.3883927297856058e-06
DAL227,5p,19,T>-,11,12,23,3765279,3771164,7536443,3.051837584388285e-06
DAL227,5p,20,T>-,9,20,29,3765254,3771167,7536421,3.8479803609697496e-06
DAL227,5p,21,T>-,17,25,42,3765270,3771169,7536439,5.57292376412786e-06
DAL227,5p,22,T>-,17,27,44,3765253,3771158,7536411,5.838322777247685e-06
DAL227,5p,23,T>-,25,13,38,3765254,3771157,7536411,5.0421878530775455e-06
DAL227,5p,24,T>-,27,36,63,3765270,3771180,7536450,8.359373445057022e-06
DAL227,5p,25,T>-,27,53,80,3765247,3771148,7536395,1.0615154858523209e-05
WA02,3p,1,T>-,0,0,0,6552698,6754258,13306956,0.0
WA02,3p,2,T>-,0,0,0,6552698,6754258,13306956,0.0
WA02,3p,3,T>-,0,0,0,6552698,6754258,13306956,0.0
WA02,3p,4,T>-,0,0,0,6552698,6754256,13306954,0.0
WA02,3p,5,T>-,0,0,0,6552698,6754256,13306954,0.0
WA02,3p,6,T>-,0,0,0,6552698,6754257,13306955,0.0
WA02,3p,7,T>-,0,0,0,6552698,6754257,13306955,0.0
WA02,3p,8,T>-,0,0,0,6552692,6754207,13306899,0.0
WA02,3p,9,T>-,8,30,38,6552688,6754191,13306879,2.855665855231719e-06
WA02,3p,10,T>-,14,30,44,6552680,6754207,13306887,3.3065584760733297e-06
WA02,3p,11,T>-,28,27,55,6552667,6754202,13306869,4.133203686006077e-06
WA02,3p,12,T>-,25,47,72,6552670,6754189,13306859,5.410743436899722e-06
WA02,3p,13,T>-,37,60,97,6552675,6754177,13306852,7.28947763152397e-06
WA02,3p,14,T>-,45,52,97,6552653,6754155,13306808,7.289501734751114e-06
WA02,3p,15,T>-,42,64,106,6552632,6754146,13306778,7.965865215456364e-06
WA02,3p,16,T>-,46,69,115,6552629,6754119,13306748,8.642231745878106e-06
WA02,3p,17,T>-,47,94,141,6552608,6754116,13306724,1.059614673002912e-05
WA02,3p,18,T>-,36,82,118,6552611,6754085,13306696,8.867715922870712e-06
WA02,3p,19,T>-,73,78,151,6552605,6754056,13306661,1.1347700223219033e-05
WA02,3p,20,T>-,68,101,169,6552618,6754033,13306651,1.2700415754497509e-05
WA02,3p,21,T>-,65,84,149,6552597,6754089,13306686,1.119737852084283e-05
WA02,3p,22,T>-,76,112,188,6552593,6754062,13306655,1.412826890003536e-05
WA02,3p,23,T>-,72,147,219,6552585,6754052,13306637,1.645795252399235e-05
WA02,3p,24,T>-,156,209,365,6552556,6754026,13306582,2.7430034249215917e-05
WA02,3p,25,T>-,219,295,514,6552517,6754038,13306555,3.8627578663297904e-05
WA02,5p,1,T>-,0,0,0,6552698,6754258,13306956,0.0
WA02,5p,2,T>-,0,0,0,6552562,6754179,13306741,0.0
WA02,5p,3,T>-,0,0,0,6552698,6754258,13306956,0.0
WA02,5p,4,T>-,0,0,0,6552698,6754258,13306956,0.0
WA02,5p,5,T>-,1,0,1,6552698,6754258,13306956,7.514866660714894e-08
WA02,5p,6,T>-,1,0,1,6552697,6754258,13306955,7.514867225447144e-08
WA02,5p,7,T>-,5,0,5,6552685,6754258,13306943,3.757437001120393e-07
WA02,5p,8,T>-,4,1,5,6552655,6754257,13306912,3.7574457545071314e-07
WA02,5p,9,T>-,63,7,70,6552662,6754226,13306888,5.260433543890953e-06
WA02,5p,10,T>-,46,11,57,6552618,6754222,13306840,4.283511337026672e-06
WA02,5p,11,T>-,53,10,63,6552625,6754225,13306850,4.734403709367732e-06
WA02,5p,12,T>-,32,13,45,6552628,6754236,13306864,3.381713377396808e-06
WA02,5p,13,T>-,70,22,92,6552614,6754205,13306819,6.913748507438179e-06
WA02,5p,14,T>-,51,21,72,6552607,6754183,13306790,5.410771493350388e-06
WA02,5p,15,T>-,88,66,154,6552586,6754168,13306754,1.157307033706342e-05
WA02,5p,16,T>-,67,38,105,6552525,6754178,13306703,7.89076001771438e-06
WA02,5p,17,T>-,71,40,111,6552567,6754148,13306715,8.341653067642916e-06
WA02,5p,18,T>-,76,75,151,6552548,6754087,13306635,1.1347722395631954e-05
WA02,5p,19,T>-,76,59,135,6552516,6754124,13306640,1.0145310912446718e-05
WA02,5p,20,T>-,91,77,168,6552507,6754132,13306639,1.262527675095116e-05
WA02,5p,21,T>-,113,87,200,6552521,6754152,13306673,1.5030052966658156e-05
WA02,5p,22,T>-,104,65,169,6552516,6754117,13306633,1.2700432934462084e-05
WA02,5p,23,T>-,153,104,257,6552465,6754131,13306596,1.9313729822412885e-05
WA02,5p,24,T>-,191,210,401,6552457,6754135,13306592,3.0135439637737445e-05
WA02,5p,25,T>-,219,245,464,6552470,6754083,13306553,3.487003734175184e-05
WA03,3p,1,T>-,0,0,0,5399458,5543742,10943200,0.0
WA03,3p,2,T>-,0,0,0,5399458,5543742,10943200,0.0
WA03,3p,3,T>-,0,0,0,5399458,5543742,10943200,0.0
WA03,3p,4,T>-,0,0,0,5399458,5543736,10943194,0.0
WA03,3p,5,T>-,0,0,0,5399458,5543740,10943198,0.0
WA03,3p,6,T>-,0,0,0,5399458,5543741,10943199,0.0
WA03,3p,7,T>-,0,0,0,5399458,5543739,10943197,0.0
WA03,3p,8,T>-,0,0,0,5399449,5543673,10943122,0.0
WA03,3p,9,T>-,7,46,53,5399436,5543670,10943106,4.843231894125854e-06
WA03,3p,10,T>-,7,56,63,5399438,5543654,10943092,5.75705659789756e-06
WA03,3p,11,T>-,15,39,54,5399404,5543644,10943048,4.934639782261761e-06
WA03,3p,12,T>-,15,25,40,5399397,5543595,10942992,3.655307433286984e-06
WA03,3p,13,T>-,15,32,47,5399378,5543551,10942929,4.295010960959356e-06
WA03,3p,14,T>-,33,52,85,5399356,5543493,10942849,7.76762980097779e-06
WA03,3p,15,T>-,35,51,86,5399349,5543505,10942854,7.859010090055118e-06
WA03,3p,16,T>-,46,89,135,5399342,5543495,10942837,1.2336837330209707e-05
WA03,3p,17,T>-,38,95,133,5399346,5543438,10942784,1.215412823647072e-05
WA03,3p,18,T>-,44,99,143,5399325,5543443,10942768,1.3067991572150666e-05
WA03,3p,19,T>-,57,118,175,5399297,5543425,10942722,1.5992364605442777e-05
WA03,3p,20,T>-,49,122,171,5399252,5543409,10942661,1.5626911954962327e-05
WA03,3p,21,T>-,53,123,176,5399248,5543303,10942551,1.6084000887909958e-05
WA03,3p,22,T>-,52,153,205,5399256,5543263,10942519,1.873426036546064e-05
WA03,3p,23,T>-,61,175,236,5399255,5543267,10942522,2.156724016638943e-05
WA03,3p,24,T>-,103,207,310,5399198,5543130,10942328,2.8330351639980085e-05
WA03,3p,25,T>-,124,246,370,5399050,5543142,10942192,3.381406577402407e-05
WA03,5p,1,T>-,0,0,0,5399457,5543742,10943199,0.0
WA03,5p,2,T>-,0,0,0,5399258,5543638,10942896,0.0
WA03,5p,3,T>-,0,0,0,5399457,5543742,10943199,0.0
WA03,5p,4,T>-,0,0,0,5399458,5543742,10943200,0.0
WA03,5p,5,T>-,0,0,0,5399456,5543740,10943196,0.0
WA03,5p,6,T>-,0,0,0,5399452,5543742,10943194,0.0
WA03,5p,7,T>-,5,0,5,5399453,5543742,10943195,4.569049532609078e-07
WA03,5p,8,T>-,3,0,3,5399403,5543732,10943135,2.741444750521674e-07
WA03,5p,9,T>-,42,9,51,5399319,5543732,10943051,4.660491850033414e-06
WA03,5p,10,T>-,28,11,39,5399344,5543717,10943061,3.563902275606432e-06
WA03,5p,11,T>-,28,24,52,5399321,5543705,10943026,4.751884899112914e-06
WA03,5p,12,T>-,30,16,46,5399213,5543665,10942878,4.203647340306636e-06
WA03,5p,13,T>-,43,30,73,5399156,5543662,10942818,6.671042139236895e-06
WA03,5p,14,T>-,47,30,77,5399124,5543629,10942753,7.0366204921193045e-06
WA03,5p,15,T>-,61,39,100,5399092,5543505,10942597,9.1385984515376e-06
WA03,5p,16,T>-,77,53,130,5399083,5543501,10942584,1.188019210087855e-05
WA03,5p,17,T>-,90,57,147,5399113,5543491,10942604,1.3433731130177058e-05
WA03,5p,18,T>-,100,62,162,5399074,5543600,10942674,1.480442531688324e-05
WA03,5p,19,T>-,92,53,145,5399071,5543546,10942617,1.3250943535719106e-05
WA03,5p,20,T>-,69,57,126,5399050,5543533,10942583,1.151464878082259e-05
WA03,5p,21,T>-,93,60,153,5399034,5543509,10942543,1.3982124630444678e-05
WA03,5p,22,T>-,114,81,195,5398989,5543454,10942443,1.7820517776514805e-05
WA03,5p,23,T>-,102,81,183,5398935,5543457,10942392,1.6723948474885565e-05
WA03,5p,24,T>-,163,139,302,5398952,5543428,10942380,2.7599114635024558e-05
WA03,5p,25,T>-,184,228,412,5398991,5543444,10942435,3.765158303430635e-05
WA07,3p,1,T>-,0,0,0,5691729,6013979,11705708,0.0
WA07,3p,2,T>-,0,0,0,5691729,6013979,11705708,0.0
WA07,3p,3,T>-,0,0,0,5691729,6013979,11705708,0.0
WA07,3p,4,T>-,0,0,0,5691729,6013979,11705708,0.0
WA07,3p,5,T>-,0,0,0,5691729,6013979,11705708,0.0
WA07,3p,6,T>-,0,0,0,5691729,6013979,11705708,0.0
WA07,3p,7,T>-,0,0,0,5691729,6013979,11705708,0.0
WA07,3p,8,T>-,0,0,0,5691713,6013800,11705513,0.0
WA07,3p,9,T>-,1,27,28,5691720,6013901,11705621,2.392013204596321e-06
WA07,3p,10,T>-,3,51,54,5691718,6013892,11705610,4.6131726582382296e-06
WA07,3p,11,T>-,3,31,34,5691711,6013883,11705594,2.904594162414996e-06
WA07,3p,12,T>-,9,23,32,5691705,6013884,11705589,2.733736849978245e-06
WA07,3p,13,T>-,7,19,26,5691711,6013848,11705559,2.221166883187723e-06
WA07,3p,14,T>-,10,25,35,5691695,6013877,11705572,2.9900290220759824e-06
WA07,3p,15,T>-,8,64,72,5691211,6013856,11705067,6.15118221877756e-06
WA07,3p,16,T>-,8,47,55,5691636,6013850,11705486,4.698651555347638e-06
WA07,3p,17,T>-,13,62,75,5691662,6013813,11705475,6.407258142023284e-06
WA07,3p,18,T>-,15,39,54,5691639,6013769,11705408,4.613252267669781e-06
WA07,3p,19,T>-,24,61,85,5691628,6013742,11705370,7.261624365568965e-06
WA07,3p,20,T>-,16,81,97,5691604,6013772,11705376,8.28679061655089e-06
WA07,3p,21,T>-,15,93,108,5691611,6013735,11705346,9.22655340559775e-06
WA07,3p,22,T>-,16,76,92,5691577,6013736,11705313,7.859678762968576e-06
WA07,3p,23,T>-,22,145,167,5691568,6013670,11705238,1.4267116994972676e-05
WA07,3p,24,T>-,41,148,189,5691554,6013661,11705215,1.614664916449634e-05
WA07,3p,25,T>-,68,173,241,5691455,6013662,11705117,2.058928586531856e-05
WA07,5p,1,T>-,0,0,0,5691729,6013979,11705708,0.0
WA07,5p,2,T>-,0,0,0,5691636,6013923,11705559,0.0
WA07,5p,3,T>-,0,0,0,5691729,6013979,11705708,0.0
WA07,5p,4,T>-,0,0,0,5691728,6013979,11705707,0.0
WA07,5p,5,T>-,0,0,0,5691729,6013978,11705707,0.0
WA07,5p,6,T>-,2,0,2,5691728,6013979,11705707,1.708568307749374e-07
WA07,5p,7,T>-,0,0,0,5691728,6013979,11705707,0.0
WA07,5p,8,T>-,1,1,2,5691579,6013975,11705554,1.7085906399645842e-07
WA07,5p,9,T>-,24,0,24,5691672,6013971,11705643,2.0502931791102803e-06
WA07,5p,10,T>-,11,1,12,5691582,6013961,11705543,1.0251553473427077e-06
WA07,5p,11,T>-,15,1,16,5691326,6013942,11705268,1.3669059093734549e-06
WA07,5p,12,T>-,34,5,39,5691520,6013938,11705458,3.3317790726343217e-06
WA07,5p,13,T>-,29,3,32,5691511,6013949,11705460,2.733766977120079e-06
WA07,5p,14,T>-,19,7,26,5691556,6013950,11705506,2.2211769401510707e-06
WA07,5p,15,T>-,44,10,54,5691563,6013633,11705196,4.613335821117391e-06
WA07,5p,16,T>-,34,15,49,5691534,6013925,11705459,4.186081041332937e-06
WA07,5p,17,T>-,51,19,70,5691561,6013916,11705477,5.980106577459423e-06
WA07,5p,18,T>-,69,26,95,5691474,6013905,11705379,8.115926874302832e-06
WA07,5p,19,T>-,45,31,76,5691482,6013884,11705366,6.492748710292356e-06
WA07,5p,20,T>-,74,25,99,5691421,6013876,11705297,8.457709360129862e-06
WA07,5p,21,T>-,74,31,105,5691379,6013853,11705232,8.970347618910928e-06
WA07,5p,22,T>-,74,48,122,5691396,6013861,11705257,1.042266735365144e-05
WA07,5p,23,T>-,88,35,123,5691314,6013795,11705109,1.0508231918216226e-05
WA07,5p,24,T>-,86,63,149,5691332,6013785,11705117,1.2729475493495707e-05
WA07,5p,25,T>-,93,104,197,5691334,6013719,11705053,1.6830338145414633e-05
WA08,3p,1,T>-,0,0,0,6798117,7189085,13987202,0.0
WA08,3p,2,T>-,0,0,0,6798117,7189085,13987202,0.0
WA08,3p,3,T>-,0,0,0,6798117,7189085,13987202,0.0
WA08,3p,4,T>-,0,0,0,6798117,7189081,13987198,0.0
WA08,3p,5,T>-,0,0,0,6798117,7189085,13987202,0.0
WA08,3p,6,T>-,0,0,0,6798117,7189085,13987202,0.0
WA08,3p,7,T>-,0,0,0,6798117,7189084,13987201,0.0
WA08,3p,8,T>-,3,1,4,6798110,7189053,13987163,2.859765057431589e-07
WA08,3p,9,T>-,2,17,19,6798103,7189051,13987154,1.3583892763316969e-06
WA08,3p,10,T>-,5,24,29,6798074,7189042,13987116,2.073336633513299e-06
WA08,3p,11,T>-,8,35,43,6798109,7189046,13987155,3.074249195065044e-06
WA08,3p,12,T>-,13,23,36,6798091,7189018,13987109,2.573798488308056e-06
WA08,3p,13,T>-,18,29,47,6798090,7189013,13987103,3.360238356720473e-06
WA08,3p,14,T>-,24,21,45,6798067,7188981,13987048,3.217262141375364e-06
WA08,3p,15,T>-,22,42,64,6798069,7188978,13987047,4.575662039313945e-06
WA08,3p,16,T>-,20,26,46,6798049,7188961,13987010,3.2887657905442262e-06
WA08,3p,17,T>-,23,30,53,6798000,7188943,13986943,3.789248301076225e-06
WA08,3p,18,T>-,37,53,90,6798023,7188956,13986979,6.434556025286089e-06
WA08,3p,19,T>-,31,50,81,6798028,7188946,13986974,5.791102492933782e-06
WA08,3p,20,T>-,48,58,106,6798009,7188917,13986926,7.578505813214426e-06
WA08,3p,21,T>-,50,66,116,6798010,7188926,13986936,8.29345326238713e-06
WA08,3p,22,T>-,60,85,145,6798012,7188920,13986932,1.0366819542698857e-05
WA08,3p,23,T>-,47,113,160,6798009,7188864,13986873,1.143929740407309e-05
WA08,3p,24,T>-,68,146,214,6798015,7188867,13986882,1.5300050432969977e-05
WA08,3p,25,T>-,129,185,314,6797966,7188892,13986858,2.2449645231259228e-05
WA08,5p,1,T>-,0,0,0,6798116,7189085,13987201,0.0
WA08,5p,2,T>-,0,0,0,6797941,7188997,13986938,0.0
WA08,5p,3,T>-,1,0,1,6798117,7189084,13987201,7.149393220273307e-08
WA08,5p,4,T>-,0,0,0,6798115,7189085,13987200,0.0
WA08,5p,5,T>-,0,0,0,6798116,7189084,13987200,0.0
WA08,5p,6,T>-,2,0,2,6798112,7189085,13987197,1.4298790529653653e-07
WA08,5p,7,T>-,2,0,2,6798110,7189085,13987195,1.429879257420805e-07
WA08,5p,8,T>-,4,1,5,6798069,7189064,13987133,3.574713988921103e-07
WA08,5p,9,T>-,26,3,29,6798054,7189067,13987121,2.0733358923541164e-06
WA08,5p,10,T>-,25,3,28,6798015,7189037,13987052,2.001851426590821e-06
WA08,5p,11,T>-,32,3,35,6797997,7189047,13987044,2.502315714456893e-06
WA08,5p,12,T>-,36,13,49,6798016,7189056,13987072,3.5032349872796824e-06
WA08,5p,13,T>-,33,16,49,6797995,7189043,13987038,3.5032435030204395e-06
WA08,5p,14,T>-,45,10,55,6797984,7189041,13987025,3.932215749953976e-06
WA08,5p,15,T>-,21,28,49,6797997,7189013,13987010,3.503250516014502e-06
WA08,5p,16,T>-,60,78,138,6797921,7188997,13986918,9.866362267942088e-06
WA08,5p,17,T>-,61,44,105,6797959,7188875,13986834,7.507059853573725e-06
WA08,5p,18,T>-,69,47,116,6797991,7188972,13986963,8.29343725296192e-06
WA08,5p,19,T>-,52,44,96,6797966,7188988,13986954,6.863538694700791e-06
WA08,5p,20,T>-,82,66,148,6797883,7188971,13986854,1.0581364472668406e-05
WA08,5p,21,T>-,77,67,144,6797885,7188979,13986864,1.0295374288332252e-05
WA08,5p,22,T>-,54,51,105,6797887,7188939,13986826,7.507064147362668e-06
WA08,5p,23,T>-,92,76,168,6797851,7188919,13986770,1.2011350726436482e-05
WA08,5p,24,T>-,131,118,249,6797841,7188876,13986717,1.780260514315118e-05
WA08,5p,25,T>-,123,179,302,6797835,7188817,13986652,2.1592015015459022e-05
WA09,3p,1,T>-,0,0,0,4741672,4881751,9623423,0.0
WA09,3p,2,T>-,0,0,0,4741672,4881751,9623423,0.0
WA09,3p,3,T>-,0,1,1,4741672,4881751,9623423,1.039131294550806e-07
WA09,3p,4,T>-,0,2,2,4741672,4881748,9623420,2.0782632369781227e-07
WA09,3p,5,T>-,0,0,0,4741672,4881751,9623423,0.0
WA09,3p,6,T>-,0,22,22,4741672,4881751,9623423,2.286088848011773e-06
WA09,3p,7,T>-,0,1,1,4741672,4881748,9623420,1.0391316184890613e-07
WA09,3p,8,T>-,1,0,1,4741663,4881718,9623381,1.0391358297047576e-07
WA09,3p,9,T>-,3,14,17,4741664,4881723,9623387,1.7665298090994366e-06
WA09,3p,10,T>-,6,19,25,4741658,4881705,9623363,2.597844433385709e-06
WA09,3p,11,T>-,5,15,20,4741648,4881712,9623360,2.0782761945931567e-06
WA09,3p,12,T>-,9,18,27,4741642,4881680,9623322,2.8056839415744376e-06
WA09,3p,13,T>-,11,42,53,4741628,4881645,9623273,5.507481706068195e-06
WA09,3p,14,T>-,15,20,35,4741616,4881571,9623187,3.637048724086937e-06
WA09,3p,15,T>-,20,30,50,4741598,4881557,9623155,5.195801169159179e-06
WA09,3p,16,T>-,25,51,76,4741586,4881546,9623132,7.89763665301484e-06
WA09,3p,17,T>-,18,60,78,4741582,4881528,9623110,8.105487726940667e-06
WA09,3p,18,T>-,39,40,79,4741560,4881490,9623050,8.209455422137472e-06
WA09,3p,19,T>-,47,57,104,4741552,4881442,9622994,1.0807447245628544e-05
WA09,3p,20,T>-,52,79,131,4741534,4881501,9623035,1.361316881836136e-05
WA09,3p,21,T>-,79,86,165,4741546,4881493,9623039,1.7146350544770733e-05
WA09,3p,22,T>-,62,113,175,4741524,4881498,9623022,1.8185555431547387e-05
WA09,3p,23,T>-,48,132,180,4741501,4881486,9622987,1.8705210762521037e-05
WA09,3p,24,T>-,62,185,247,4741491,4881450,9622941,2.566782857756272e-05
WA09,3p,25,T>-,137,212,349,4741451,4881469,9622920,3.626757782461041e-05
WA09,5p,1,T>-,0,0,0,4741672,4881751,9623423,0.0
WA09,5p,2,T>-,0,0,0,4741495,4881667,9623162,0.0
WA09,5p,3,T>-,0,0,0,4741672,4881750,9623422,0.0
WA09,5p,4,T>-,0,0,0,4741672,4881751,9623423,0.0
WA09,5p,5,T>-,1,0,1,4741671,4881751,9623422,1.0391314025302019e-07
WA09,5p,6,T>-,0,0,0,4741669,4881751,9623420,0.0
WA09,5p,7,T>-,3,0,3,4741667,4881751,9623418,3.11739550334403e-07
WA09,5p,8,T>-,3,0,3,4741639,4881744,9623383,3.117406841232444e-07
WA09,5p,9,T>-,22,0,22,4741618,4881747,9623365,2.2861026262643056e-06
WA09,5p,10,T>-,12,0,12,4741622,4881737,9623359,1.2469658463328656e-06
WA09,5p,11,T>-,19,10,29,4741614,4881733,9623347,3.0135045530416807e-06
WA09,5p,12,T>-,20,5,25,4741580,4881734,9623314,2.597857661092634e-06
WA09,5p,13,T>-,29,7,36,4741530,4881708,9623238,3.740944576035634e-06
WA09,5p,14,T>-,45,14,59,4741498,4881705,9623203,6.131014798295328e-06
WA09,5p,15,T>-,30,50,80,4741496,4881672,9623168,8.313270640188345e-06
WA09,5p,16,T>-,54,31,85,4741451,4881636,9623087,8.832924403572367e-06
WA09,5p,17,T>-,58,33,91,4741476,4881638,9623114,9.456398417393788e-06
WA09,5p,18,T>-,116,32,148,4741455,4881610,9623065,1.5379715298608085e-05
WA09,5p,19,T>-,56,22,78,4741379,4881580,9622959,8.105614915329059e-06
WA09,5p,20,T>-,53,260,313,4741390,4881557,9622947,3.2526418362275094e-05
WA09,5p,21,T>-,69,45,114,4741379,4881587,9622966,1.184665933559362e-05
WA09,5p,22,T>-,77,43,120,4741354,4881580,9622934,1.2470209189837528e-05
WA09,5p,23,T>-,86,66,152,4741312,4881565,9622877,1.5795691870528947e-05
WA09,5p,24,T>-,135,122,257,4741363,4881548,9622911,2.670709518148926e-05
WA09,5p,25,T>-,201,149,350,4741301,4881503,9622804,3.63719348331318e-05
WA11,3p,1,T>-,0,0,0,9756642,10108269,19864911,0.0
WA11,3p,2,T>-,0,0,0,9756642,10108269,19864911,0.0
WA11,3p,3,T>-,0,0,0,9756642,10108269,19864911,0.0
WA11,3p,4,T>-,0,0,0,9756642,10108267,19864909,0.0
WA11,3p,5,T>-,0,0,0,9756642,10108269,19864911,0.0
WA11,3p,6,T>-,0,0,0,9756642,10108269,19864911,0.0
WA11,3p,7,T>-,0,0,0,9756642,10108265,19864907,0.0
WA11,3p,8,T>-,0,1,1,9756629,10108160,19864789,5.034032830653273e-08
WA11,3p,9,T>-,14,46,60,9756610,10108092,19864702,3.0204329267058725e-06
WA11,3p,10,T>-,12,32,44,9756615,10107969,19864584,2.2149973037441917e-06
WA11,3p,11,T>-,18,27,45,9756587,10107918,19864505,2.265347160676795e-06
WA11,3p,12,T>-,21,43,64,9756581,10108019,19864600,3.2218116649718595e-06
WA11,3p,13,T>-,15,45,60,9756565,10107963,19864528,3.020459383681304e-06
WA11,3p,14,T>-,24,65,89,9756515,10107914,19864429,4.480370414875756e-06
WA11,3p,15,T>-,48,114,162,9756471,10107972,19864443,8.15527523223279e-06
WA11,3p,16,T>-,53,84,137,9756477,10108011,19864488,6.896729480266493e-06
WA11,3p,17,T>-,68,103,171,9756469,10108044,19864513,8.608315743758733e-06
WA11,3p,18,T>-,57,129,186,9756421,10108016,19864437,9.36346698373581e-06
WA11,3p,19,T>-,72,143,215,9756438,10108000,19864438,1.082336182881187e-05
WA11,3p,20,T>-,69,132,201,9756433,10107963,19864396,1.0118606173578094e-05
WA11,3p,21,T>-,57,140,197,9756421,10107904,19864325,9.9172763232579e-06
WA11,3p,22,T>-,87,187,274,9756405,10107842,19864247,1.3793626307606827e-05
WA11,3p,23,T>-,87,206,293,9756375,10107816,19864191,1.4750160225503268e-05
WA11,3p,24,T>-,109,264,373,9756358,10107704,19864062,1.8777629671111577e-05
WA11,3p,25,T>-,206,314,520,9756281,10107693,19863974,2.617804473566065e-05
WA11,5p,1,T>-,0,0,0,9756641,10108269,19864910,0.0
WA11,5p,2,T>-,0,0,0,9756471,10108196,19864667,0.0
WA11,5p,3,T>-,0,0,0,9756642,10108269,19864911,0.0
WA11,5p,4,T>-,0,0,0,9756638,10108269,19864907,0.0
WA11,5p,5,T>-,0,0,0,9756638,10108267,19864905,0.0
WA11,5p,6,T>-,1,0,1,9756642,10108269,19864911,5.034001914229569e-08
WA11,5p,7,T>-,2,0,2,9756629,10108269,19864898,1.0068010417169018e-07
WA11,5p,8,T>-,7,3,10,9756500,10108261,19864761,5.034039926279505e-07
WA11,5p,9,T>-,60,3,63,9756493,10108240,19864733,3.171449623813217e-06
WA11,5p,10,T>-,57,12,69,9756446,10108197,19864643,3.4735081823519304e-06
WA11,5p,11,T>-,57,23,80,9756457,10108195,19864652,4.027254038983416e-06
WA11,5p,12,T>-,46,23,69,9756411,10108221,19864632,3.4735101058000976e-06
WA11,5p,13,T>-,67,36,103,9756334,10108178,19864512,5.185126118376329e-06
WA11,5p,14,T>-,46,46,92,9756261,10108167,19864428,4.631394369875639e-06
WA11,5p,15,T>-,91,49,140,9756237,10108096,19864333,7.047807746678432e-06
WA11,5p,16,T>-,71,74,145,9756275,10108079,19864354,7.299507449373888e-06
WA11,5p,17,T>-,101,48,149,9756369,10108078,19864447,7.500838055043768e-06
WA11,5p,18,T>-,125,82,207,9756327,10108075,19864402,1.0420650971521822e-05
WA11,5p,19,T>-,116,68,184,9756284,10108088,19864372,9.262814852641703e-06
WA11,5p,20,T>-,104,76,180,9756292,10108082,19864374,9.06144840003516e-06
WA11,5p,21,T>-,128,148,276,9756251,10108036,19864287,1.389428173284045e-05
WA11,5p,22,T>-,158,87,245,9756136,10108029,19864165,1.2333767867916924e-05
WA11,5p,23,T>-,174,118,292,9756095,10108016,19864111,1.4699877583245485e-05
WA11,5p,24,T>-,206,173,379,9756046,10108010,19864056,1.907968845838937e-05
WA11,5p,25,T>-,266,241,507,9756056,10107943,19863999,2.5523561494339582e-05
WA12,3p,1,T>-,0,0,0,6632243,6940679,13572922,0.0
WA12,3p,2,T>-,0,0,0,6632243,6940679,13572922,0.0
WA12,3p,3,T>-,0,0,0,6632243,6940679,13572922,0.0
WA12,3p,4,T>-,0,0,0,6632243,6940676,13572919,0.0
WA12,3p,5,T>-,0,0,0,6632243,6940678,13572921,0.0
WA12,3p,6,T>-,0,0,0,6632243,6940679,13572922,0.0
WA12,3p,7,T>-,0,0,0,6632243,6940676,13572919,0.0
WA12,3p,8,T>-,1,0,1,6632240,6940664,13572904,7.367620075998476e-08
WA12,3p,9,T>-,1,13,14,6632231,6940656,13572887,1.0314681025488535e-06
WA12,3p,10,T>-,5,11,16,6632228,6940644,13572872,1.1788219913957784e-06
WA12,3p,11,T>-,9,13,22,6632231,6940642,13572873,1.6208801187486246e-06
WA12,3p,12,T>-,2,34,36,6632223,6940615,13572838,2.652356124783925e-06
WA12,3p,13,T>-,4,21,25,6632204,6940591,13572795,1.84191981091588e-06
WA12,3p,14,T>-,10,20,30,6632209,6940533,13572742,2.210312404081652e-06
WA12,3p,15,T>-,13,38,51,6632188,6940474,13572662,3.757553234582869e-06
WA12,3p,16,T>-,17,41,58,6632187,6940478,13572665,4.273294890870731e-06
WA12,3p,17,T>-,25,97,122,6632168,6940473,13572641,8.988670664758613e-06
WA12,3p,18,T>-,20,61,81,6632160,6940482,13572642,5.967887460672727e-06
WA12,3p,19,T>-,22,85,107,6632121,6940435,13572556,7.883555610306563e-06
WA12,3p,20,T>-,26,74,100,6632105,6940432,13572537,7.367819295685103e-06
WA12,3p,21,T>-,24,93,117,6632096,6940454,13572550,8.620340319247305e-06
WA12,3p,22,T>-,34,80,114,6632039,6940438,13572477,8.399351128021805e-06
WA12,3p,23,T>-,30,102,132,6631950,6940459,13572409,9.725613190701812e-06
WA12,3p,24,T>-,80,132,212,6631933,6940411,13572344,1.5619999021539685e-05
WA12,3p,25,T>-,103,192,295,6631986,6940428,13572414,2.1735263896312037e-05
WA12,5p,1,T>-,0,0,0,6632243,6940679,13572922,0.0
WA12,5p,2,T>-,0,0,0,6631949,6940524,13572473,0.0
WA12,5p,3,T>-,0,0,0,6632242,6940678,13572920,0.0
WA12,5p,4,T>-,0,0,0,6632242,6940679,13572921,0.0
WA12,5p,5,T>-,0,0,0,6632242,6940677,13572919,0.0
WA12,5p,6,T>-,1,0,1,6632242,6940679,13572921,7.367610848099683e-08
WA12,5p,7,T>-,1,0,1,6632238,6940679,13572917,7.367613019367907e-08
WA12,5p,8,T>-,1,0,1,6632204,6940670,13572874,7.367636360582144e-08
WA12,5p,9,T>-,45,4,49,6632209,6940675,13572884,3.6101391568659994e-06
WA12,5p,10,T>-,8,2,10,6632199,6940665,13572864,7.367641788792697e-07
WA12,5p,11,T>-,19,9,28,6632166,6940667,13572833,2.062944412562948e-06
WA12,5p,12,T>-,13,4,17,6632126,6940660,13572786,1.25250630194862e-06
WA12,5p,13,T>-,16,12,28,6632065,6940658,13572723,2.062961131675641e-06
WA12,5p,14,T>-,31,4,35,6632026,6940638,13572664,2.5787126241392256e-06
WA12,5p,15,T>-,26,12,38,6631987,6940631,13572618,2.7997546236105664e-06
WA12,5p,16,T>-,47,37,84,6631930,6940590,13572520,6.188975960249092e-06
WA12,5p,17,T>-,55,21,76,6631958,6940621,13572579,5.599525337078532e-06
WA12,5p,18,T>-,59,32,91,6632019,6940577,13572596,6.704686413711864e-06
WA12,5p,19,T>-,53,30,83,6631996,6940532,13572528,6.115294070492984e-06
WA12,5p,20,T>-,61,61,122,6631973,6940532,13572505,8.988760733556555e-06
WA12,5p,21,T>-,77,57,134,6631936,6940534,13572470,9.872926593317207e-06
WA12,5p,22,T>-,88,40,128,6631921,6940529,13572450,9.430869150374472e-06
WA12,5p,23,T>-,107,51,158,6631926,6940534,13572460,1.1641220530397584e-05
WA12,5p,24,T>-,143,122,265,6631934,6940518,13572452,1.9524843410755845e-05
WA12,5p,25,T>-,125,146,271,6631933,6940515,13572448,1.9966921221580666e-05
WA13,3p,1,T>-,0,0,0,5896847,6081528,11978375,0.0
WA13,3p,2,T>-,0,0,0,5896847,6081528,11978375,0.0
WA13,3p,3,T>-,0,0,0,5896847,6081528,11978375,0.0
WA13,3p,4,T>-,0,0,0,5896847,6081522,11978369,0.0
WA13,3p,5,T>-,0,0,0,5896847,6081527,11978374,0.0
WA13,3p,6,T>-,0,0,0,5896847,6081528,11978375,0.0
WA13,3p,7,T>-,0,2,2,5896847,6081528,11978375,1.6696755611675205e-07
WA13,3p,8,T>-,0,0,0,5896845,6081521,11978366,0.0
WA13,3p,9,T>-,0,11,11,5896842,6081517,11978359,9.183227852830258e-07
WA13,3p,10,T>-,1,9,10,5896843,6081517,11978360,8.348388260162493e-07
WA13,3p,11,T>-,5,8,13,5896841,6081492,11978333,1.085292920141726e-06
WA13,3p,12,T>-,1,6,7,5896836,6081505,11978341,5.843881051641459e-07
WA13,3p,13,T>-,4,13,17,5896834,6081495,11978329,1.4192296771945405e-06
WA13,3p,14,T>-,5,20,25,5896832,6081501,11978333,2.087101769503319e-06
WA13,3p,15,T>-,12,16,28,5896825,6081505,11978330,2.3375545672894302e-06
WA13,3p,16,T>-,12,33,45,5896830,6081509,11978339,3.756781303317597e-06
WA13,3p,17,T>-,4,22,26,5896823,6081499,11978322,2.170587833588044e-06
WA13,3p,18,T>-,10,31,41,5896827,6081499,11978326,3.422848902258963e-06
WA13,3p,19,T>-,10,25,35,5896822,6081480,11978302,2.9219500393294474e-06
WA13,3p,20,T>-,15,32,47,5896818,6081448,11978266,3.923773274028144e-06
WA13,3p,21,T>-,19,22,41,5896824,6081466,11978290,3.422859189416853e-06
WA13,3p,22,T>-,18,23,41,5896824,6081460,11978284,3.42286090394918e-06
WA13,3p,23,T>-,16,69,85,5896819,6081454,11978273,7.096181561398709e-06
WA13,3p,24,T>-,46,81,127,5896803,6081440,11978243,1.060255665208996e-05
WA13,3p,25,T>-,91,108,199,5896783,6081437,11978220,1.6613486811896927e-05
WA13,5p,1,T>-,0,0,0,5896847,6081528,11978375,0.0
WA13,5p,2,T>-,0,0,0,5896725,6081443,11978168,0.0
WA13,5p,3,T>-,0,0,0,5896847,6081528,11978375,0.0
WA13,5p,4,T>-,0,0,0,5896841,6081528,11978369,0.0
WA13,5p,5,T>-,0,0,0,5896841,6081528,11978369,0.0
WA13,5p,6,T>-,0,0,0,5896841,6081528,11978369,0.0
WA13,5p,7,T>-,0,0,0,5896845,6081528,11978373,0.0
WA13,5p,8,T>-,1,0,1,5896843,6081526,11978369,8.348381987564417e-08
WA13,5p,9,T>-,16,0,16,5896837,6081518,11978355,1.335742679190924e-06
WA13,5p,10,T>-,8,1,9,5896833,6081518,11978351,7.513555079492996e-07
WA13,5p,11,T>-,12,0,12,5896827,6081513,11978340,1.001808263916369e-06
WA13,5p,12,T>-,10,2,12,5896822,6081502,11978324,1.0018096020778868e-06
WA13,5p,13,T>-,13,3,16,5896809,6081508,11978317,1.3357469166995663e-06
WA13,5p,14,T>-,16,11,27,5896802,6081520,11978322,2.2540719810337374e-06
WA13,5p,15,T>-,12,8,20,5896798,6081508,11978306,1.6696851791897786e-06
WA13,5p,16,T>-,9,10,19,5896754,6081491,11978245,1.5862089980627378e-06
WA13,5p,17,T>-,20,12,32,5896805,6081514,11978319,2.6714933873442507e-06
WA13,5p,18,T>-,17,11,28,5896796,6081504,11978300,2.337560421762688e-06
WA13,5p,19,T>-,9,14,23,5896797,6081472,11978269,1.9201438872344576e-06
WA13,5p,20,T>-,13,30,43,5896788,6081482,11978270,3.589833924264522e-06
WA13,5p,21,T>-,23,35,58,5896782,6081484,11978266,4.84210318922622e-06
WA13,5p,22,T>-,31,33,64,5896771,6081483,11978254,5.343015768408317e-06
WA13,5p,23,T>-,43,41,84,5896768,6081501,11978269,7.012699414247585e-06
WA13,5p,24,T>-,45,42,87,5896781,6081498,11978279,7.26314690115333e-06
WA13,5p,25,T>-,84,71,155,5896769,6081462,11978231,1.294014116107796e-05
WA14,3p,1,T>-,0,0,0,6684341,7140972,13825313,0.0
WA14,3p,2,T>-,0,0,0,6684341,7140972,13825313,0.0
WA14,3p,3,T>-,0,0,0,6684341,7140972,13825313,0.0
WA14,3p,4,T>-,0,0,0,6684341,7140971,13825312,0.0
WA14,3p,5,T>-,0,0,0,6684341,7140970,13825311,0.0
WA14,3p,6,T>-,0,0,0,6684341,7140971,13825312,0.0
WA14,3p,7,T>-,0,3,3,6684341,7140969,13825310,2.1699332600860306e-07
WA14,3p,8,T>-,0,0,0,6684326,7140932,13825258,0.0
WA14,3p,9,T>-,1,39,40,6684323,7140920,13825243,2.893258368044598e-06
WA14,3p,10,T>-,6,25,31,6684256,7140912,13825168,2.2422873993285288e-06
WA14,3p,11,T>-,7,25,32,6684256,7140894,13825150,2.314622264496226e-06
WA14,3p,12,T>-,11,57,68,6684291,7140849,13825140,4.918575869756111e-06
WA14,3p,13,T>-,20,46,66,6684289,7140794,13825083,4.77393155614328e-06
WA14,3p,14,T>-,24,59,83,6684291,7140742,13825033,6.003602306048745e-06
WA14,3p,15,T>-,25,90,115,6684271,7140702,13824973,8.318280259932516e-06
WA14,3p,16,T>-,16,145,161,6684263,7140648,13824911,1.1645644590406404e-05
WA14,3p,17,T>-,28,136,164,6684212,7140653,13824865,1.1862683650075426e-05
WA14,3p,18,T>-,33,116,149,6684177,7140647,13824824,1.0777714059867958e-05
WA14,3p,19,T>-,50,193,243,6684172,7140542,13824714,1.757721714894066e-05
WA14,3p,20,T>-,42,109,151,6684176,7140544,13824720,1.09224635290986e-05
WA14,3p,21,T>-,84,218,302,6684132,7140443,13824575,2.184515618020807e-05
WA14,3p,22,T>-,57,180,237,6684105,7140560,13824665,1.7143272549461415e-05
WA14,3p,23,T>-,66,198,264,6683638,7140562,13824200,1.9096945935388665e-05
WA14,3p,24,T>-,118,292,410,6683623,7140532,13824155,2.9658232275318093e-05
WA14,3p,25,T>-,197,298,495,6683613,7140513,13824126,3.5806965301097514e-05
WA14,5p,1,T>-,0,0,0,6684341,7140972,13825313,0.0
WA14,5p,2,T>-,0,0,0,6684184,7140911,13825095,0.0
WA14,5p,3,T>-,0,0,0,6684338,7140972,13825310,0.0
WA14,5p,4,T>-,1,0,1,6684341,7140972,13825313,7.233109297416991e-08
WA14,5p,5,T>-,0,0,0,6684341,7140972,13825313,0.0
WA14,5p,6,T>-,0,0,0,6684340,7140972,13825312,0.0
WA14,5p,7,T>-,3,0,3,6684336,7140972,13825308,2.169933573993433e-07
WA14,5p,8,T>-,1,2,3,6684277,7140970,13825247,2.169943148212831e-07
WA14,5p,9,T>-,28,1,29,6684241,7140959,13825200,2.097618840957093e-06
WA14,5p,10,T>-,34,0,34,6684210,7140628,13824838,2.459341657385063e-06
WA14,5p,11,T>-,16,3,19,6684218,7140646,13824864,1.3743354003337754e-06
WA14,5p,12,T>-,21,15,36,6684139,7140917,13825056,2.6039677524633536e-06
WA14,5p,13,T>-,80,12,92,6684018,7140931,13824949,6.654635760319984e-06
WA14,5p,14,T>-,48,26,74,6683951,7140942,13824893,5.352663488968776e-06
WA14,5p,15,T>-,91,21,112,6684030,7140908,13824938,8.101302154121777e-06
WA14,5p,16,T>-,109,23,132,6683910,7140868,13824778,9.548073755687072e-06
WA14,5p,17,T>-,92,48,140,6683904,7140873,13824777,1.0126745624902305e-05
WA14,5p,18,T>-,101,66,167,6683891,7140646,13824537,1.2079970562486107e-05
WA14,5p,19,T>-,72,53,125,6683958,7140595,13824553,9.04188366886076e-06
WA14,5p,20,T>-,73,84,157,6683860,7140558,13824418,1.1356716789090144e-05
WA14,5p,21,T>-,117,75,192,6683480,7140494,13823974,1.38889150109802e-05
WA14,5p,22,T>-,159,102,261,6683768,7140398,13824166,1.8879981620591076e-05
WA14,5p,23,T>-,200,109,309,6683762,7140257,13824019,2.23523998339412e-05
WA14,5p,24,T>-,228,166,394,6683714,7140421,13824135,2.8500879078510155e-05
WA14,5p,25,T>-,233,252,485,6683731,7140511,13824242,3.508329787629586e-05
WA18,3p,1,T>-,0,0,0,14112928,14131239,28244167,0.0
WA18,3p,2,T>-,0,0,0,14112928,14131239,28244167,0.0
WA18,3p,3,T>-,0,0,0,14112928,14131239,28244167,0.0
WA18,3p,4,T>-,0,0,0,14112928,14131238,28244166,0.0
WA18,3p,5,T>-,0,0,0,14112928,14131239,28244167,0.0
WA18,3p,6,T>-,0,2,2,14112928,14131239,28244167,7.081108109862117e-08
WA18,3p,7,T>-,0,0,0,14112928,14131237,28244165,0.0
WA18,3p,8,T>-,0,0,0,14112927,14131187,28244114,0.0
WA18,3p,9,T>-,1,35,36,14112909,14131177,28244086,1.2746031151441756e-06
WA18,3p,10,T>-,4,37,41,14112909,14131197,28244106,1.4516302976628114e-06
WA18,3p,11,T>-,9,19,28,14112900,14131167,28244067,9.91358645339568e-07
WA18,3p,12,T>-,11,40,51,14112895,14131136,28244031,1.8056912626954704e-06
WA18,3p,13,T>-,13,32,45,14112898,14131061,28243959,1.5932610580549278e-06
WA18,3p,14,T>-,17,34,51,14112830,14131006,28243836,1.8057037294792396e-06
WA18,3p,15,T>-,17,152,169,14112809,14130957,28243766,5.983621306025549e-06
WA18,3p,16,T>-,19,165,184,14112765,14130927,28243692,6.514729023386886e-06
WA18,3p,17,T>-,35,78,113,14112743,14130850,28243593,4.000907391633919e-06
WA18,3p,18,T>-,18,104,122,14112708,14130769,28243477,4.319581473626636e-06
WA18,3p,19,T>-,86,111,197,14112724,14130771,28243495,6.975057442430549e-06
WA18,3p,20,T>-,32,142,174,14112697,14130797,28243494,6.160710852559532e-06
WA18,3p,21,T>-,43,144,187,14112659,14130783,28243442,6.621006037436938e-06
WA18,3p,22,T>-,46,178,224,14112575,14130715,28243290,7.93108734853482e-06
WA18,3p,23,T>-,50,224,274,14112548,14130648,28243196,9.701451634581298e-06
WA18,3p,24,T>-,86,255,341,14112551,14130690,28243241,1.207368516948887e-05
WA18,3p,25,T>-,149,273,422,14112486,14130651,28243137,1.4941683000723329e-05
WA18,5p,1,T>-,0,0,0,14112926,14131239,28244165,0.0
WA18,5p,2,T>-,0,0,0,14112820,14131183,28244003,0.0
WA18,5p,3,T>-,0,0,0,14112928,14131239,28244167,0.0
WA18,5p,4,T>-,1,0,1,14112928,14131239,28244167,3.5405540549310586e-08
WA18,5p,5,T>-,1,0,1,14112925,14131239,28244164,3.5405544309967895e-08
WA18,5p,6,T>-,0,0,0,14112927,14131239,28244166,0.0
WA18,5p,7,T>-,3,0,3,14112921,14131239,28244160,1.0621664797253664e-07
WA18,5p,8,T>-,4,1,5,14112828,14131230,28244058,1.770283859351939e-07
WA18,5p,9,T>-,82,3,85,14112833,14131230,28244063,3.00948202813455e-06
WA18,5p,10,T>-,32,6,38,14112791,14131213,28244004,1.3454183054215684e-06
WA18,5p,11,T>-,30,21,51,14112776,14131211,28243987,1.805694075698307e-06
WA18,5p,12,T>-,22,8,30,14112682,14131223,28243905,1.0621760694918071e-06
WA18,5p,13,T>-,64,21,85,14112608,14131206,28243814,3.0095085599983062e-06
WA18,5p,14,T>-,47,18,65,14112535,14131179,28243714,2.3013970471447203e-06
WA18,5p,15,T>-,73,38,111,14112545,14131148,28243693,3.930080956481152e-06
WA18,5p,16,T>-,89,31,120,14112522,14131083,28243605,4.248749407166684e-06
WA18,5p,17,T>-,77,51,128,14112485,14130990,28243475,4.532020227680907e-06
WA18,5p,18,T>-,113,64,177,14112481,14130987,28243468,6.2669357743178e-06
WA18,5p,19,T>-,88,61,149,14112359,14130867,28243226,5.275601307017832e-06
WA18,5p,20,T>-,159,81,240,14112397,14130866,28243263,8.497601711247033e-06
WA18,5p,21,T>-,135,70,205,14112347,14130679,28243026,7.2584290366053555e-06
WA18,5p,22,T>-,168,87,255,14112376,14129592,28241968,9.029115817991156e-06
WA18,5p,23,T>-,134,69,203,14112288,14129275,28241563,7.187987435397963e-06
WA18,5p,24,T>-,185,128,313,14112253,14129481,28241734,1.1082888890604238e-05
WA18,5p,25,T>-,204,191,395,14112273,14130551,28242824,1.3985853539291963e-05
WA22,3p,1,T>-,0,0,0,1513709,1653397,3167106,0.0
WA22,3p,2,T>-,0,0,0,1513709,1653396,3167105,0.0
WA22,3p,3,T>-,0,0,0,1513709,1653396,3167105,0.0
WA22,3p,4,T>-,0,0,0,1513709,1653394,3167103,0.0
WA22,3p,5,T>-,0,0,0,1513709,1653397,3167106,0.0
WA22,3p,6,T>-,0,0,0,1513709,1653397,3167106,0.0
WA22,3p,7,T>-,0,0,0,1513709,1653397,3167106,0.0
WA22,3p,8,T>-,1,0,1,1513709,1653395,3167104,3.15745867518086e-07
WA22,3p,9,T>-,0,30,30,1513709,1653397,3167106,9.472370043819183e-06
WA22,3p,10,T>-,10,12,22,1513706,1653396,3167102,6.946413472000586e-06
WA22,3p,11,T>-,23,1,24,1513685,1653390,3167075,7.577970209104615e-06
WA22,3p,12,T>-,19,32,51,1513662,1653379,3167041,1.6103359571284363e-05
WA22,3p,13,T>-,16,54,70,1513689,1653380,3167069,2.2102454982824812e-05
WA22,3p,14,T>-,26,25,51,1513686,1653352,3167038,1.610337482530996e-05
WA22,3p,15,T>-,21,35,56,1513677,1653343,3167020,1.768223756086163e-05
WA22,3p,16,T>-,10,34,44,1513637,1653341,3166978,1.3893370904376349e-05
WA22,3p,17,T>-,10,86,96,1513671,1653319,3166990,3.0312694388046693e-05
WA22,3p,18,T>-,38,42,80,1513665,1653288,3166953,2.5260873779939268e-05
WA22,3p,19,T>-,27,61,88,1513662,1653275,3166937,2.7787101543226152e-05
WA22,3p,20,T>-,15,52,67,1513684,1653304,3166988,2.1155747985151824e-05
WA22,3p,21,T>-,36,75,111,1513677,1653327,3167004,3.5048897948976386e-05
WA22,3p,22,T>-,32,89,121,1513684,1653356,3167040,3.820602202687683e-05
WA22,3p,23,T>-,26,74,100,1513676,1653329,3167005,3.157557376764483e-05
WA22,3p,24,T>-,27,142,169,1513672,1653285,3166957,5.3363528459653855e-05
WA22,3p,25,T>-,79,143,222,1513669,1653296,3166965,7.009865912632441e-05
WA22,5p,1,T>-,0,0,0,1513709,1653397,3167106,0.0
WA22,5p,2,T>-,0,0,0,1513674,1653378,3167052,0.0
WA22,5p,3,T>-,1,0,1,1513709,1653397,3167106,3.157456681273061e-07
WA22,5p,4,T>-,0,0,0,1513709,1653397,3167106,0.0
WA22,5p,5,T>-,0,0,0,1513708,1653396,3167104,0.0
WA22,5p,6,T>-,0,0,0,1513704,1653397,3167101,0.0
WA22,5p,7,T>-,0,0,0,1513707,1653397,3167104,0.0
WA22,5p,8,T>-,0,0,0,1513692,1653397,3167089,0.0
WA22,5p,9,T>-,40,1,41,1513700,1653389,3167089,1.2945641881235418e-05
WA22,5p,10,T>-,25,1,26,1513705,1653389,3167094,8.20941847636982e-06
WA22,5p,11,T>-,13,1,14,1513699,1653381,3167080,4.420475643179206e-06
WA22,5p,12,T>-,8,8,16,1513692,1653345,3167037,5.052040756075789e-06
WA22,5p,13,T>-,12,6,18,1513697,1653377,3167074,5.683479451380043e-06
WA22,5p,14,T>-,30,36,66,1513677,1653376,3167053,2.083956283649184e-05
WA22,5p,15,T>-,29,22,51,1513695,1653381,3167076,1.6103181609787702e-05
WA22,5p,16,T>-,39,17,56,1513668,1653368,3167036,1.7682148229448607e-05
WA22,5p,17,T>-,13,82,95,1513675,1653395,3167070,2.9996179433987883e-05
WA22,5p,18,T>-,12,3,15,1513651,1653392,3167043,4.736279235867653e-06
WA22,5p,19,T>-,17,32,49,1513674,1653350,3167024,1.5471938324433284e-05
WA22,5p,20,T>-,40,23,63,1513678,1653356,3167034,1.989242932030411e-05
WA22,5p,21,T>-,58,58,116,1513690,1653371,3167061,3.662701791976852e-05
WA22,5p,22,T>-,32,34,66,1513691,1653380,3167071,2.083944439515249e-05
WA22,5p,23,T>-,47,41,88,1513634,1653393,3167027,2.778631189440444e-05
WA22,5p,24,T>-,62,38,100,1513632,1653375,3167007,3.157555382732024e-05
WA22,5p,25,T>-,57,132,189,1513644,1653364,3167008,5.9677777890046375e-05
WA25,3p,1,T>-,0,0,0,3375244,3569089,6944333,0.0
WA25,3p,2,T>-,0,0,0,3375244,3569089,6944333,0.0
WA25,3p,3,T>-,0,0,0,3375244,3569089,6944333,0.0
WA25,3p,4,T>-,0,0,0,3375244,3569087,6944331,0.0
WA25,3p,5,T>-,0,0,0,3375244,3569089,6944333,0.0
WA25,3p,6,T>-,0,0,0,3375244,3569089,6944333,0.0
WA25,3p,7,T>-,0,0,0,3375244,3569089,6944333,0.0
WA25,3p,8,T>-,0,0,0,3375239,3569076,6944315,0.0
WA25,3p,9,T>-,0,9,9,3375240,3569076,6944316,1.2960239712593725e-06
WA25,3p,10,T>-,3,4,7,3375240,3569075,6944315,1.0080187894702356e-06
WA25,3p,11,T>-,2,7,9,3375233,3569054,6944287,1.2960293835781844e-06
WA25,3p,12,T>-,5,11,16,3375226,3569069,6944295,2.304049583147029e-06
WA25,3p,13,T>-,11,15,26,3375230,3569053,6944283,3.744087042535565e-06
WA25,3p,14,T>-,3,13,16,3375223,3569037,6944260,2.3040611958653624e-06
WA25,3p,15,T>-,7,26,33,3375218,3569039,6944257,4.752128269446249e-06
WA25,3p,16,T>-,14,17,31,3375196,3569030,6944226,4.464140424001178e-06
WA25,3p,17,T>-,10,28,38,3375198,3569022,6944220,5.47217686075614e-06
WA25,3p,18,T>-,16,32,48,3375213,3569006,6944219,6.912224398452872e-06
WA25,3p,19,T>-,26,25,51,3375204,3569005,6944209,7.344248999418076e-06
WA25,3p,20,T>-,17,33,50,3375190,3568979,6944169,7.200285592127726e-06
WA25,3p,21,T>-,22,53,75,3375199,3568998,6944197,1.0800384839312596e-05
WA25,3p,22,T>-,22,57,79,3375179,3568994,6944173,1.1376444682469749e-05
WA25,3p,23,T>-,15,61,76,3375175,3568972,6944147,1.0944468773486504e-05
WA25,3p,24,T>-,40,88,128,3375177,3568962,6944139,1.843281074874797e-05
WA25,3p,25,T>-,62,107,169,3375156,3568970,6944126,2.4337116002791422e-05
WA25,5p,1,T>-,0,0,0,3375244,3569089,6944333,0.0
WA25,5p,2,T>-,0,0,0,3375147,3569045,6944192,0.0
WA25,5p,3,T>-,0,0,0,3375243,3569089,6944332,0.0
WA25,5p,4,T>-,1,0,1,3375243,3569089,6944332,1.4400233168575465e-07
WA25,5p,5,T>-,0,0,0,3375244,3569088,6944332,0.0
WA25,5p,6,T>-,1,0,1,3375244,3569089,6944333,1.440023109490861e-07
WA25,5p,7,T>-,3,0,3,3375242,3569089,6944331,4.320070572672876e-07
WA25,5p,8,T>-,2,0,2,3375221,3569088,6944309,2.880056172615591e-07
WA25,5p,9,T>-,27,0,27,3375227,3569087,6944314,3.888073033563862e-06
WA25,5p,10,T>-,18,2,20,3375217,3569085,6944302,2.8800590757717623e-06
WA25,5p,11,T>-,10,4,14,3375193,3569088,6944281,2.016047449692776e-06
WA25,5p,12,T>-,13,5,18,3375142,3569084,6944226,2.592081536516813e-06
WA25,5p,13,T>-,48,3,51,3375133,3569081,6944214,7.344243711383319e-06
WA25,5p,14,T>-,20,3,23,3375151,3569071,6944222,3.3121060933823837e-06
WA25,5p,15,T>-,27,13,40,3375137,3569055,6944192,5.760209395131932e-06
WA25,5p,16,T>-,21,16,37,3375081,3569035,6944116,5.3282520050068285e-06
WA25,5p,17,T>-,29,23,52,3375076,3568871,6943947,7.488536418840754e-06
WA25,5p,18,T>-,36,17,53,3375102,3568996,6944098,7.632380764211565e-06
WA25,5p,19,T>-,24,17,41,3375134,3569021,6944155,5.904246088976989e-06
WA25,5p,20,T>-,21,17,38,3375145,3569019,6944164,5.472220990172467e-06
WA25,5p,21,T>-,25,11,36,3375130,3569013,6944143,5.184225036840399e-06
WA25,5p,22,T>-,48,22,70,3375139,3569001,6944140,1.008044192657406e-05
WA25,5p,23,T>-,37,28,65,3375144,3569002,6944146,9.360402272648067e-06
WA25,5p,24,T>-,65,38,103,3375124,3568967,6944091,1.4832754927894813e-05
WA25,5p,25,T>-,86,80,166,3375125,3568950,6944075,2.3905271760457656e-05
WA26,3p,1,T>-,0,0,0,2709623,2900126,5609749,0.0
WA26,3p,2,T>-,0,0,0,2709623,2900126,5609749,0.0
WA26,3p,3,T>-,0,0,0,2709623,2900126,5609749,0.0
WA26,3p,4,T>-,0,0,0,2709623,2900126,5609749,0.0
WA26,3p,5,T>-,0,0,0,2709623,2900126,5609749,0.0
WA26,3p,6,T>-,0,0,0,2709623,2900126,5609749,0.0
WA26,3p,7,T>-,0,0,0,2709623,2900126,5609749,0.0
WA26,3p,8,T>-,0,0,0,2709619,2900114,5609733,0.0
WA26,3p,9,T>-,1,24,25,2709613,2900111,5609724,4.456547238331155e-06
WA26,3p,10,T>-,32,27,59,2709609,2900074,5609683,1.0517528352315096e-05
WA26,3p,11,T>-,42,33,75,2709594,2900076,5609670,1.3369770414302446e-05
WA26,3p,12,T>-,57,39,96,2709607,2900081,5609688,1.7113251218249572e-05
WA26,3p,13,T>-,18,58,76,2709604,2900084,5609688,1.354799054778091e-05
WA26,3p,14,T>-,27,63,90,2709584,2900069,5609653,1.604377311751725e-05
WA26,3p,15,T>-,86,84,170,2709593,2900082,5609675,3.0304785927883523e-05
WA26,3p,16,T>-,63,113,176,2709580,2900075,5609655,3.1374478466144534e-05
WA26,3p,17,T>-,44,70,114,2709570,2900078,5609648,2.0322130729058224e-05
WA26,3p,18,T>-,54,71,125,2709582,2900059,5609641,2.2283065886034414e-05
WA26,3p,19,T>-,66,91,157,2709567,2900016,5609583,2.798782012851936e-05
WA26,3p,20,T>-,68,95,163,2709563,2899983,5609546,2.905761000979402e-05
WA26,3p,21,T>-,72,112,184,2709562,2900021,5609583,3.28010121251437e-05
WA26,3p,22,T>-,48,129,177,2709522,2900007,5609529,3.155345127906461e-05
WA26,3p,23,T>-,41,164,205,2709541,2899974,5609515,3.654504890351483e-05
WA26,3p,24,T>-,103,211,314,2709558,2899951,5609509,5.597637868127139e-05
WA26,3p,25,T>-,131,255,386,2709500,2900002,5609502,6.881181252809964e-05
WA26,5p,1,T>-,0,0,0,2709622,2900126,5609748,0.0
WA26,5p,2,T>-,0,0,0,2709554,2900092,5609646,0.0
WA26,5p,3,T>-,0,0,0,2709623,2900126,5609749,0.0
WA26,5p,4,T>-,3,0,3,2709623,2900126,5609749,5.347832853127653e-07
WA26,5p,5,T>-,3,0,3,2709623,2900125,5609748,5.347833806438364e-07
WA26,5p,6,T>-,3,0,3,2709621,2900126,5609747,5.347834759749415e-07
WA26,5p,7,T>-,1,0,1,2709622,2900126,5609748,1.782611268812788e-07
WA26,5p,8,T>-,0,0,0,2709609,2900124,5609733,0.0
WA26,5p,9,T>-,42,1,43,2709594,2900123,5609717,7.665270814909201e-06
WA26,5p,10,T>-,23,2,25,2709601,2900123,5609724,4.456547238331155e-06
WA26,5p,11,T>-,16,6,22,2709605,2900103,5609708,3.921772755373364e-06
WA26,5p,12,T>-,34,12,46,2709595,2900107,5609702,8.20007907728432e-06
WA26,5p,13,T>-,51,16,67,2709592,2900104,5609696,1.1943606213242217e-05
WA26,5p,14,T>-,34,19,53,2709563,2900089,5609652,9.44800140900006e-06
WA26,5p,15,T>-,35,19,54,2709545,2900085,5609630,9.626303339079404e-06
WA26,5p,16,T>-,32,33,65,2709540,2900076,5609616,1.1587245900610666e-05
WA26,5p,17,T>-,46,39,85,2709554,2900055,5609609,1.5152571239813684e-05
WA26,5p,18,T>-,52,86,138,2709554,2900082,5609636,2.460052666518826e-05
WA26,5p,19,T>-,41,63,104,2709570,2900086,5609656,1.8539461243256276e-05
WA26,5p,20,T>-,74,60,134,2709563,2900082,5609645,2.388742959670353e-05
WA26,5p,21,T>-,43,58,101,2709545,2900061,5609606,1.800482957270083e-05
WA26,5p,22,T>-,67,71,138,2709542,2900059,5609601,2.460068015532656e-05
WA26,5p,23,T>-,87,69,156,2709528,2900065,5609593,2.780950418328032e-05
WA26,5p,24,T>-,126,84,210,2709495,2900057,5609552,3.743614463329692e-05
WA26,5p,25,T>-,140,178,318,2709506,2900041,5609547,5.668906954518787e-05
