Sample,End,Position,Substitution,Pos_Count,Neg_Count,Combined_Count,Pos_Total,Neg_Total,Combined_Total,Frequency
DAL192,3p,1,T>G,14,7,21,6350003,6167708,12517711,1.677623009510285e-06
DAL192,3p,2,T>G,21,12,33,6350003,6167706,12517709,2.6362651504360742e-06
DAL192,3p,3,T>G,160,72,232,6350003,6167708,12517711,1.8533739914589817e-05
DAL192,3p,4,T>G,130,77,207,6350003,6167708,12517711,1.653656966517281e-05
DAL192,3p,5,T>G,243,211,454,6350003,6167708,12517711,3.626861172941283e-05
DAL192,3p,6,T>G,199,218,417,6350003,6167708,12517711,3.331279976027566e-05
DAL192,3p,7,T>G,338,221,559,6350003,6167708,12517711,4.4656726776964254e-05
DAL192,3p,8,T>G,467,248,715,6350003,6167618,12517621,5.7119479811699046e-05
DAL192,3p,9,T>G,408,336,744,6350003,6167637,12517640,5.943612374217504e-05
DAL192,3p,10,T>G,454,328,782,6350003,6167645,12517648,6.24717998141504e-05
DAL192,3p,11,T>G,343,338,681,6349987,6167644,12517631,5.44032652823845e-05
DAL192,3p,12,T>G,327,415,742,6349997,6167646,12517643,5.927633500971389e-05
DAL192,3p,13,T>G,596,601,1197,6349992,6167621,12517613,9.56252601833912e-05
DAL192,3p,14,T>G,626,481,1107,6349967,6167610,12517577,8.843564533295861e-05
DAL192,3p,15,T>G,524,367,891,6349968,6167615,12517583,7.11798755398706e-05
DAL192,3p,16,T>G,822,453,1275,6349943,6167587,12517530,0.000101857155525
DAL192,3p,17,T>G,754,489,1243,6349922,6167606,12517528,9.930075650719536e-05
DAL192,3p,18,T>G,718,655,1373,6349922,6167564,12517486,0.0001096865616626
DAL192,3p,19,T>G,556,452,1008,6349921,6167519,12517440,8.052764782575351e-05
DAL192,3p,20,T>G,478,387,865,6349910,6167516,12517426,6.910366396414088e-05
DAL192,3p,21,T>G,614,487,1101,6349882,6167507,12517389,8.79576403673322e-05
DAL192,3p,22,T>G,627,452,1079,6349894,6167488,12517382,8.620013354230141e-05
DAL192,3p,23,T>G,856,621,1477,6349902,6167465,12517367,0.0001179960609926
DAL192,3p,24,T>G,1333,615,1948,6349899,6167465,12517364,0.0001556238198393
DAL192,3p,25,T>G,1067,437,1504,6349856,6167384,12517240,0.0001201542832125
DAL192,5p,1,T>G,8,9,17,6350003,6167708,12517711,1.3580757696035642e-06
DAL192,5p,2,T>G,8,7,15,6349992,6167694,12517686,1.1983045428683864e-06
DAL192,5p,3,T>G,378,236,614,6350003,6167707,12517710,4.905050524417006e-05
DAL192,5p,4,T>G,164,120,284,6350003,6167708,12517711,2.268785403337719e-05
DAL192,5p,5,T>G,282,299,581,6350003,6167707,12517710,4.641424030433681e-05
DAL192,5p,6,T>G,203,259,462,6350002,6167707,12517709,3.690771210610504e-05
DAL192,5p,7,T>G,244,200,444,6350002,6167708,12517710,3.546974646321092e-05
DAL192,5p,8,T>G,309,205,514,6349926,6167708,12517634,4.106207291250088e-05
DAL192,5p,9,T>G,265,262,527,6349914,6167708,12517622,4.210064819020737e-05
DAL192,5p,10,T>G,329,256,585,6349896,6167708,12517604,4.673418331495389e-05
DAL192,5p,11,T>G,373,256,629,6349942,6167706,12517648,5.02490563722514e-05
DAL192,5p,12,T>G,330,226,556,6349906,6167700,12517606,4.441743892562204e-05
DAL192,5p,13,T>G,280,301,581,6349906,6167705,12517611,4.641460738794327e-05
DAL192,5p,14,T>G,422,409,831,6349889,6167679,12517568,6.638669747989385e-05
DAL192,5p,15,T>G,522,309,831,6349890,6167649,12517539,6.638685128123028e-05
DAL192,5p,16,T>G,433,364,797,6349904,6167639,12517543,6.367064207408755e-05
DAL192,5p,17,T>G,286,555,841,6349778,6167623,12517401,6.718647105737045e-05
DAL192,5p,18,T>G,348,523,871,6349859,6167631,12517490,6.958263997015376e-05
DAL192,5p,19,T>G,437,614,1051,6349822,6167638,12517460,8.396272087148671e-05
DAL192,5p,20,T>G,410,311,721,6349836,6167621,12517457,5.759955876021783e-05
DAL192,5p,21,T>G,639,419,1058,6349784,6167624,12517408,8.452229087683328e-05
DAL192,5p,22,T>G,497,531,1028,6349783,6167584,12517367,8.212589756296192e-05
DAL192,5p,23,T>G,515,492,1007,6349801,6167567,12517368,8.04482220223932e-05
DAL192,5p,24,T>G,473,656,1129,6349759,6167564,12517323,9.019500415544122e-05
DAL192,5p,25,T>G,458,592,1050,6349777,6167551,12517328,8.388371703609589e-05
DAL193,3p,1,T>G,39,19,58,6484405,6362696,12847101,4.514637193246944e-06
DAL193,3p,2,T>G,81,39,120,6484402,6362696,12847098,9.340630856867442e-06
DAL193,3p,3,T>G,152,165,317,6484405,6362696,12847101,2.4674827418263467e-05
DAL193,3p,4,T>G,261,267,528,6484405,6362696,12847101,4.1098766173006656e-05
DAL193,3p,5,T>G,873,1016,1889,6484405,6362696,12847101,0.0001470370630697
DAL193,3p,6,T>G,986,1087,2073,6484405,6362696,12847101,0.0001613593603724
DAL193,3p,7,T>G,925,912,1837,6484405,6362696,12847101,0.0001429894573102
DAL193,3p,8,T>G,1125,892,2017,6484400,6362644,12847044,0.000157001096906
DAL193,3p,9,T>G,1528,1214,2742,6484400,6362631,12847031,0.00021343452818
DAL193,3p,10,T>G,1284,1358,2642,6484393,6362640,12847033,0.0002056505965229
DAL193,3p,11,T>G,1476,1132,2608,6484398,6362639,12847037,0.0002030040078502
DAL193,3p,12,T>G,1424,1462,2886,6484368,6362594,12846962,0.0002246445502057
DAL193,3p,13,T>G,1266,1108,2374,6484385,6362543,12846928,0.0001847912590465
DAL193,3p,14,T>G,1358,1048,2406,6484363,6362486,12846849,0.0001872832785689
DAL193,3p,15,T>G,1417,1431,2848,6484332,6362438,12846770,0.0002216899656489
DAL193,3p,16,T>G,1147,1051,2198,6484341,6362460,12846801,0.0001710931772041
DAL193,3p,17,T>G,1433,1425,2858,6484294,6362445,12846739,0.0002224689082575
DAL193,3p,18,T>G,1297,1178,2475,6484244,6362380,12846624,0.0001926576196205
DAL193,3p,19,T>G,1228,1063,2291,6484265,6362400,12846665,0.0001783342213718
DAL193,3p,20,T>G,1179,1183,2362,6484261,6362382,12846643,0.0001838612624325
DAL193,3p,21,T>G,1234,1707,2941,6484248,6362443,12846691,0.0002289305471735
DAL193,3p,22,T>G,1310,1344,2654,6484224,6362407,12846631,0.0002065911288336
DAL193,3p,23,T>G,1434,1451,2885,6484218,6362399,12846617,0.0002245727416019
DAL193,3p,24,T>G,1552,1670,3222,6484164,6362319,12846483,0.000250807944867
DAL193,3p,25,T>G,1345,1336,2681,6484128,6362355,12846483,0.0002086952514552
DAL193,5p,1,T>G,10,42,52,6484405,6362696,12847101,4.047605759462777e-06
DAL193,5p,2,T>G,36,38,74,6484386,6362681,12847067,5.760069594094901e-06
DAL193,5p,3,T>G,785,253,1038,6484400,6362696,12847096,8.079646949006998e-05
DAL193,5p,4,T>G,205,231,436,6484403,6362696,12847099,3.3937622804961646e-05
DAL193,5p,5,T>G,957,1107,2064,6484403,6362696,12847099,0.0001606588382326
DAL193,5p,6,T>G,820,769,1589,6484404,6362696,12847100,0.000123685501008
DAL193,5p,7,T>G,747,636,1383,6484404,6362696,12847100,0.0001076507538666
DAL193,5p,8,T>G,1911,856,2767,6484314,6362693,12847007,0.0002153809054513
DAL193,5p,9,T>G,1313,1202,2515,6484295,6362695,12846990,0.0001957657007594
DAL193,5p,10,T>G,1221,1277,2498,6484284,6362694,12846978,0.0001944426152204
DAL193,5p,11,T>G,1439,1798,3237,6484315,6362677,12846992,0.0002519655963045
DAL193,5p,12,T>G,1632,1404,3036,6484218,6362670,12846888,0.0002363218236198
DAL193,5p,13,T>G,1779,1279,3058,6484143,6362652,12846795,0.0002380360237709
DAL193,5p,14,T>G,1135,1237,2372,6484145,6362627,12846772,0.000184637821859
DAL193,5p,15,T>G,1211,1510,2721,6484166,6362534,12846700,0.0002118053663586
DAL193,5p,16,T>G,1134,1745,2879,6484111,6362519,12846630,0.0002241054657914
DAL193,5p,17,T>G,1412,1254,2666,6484043,6362598,12846641,0.0002075250643339
DAL193,5p,18,T>G,1532,1317,2849,6483967,6362571,12846538,0.000221771811207
DAL193,5p,19,T>G,1638,1872,3510,6483980,6362593,12846573,0.0002732246179584
DAL193,5p,20,T>G,1118,1483,2601,6483952,6362554,12846506,0.0002024675036153
DAL193,5p,21,T>G,1335,1454,2789,6484003,6362532,12846535,0.0002171013428912
DAL193,5p,22,T>G,1504,1703,3207,6484010,6362499,12846509,0.0002496398048683
DAL193,5p,23,T>G,1124,1432,2556,6483966,6362463,12846429,0.0001989657981996
DAL193,5p,24,T>G,1769,1529,3298,6483905,6362426,12846331,0.0002567269985492
DAL193,5p,25,T>G,1905,1702,3607,6483942,6362403,12846345,0.0002807802530603
DAL195,3p,1,T>G,16,4,20,2363278,2267461,4630739,4.318965072313512e-06
DAL195,3p,2,T>G,18,4,22,2363278,2267460,4630738,4.750862605485346e-06
DAL195,3p,3,T>G,55,18,73,2363278,2267461,4630739,1.576422251394432e-05
DAL195,3p,4,T>G,68,56,124,2363278,2267461,4630739,2.677758344834377e-05
DAL195,3p,5,T>G,208,263,471,2363278,2267461,4630739,0.0001017116274529
DAL195,3p,6,T>G,157,256,413,2363278,2267461,4630739,8.918662874327402e-05
DAL195,3p,7,T>G,293,182,475,2363278,2267461,4630739,0.0001025754204674
DAL195,3p,8,T>G,244,210,454,2363278,2267413,4630691,9.804152339251312e-05
DAL195,3p,9,T>G,183,392,575,2363276,2267438,4630714,0.0001241709161913
DAL195,3p,10,T>G,197,228,425,2363274,2267432,4630706,9.177866182823958e-05
DAL195,3p,11,T>G,223,306,529,2363274,2267431,4630705,0.0001142374649216
DAL195,3p,12,T>G,193,245,438,2363273,2267414,4630687,9.458639722356533e-05
DAL195,3p,13,T>G,190,321,511,2363269,2267412,4630681,0.0001103509397429
DAL195,3p,14,T>G,213,277,490,2363250,2267410,4630660,0.000105816449491
DAL195,3p,15,T>G,246,325,571,2363254,2267411,4630665,0.0001233084233042
DAL195,3p,16,T>G,469,297,766,2363259,2267394,4630653,0.0001654194343648
DAL195,3p,17,T>G,236,391,627,2363234,2267398,4630632,0.0001354026836941
DAL195,3p,18,T>G,359,494,853,2363236,2267374,4630610,0.0001842089919038
DAL195,3p,19,T>G,247,320,567,2363215,2267369,4630584,0.0001224467583354
DAL195,3p,20,T>G,501,345,846,2363222,2267380,4630602,0.0001826976276518
DAL195,3p,21,T>G,256,409,665,2363235,2267382,4630617,0.0001436093721419
DAL195,3p,22,T>G,276,273,549,2363231,2267383,4630614,0.0001185587915555
DAL195,3p,23,T>G,188,295,483,2363219,2267370,4630589,0.0001043063852136
DAL195,3p,24,T>G,217,520,737,2363198,2267373,4630571,0.000159159637116
DAL195,3p,25,T>G,234,334,568,2363180,2267377,4630557,0.0001226634290432
DAL195,5p,1,T>G,6,7,13,2363278,2267461,4630739,2.807327297003783e-06
DAL195,5p,2,T>G,6,4,10,2363264,2267447,4630711,2.159495593657216e-06
DAL195,5p,3,T>G,78,45,123,2363278,2267459,4630737,2.656164666661052e-05
DAL195,5p,4,T>G,44,77,121,2363278,2267461,4630739,2.6129738687496747e-05
DAL195,5p,5,T>G,176,245,421,2363277,2267461,4630738,9.091423440496956e-05
DAL195,5p,6,T>G,122,186,308,2363277,2267461,4630738,6.651207647679484e-05
DAL195,5p,7,T>G,154,105,259,2363277,2267461,4630738,5.593060976457748e-05
DAL195,5p,8,T>G,226,252,478,2363212,2267460,4630672,0.0001032247587391
DAL195,5p,9,T>G,178,234,412,2363181,2267461,4630642,8.897254419581561e-05
DAL195,5p,10,T>G,225,251,476,2363146,2267458,4630604,0.0001027943654866
DAL195,5p,11,T>G,244,338,582,2362948,2267450,4630398,0.0001256911392929
DAL195,5p,12,T>G,209,291,500,2362864,2267454,4630318,0.0001079839440833
DAL195,5p,13,T>G,206,218,424,2363073,2267445,4630518,9.156642950097592e-05
DAL195,5p,14,T>G,207,285,492,2363094,2267434,4630528,0.0001062513821318
DAL195,5p,15,T>G,207,254,461,2363178,2267432,4630610,9.955491825051128e-05
DAL195,5p,16,T>G,219,273,492,2363170,2267429,4630599,0.0001062497530017
DAL195,5p,17,T>G,233,265,498,2363159,2267431,4630590,0.0001075456907219
DAL195,5p,18,T>G,224,264,488,2363182,2267420,4630602,0.0001053858655958
DAL195,5p,19,T>G,315,277,592,2363138,2267420,4630558,0.0001278463632244
DAL195,5p,20,T>G,266,224,490,2363110,2267401,4630511,0.0001058198544393
DAL195,5p,21,T>G,269,295,564,2363086,2267400,4630486,0.0001218014696513
DAL195,5p,22,T>G,239,264,503,2363094,2267388,4630482,0.0001086280002816
DAL195,5p,23,T>G,281,322,603,2363068,2267398,4630466,0.0001302244741673
DAL195,5p,24,T>G,259,322,581,2363067,2267402,4630469,0.0001254732511976
DAL195,5p,25,T>G,269,236,505,2363135,2267374,4630509,0.0001090592848431
DAL212,3p,1,T>G,11,6,17,4131322,4008153,8139475,2.088586794602846e-06
DAL212,3p,2,T>G,80,9,89,4131322,4008153,8139475,1.0934366159979606e-05
DAL212,3p,3,T>G,58,56,114,4131322,4008153,8139475,1.4005817328513205e-05
DAL212,3p,4,T>G,78,77,155,4131322,4008153,8139475,1.9042997244908303e-05
DAL212,3p,5,T>G,366,330,696,4131322,4008151,8139473,8.550922154296722e-05
DAL212,3p,6,T>G,396,407,803,4131322,4008151,8139473,9.865503577442912e-05
DAL212,3p,7,T>G,438,337,775,4131322,4008153,8139475,9.521498622454153e-05
DAL212,3p,8,T>G,416,528,944,4131319,4008093,8139412,0.000115978893807
DAL212,3p,9,T>G,608,462,1070,4131316,4008115,8139431,0.0001314588206472
DAL212,3p,10,T>G,451,431,882,4131317,4008102,8139419,0.0001083615427587
DAL212,3p,11,T>G,488,456,944,4131313,4008105,8139418,0.0001159788083128
DAL212,3p,12,T>G,590,603,1193,4131314,4008034,8139348,0.0001465719367202
DAL212,3p,13,T>G,473,567,1040,4131307,4007923,8139230,0.0001277762147033
DAL212,3p,14,T>G,460,484,944,4131271,4007904,8139175,0.0001159822709304
DAL212,3p,15,T>G,516,582,1098,4131254,4007935,8139189,0.0001349028754584
DAL212,3p,16,T>G,551,492,1043,4131236,4007982,8139218,0.0001281449888674
DAL212,3p,17,T>G,527,398,925,4131249,4007981,8139230,0.000113647114039
DAL212,3p,18,T>G,597,486,1083,4131222,4007954,8139176,0.0001330601525264
DAL212,3p,19,T>G,523,527,1050,4131233,4007956,8139189,0.0001290054819958
DAL212,3p,20,T>G,520,586,1106,4131221,4007928,8139149,0.0001358864421821
DAL212,3p,21,T>G,497,505,1002,4131228,4007917,8139145,0.0001231087540521
DAL212,3p,22,T>G,555,507,1062,4131183,4007898,8139081,0.0001304815617389
DAL212,3p,23,T>G,572,462,1034,4131172,4007904,8139076,0.0001270414479481
DAL212,3p,24,T>G,555,520,1075,4131124,4007904,8139028,0.0001320796537375
DAL212,3p,25,T>G,562,451,1013,4131071,4007924,8138995,0.0001244625411368
DAL212,5p,1,T>G,1,9,10,4131322,4008153,8139475,1.2285804674134389e-06
DAL212,5p,2,T>G,10,3,13,4131307,4008143,8139450,1.5971595132349237e-06
DAL212,5p,3,T>G,662,120,782,4131321,4008153,8139474,9.607500435531828e-05
DAL212,5p,4,T>G,152,141,293,4131322,4008153,8139475,3.599740769521376e-05
DAL212,5p,5,T>G,522,470,992,4131322,4008153,8139475,0.0001218751823674
DAL212,5p,6,T>G,361,320,681,4131322,4008153,8139475,8.366632983085518e-05
DAL212,5p,7,T>G,256,272,528,4131322,4008153,8139475,6.486904867942957e-05
DAL212,5p,8,T>G,586,406,992,4131248,4008153,8139401,0.0001218762904051
DAL212,5p,9,T>G,483,399,882,4131243,4008153,8139396,0.0001083618489627
DAL212,5p,10,T>G,521,531,1052,4131179,4008148,8139327,0.0001292490153055
DAL212,5p,11,T>G,509,686,1195,4131234,4008143,8139377,0.0001468171335471
DAL212,5p,12,T>G,683,509,1192,4131187,4008141,8139328,0.0001464494366119
DAL212,5p,13,T>G,448,503,951,4131181,4008142,8139323,0.000116840184374
DAL212,5p,14,T>G,445,495,940,4131134,4008108,8139242,0.0001154898699412
DAL212,5p,15,T>G,587,531,1118,4131156,4008091,8139247,0.0001373591439109
DAL212,5p,16,T>G,776,556,1332,4131154,4008081,8139235,0.0001636517436835
DAL212,5p,17,T>G,510,555,1065,4131159,4008081,8139240,0.0001308475975643
DAL212,5p,18,T>G,604,754,1358,4131113,4008066,8139179,0.0001668472950404
DAL212,5p,19,T>G,536,577,1113,4131040,4008052,8139092,0.0001367474406235
DAL212,5p,20,T>G,659,624,1283,4131020,4008040,8139060,0.0001576349111568
DAL212,5p,21,T>G,513,446,959,4130973,4008040,8139013,0.0001178275547661
DAL212,5p,22,T>G,566,492,1058,4131015,4007967,8138982,0.000129991686921
DAL212,5p,23,T>G,799,514,1313,4131005,4007962,8138967,0.0001613226838246
DAL212,5p,24,T>G,584,498,1082,4131060,4007918,8138978,0.0001329405239822
DAL212,5p,25,T>G,1026,617,1643,4131016,4007614,8138630,0.0002018767286386
DAL218,3p,1,T>G,34,35,69,6952891,6658031,13610922,5.069458189533376e-06
DAL218,3p,2,T>G,55,63,118,6952891,6658031,13610922,8.669508208187513e-06
DAL218,3p,3,T>G,106,123,229,6952891,6658030,13610921,1.6824724792686697e-05
DAL218,3p,4,T>G,218,382,600,6952891,6658031,13610922,4.408224512637719e-05
DAL218,3p,5,T>G,784,1388,2172,6952891,6658031,13610922,0.0001595777273574
DAL218,3p,6,T>G,785,1074,1859,6952891,6658030,13610921,0.0001365814995179
DAL218,3p,7,T>G,737,1009,1746,6952891,6658026,13610917,0.0001282793804414
DAL218,3p,8,T>G,1000,983,1983,6952887,6657945,13610832,0.0001456927835124
DAL218,3p,9,T>G,1027,1115,2142,6952882,6657945,13610827,0.0001573747135276
DAL218,3p,10,T>G,1036,1197,2233,6952881,6657960,13610841,0.000164060398619
DAL218,3p,11,T>G,1221,1728,2949,6952866,6657905,13610771,0.0002166666385026
DAL218,3p,12,T>G,1374,2031,3405,6952858,6657882,13610740,0.0002501700862701
DAL218,3p,13,T>G,1011,1353,2364,6952870,6657811,13610681,0.000173687121166
DAL218,3p,14,T>G,2305,1139,3444,6952816,6657779,13610595,0.0002530381662227
DAL218,3p,15,T>G,1017,1432,2449,6952788,6657738,13610526,0.0001799342655823
DAL218,3p,16,T>G,2548,1230,3778,6952760,6657689,13610449,0.0002775808498308
DAL218,3p,17,T>G,842,1180,2022,6952737,6657651,13610388,0.0001485629946773
DAL218,3p,18,T>G,960,1155,2115,6952711,6657672,13610383,0.0001553960678402
DAL218,3p,19,T>G,1371,1402,2773,6952716,6657697,13610413,0.0002037410620823
DAL218,3p,20,T>G,1204,2426,3630,6952697,6657752,13610449,0.0002667068514785
DAL218,3p,21,T>G,1199,1654,2853,6952660,6657692,13610352,0.000209619854064
DAL218,3p,22,T>G,1180,1538,2718,6952654,6657637,13610291,0.0001997018285648
DAL218,3p,23,T>G,1148,1249,2397,6952651,6657632,13610283,0.0001761168375411
DAL218,3p,24,T>G,1071,2094,3165,6952669,6657588,13610257,0.0002325452046937
DAL218,3p,25,T>G,1242,1401,2643,6952605,6657566,13610171,0.0001941930046286
DAL218,5p,1,T>G,13,57,70,6952891,6658031,13610922,5.1429285980773385e-06
DAL218,5p,2,T>G,31,59,90,6952874,6658014,13610888,6.6123532865746896e-06
DAL218,5p,3,T>G,651,347,998,6952891,6658031,13610922,7.332346772687405e-05
DAL218,5p,4,T>G,253,368,621,6952891,6658031,13610922,4.562512370580039e-05
DAL218,5p,5,T>G,985,1142,2127,6952891,6658031,13610922,0.000156271558973
DAL218,5p,6,T>G,769,786,1555,6952891,6658031,13610922,0.0001142464852858
DAL218,5p,7,T>G,493,766,1259,6952888,6658031,13610919,9.249926474472444e-05
DAL218,5p,8,T>G,700,895,1595,6952719,6658029,13610748,0.0001171867997262
DAL218,5p,9,T>G,1201,948,2149,6952736,6658029,13610765,0.0001578897291959
DAL218,5p,10,T>G,1076,1432,2508,6952716,6658028,13610744,0.0001842661944122
DAL218,5p,11,T>G,1090,1206,2296,6952715,6658016,13610731,0.000168690425224
DAL218,5p,12,T>G,1037,1146,2183,6952625,6658005,13610630,0.0001603893427416
DAL218,5p,13,T>G,1461,1071,2532,6952475,6658005,13610480,0.0001860331156579
DAL218,5p,14,T>G,1002,925,1927,6952554,6657955,13610509,0.0001415817733194
DAL218,5p,15,T>G,1258,1247,2505,6952449,6657923,13610372,0.0001840508106611
DAL218,5p,16,T>G,1004,1452,2456,6952253,6657920,13610173,0.0001804532536066
DAL218,5p,17,T>G,1177,998,2175,6952350,6657874,13610224,0.0001598063338266
DAL218,5p,18,T>G,1952,1023,2975,6952457,6657843,13610300,0.0002185844544205
DAL218,5p,19,T>G,1464,1285,2749,6952296,6657770,13610066,0.0002019828559244
DAL218,5p,20,T>G,2275,1106,3381,6952289,6657772,13610061,0.0002484191657921
DAL218,5p,21,T>G,1349,1204,2553,6952371,6657729,13610100,0.0001875812815482
DAL218,5p,22,T>G,1439,1269,2708,6952322,6657786,13610108,0.0001989697657064
DAL218,5p,23,T>G,1225,1209,2434,6952288,6657745,13610033,0.0001788386552773
DAL218,5p,24,T>G,2381,1417,3798,6952375,6657772,13610147,0.0002790565010061
DAL218,5p,25,T>G,2010,1353,3363,6952272,6657720,13609992,0.0002470978675079
DAL224,3p,1,T>G,54,18,72,4609472,4586477,9195949,7.829534504812934e-06
DAL224,3p,2,T>G,97,21,118,4609471,4586476,9195947,1.2831739895847594e-05
DAL224,3p,3,T>G,500,87,587,4609472,4586477,9195949,6.383245492118322e-05
DAL224,3p,4,T>G,332,84,416,4609472,4586477,9195949,4.523731047225251e-05
DAL224,3p,5,T>G,428,280,708,4609472,4586477,9195949,7.699042263066052e-05
DAL224,3p,6,T>G,441,367,808,4609472,4586477,9195949,8.786477610956737e-05
DAL224,3p,7,T>G,447,345,792,4609472,4586476,9195948,8.612488891846713e-05
DAL224,3p,8,T>G,826,424,1250,4609469,4586423,9195892,0.0001359302610339
DAL224,3p,9,T>G,1064,585,1649,4609466,4586431,9195897,0.0001793191028564
DAL224,3p,10,T>G,437,475,912,4609461,4586371,9195832,9.917536553516854e-05
DAL224,3p,11,T>G,643,1241,1884,4609461,4586382,9195843,0.0002048751811008
DAL224,3p,12,T>G,988,817,1805,4609458,4586384,9195842,0.0001962843641724
DAL224,3p,13,T>G,619,513,1132,4609454,4586364,9195818,0.0001230994349822
DAL224,3p,14,T>G,1392,1481,2873,4609412,4586293,9195705,0.0003124284652454
DAL224,3p,15,T>G,574,905,1479,4609400,4586272,9195672,0.0001608365326644
DAL224,3p,16,T>G,579,690,1269,4609379,4586240,9195619,0.0001380004978457
DAL224,3p,17,T>G,786,639,1425,4609381,4586216,9195597,0.0001549654687999
DAL224,3p,18,T>G,681,1325,2006,4609363,4586282,9195645,0.0002181467422894
DAL224,3p,19,T>G,1146,742,1888,4609353,4586195,9195548,0.0002053167467561
DAL224,3p,20,T>G,1363,1527,2890,4609344,4586225,9195569,0.0003142818024637
DAL224,3p,21,T>G,1218,900,2118,4609343,4586223,9195566,0.0002303283995786
DAL224,3p,22,T>G,913,1100,2013,4609324,4586172,9195496,0.0002189115192916
DAL224,3p,23,T>G,1383,1086,2469,4609323,4586083,9195406,0.0002685036419272
DAL224,3p,24,T>G,905,1034,1939,4609325,4586202,9195527,0.0002108633904288
DAL224,3p,25,T>G,1920,1466,3386,4609265,4586173,9195438,0.0003682260703622
DAL224,5p,1,T>G,3,19,22,4609472,4586477,9195949,2.392357765359508e-06
DAL224,5p,2,T>G,27,36,63,4609461,4586469,9195930,6.850856846452724e-06
DAL224,5p,3,T>G,298,315,613,4609468,4586477,9195945,6.665981582099501e-05
DAL224,5p,4,T>G,165,133,298,4609471,4586477,9195948,3.24055768910394e-05
DAL224,5p,5,T>G,615,273,888,4609471,4586477,9195948,9.656426939343285e-05
DAL224,5p,6,T>G,815,176,991,4609472,4586477,9195949,0.0001077648429759
DAL224,5p,7,T>G,279,218,497,4609471,4586477,9195948,5.404554266727041e-05
DAL224,5p,8,T>G,354,268,622,4609397,4586477,9195874,6.763903028684385e-05
DAL224,5p,9,T>G,737,340,1077,4609357,4586473,9195830,0.0001171183025349
DAL224,5p,10,T>G,599,466,1065,4609338,4586470,9195808,0.0001158136403021
DAL224,5p,11,T>G,592,412,1004,4609388,4586469,9195857,0.0001091796012051
DAL224,5p,12,T>G,527,447,974,4609357,4586464,9195821,0.0001059176771709
DAL224,5p,13,T>G,427,670,1097,4609320,4586461,9195781,0.0001192938370324
DAL224,5p,14,T>G,476,673,1149,4609270,4586428,9195698,0.0001249497319289
DAL224,5p,15,T>G,468,648,1116,4609299,4586416,9195715,0.0001213608729718
DAL224,5p,16,T>G,706,532,1238,4609292,4586373,9195665,0.0001346286538276
DAL224,5p,17,T>G,502,609,1111,4609285,4586385,9195670,0.0001208177326937
DAL224,5p,18,T>G,1579,495,2074,4609226,4586351,9195577,0.0002255432149608
DAL224,5p,19,T>G,695,491,1186,4609203,4586337,9195540,0.0001289755685908
DAL224,5p,20,T>G,457,958,1415,4609148,4586313,9195461,0.0001538802676668
DAL224,5p,21,T>G,616,651,1267,4609195,4586347,9195542,0.0001377841567141
DAL224,5p,22,T>G,642,819,1461,4609138,4586312,9195450,0.0001588829257948
DAL224,5p,23,T>G,848,614,1462,4609100,4586313,9195413,0.0001589923149726
DAL224,5p,24,T>G,724,951,1675,4609109,4586316,9195425,0.0001821558003028
DAL224,5p,25,T>G,606,1142,1748,4609125,4586257,9195382,0.0001900954196356
DAL227,3p,1,T>G,17,17,34,3765386,3771243,7536629,4.511300742016093e-06
DAL227,3p,2,T>G,23,48,71,3765386,3771243,7536629,9.420657431857134e-06
DAL227,3p,3,T>G,99,81,180,3765386,3771243,7536629,2.388335686949696e-05
DAL227,3p,4,T>G,104,261,365,3765386,3771243,7536629,4.843014031870217e-05
DAL227,3p,5,T>G,275,331,606,3765386,3771243,7536629,8.040730146063977e-05
DAL227,3p,6,T>G,248,302,550,3765386,3771243,7536629,7.297692376790737e-05
DAL227,3p,7,T>G,176,291,467,3765386,3771243,7536629,6.196404254475044e-05
DAL227,3p,8,T>G,228,298,526,3765386,3771207,7536593,6.979280956262332e-05
DAL227,3p,9,T>G,330,467,797,3765384,3771218,7536602,0.0001057505756573
DAL227,3p,10,T>G,351,443,794,3765382,3771209,7536591,0.0001053526720502
DAL227,3p,11,T>G,337,456,793,3765378,3771214,7536592,0.0001052199721041
DAL227,3p,12,T>G,345,494,839,3765377,3771173,7536550,0.0001113241469903
DAL227,3p,13,T>G,287,502,789,3765373,3771183,7536556,0.0001046897283056
DAL227,3p,14,T>G,385,452,837,3765341,3771166,7536507,0.0001110594072293
DAL227,3p,15,T>G,451,461,912,3765341,3771186,7536527,0.000121010645885
DAL227,3p,16,T>G,362,366,728,3765340,3771079,7536419,9.659760159301122e-05
DAL227,3p,17,T>G,306,582,888,3765328,3771049,7536377,0.0001178285003523
DAL227,3p,18,T>G,408,571,979,3765321,3771036,7536357,0.0001299036125809
DAL227,3p,19,T>G,334,690,1024,3765313,3771111,7536424,0.0001358734593488
DAL227,3p,20,T>G,460,592,1052,3765308,3771082,7536390,0.0001395893789997
DAL227,3p,21,T>G,575,482,1057,3765307,3771104,7536411,0.0001402524358079
DAL227,3p,22,T>G,390,577,967,3765309,3771137,7536446,0.0001283098160591
DAL227,3p,23,T>G,502,429,931,3765319,3771112,7536431,0.0001235332745698
DAL227,3p,24,T>G,401,505,906,3765312,3771081,7536393,0.0001202166606757
DAL227,3p,25,T>G,396,942,1338,3765249,3771100,7536349,0.0001775395486594
DAL227,5p,1,T>G,5,8,13,3765386,3771243,7536629,1.724909107241447e-06
DAL227,5p,2,T>G,5,8,13,3765373,3771238,7536611,1.7249132269132638e-06
DAL227,5p,3,T>G,379,171,550,3765386,3771243,7536629,7.297692376790737e-05
DAL227,5p,4,T>G,49,159,208,3765385,3771243,7536628,2.75985493777854e-05
DAL227,5p,5,T>G,218,302,520,3765386,3771242,7536628,6.899637344446349e-05
DAL227,5p,6,T>G,140,214,354,3765386,3771243,7536629,4.697060184334402e-05
DAL227,5p,7,T>G,154,272,426,3765386,3771243,7536629,5.6523944591142806e-05
DAL227,5p,8,T>G,256,308,564,3765342,3771242,7536584,7.483496501863444e-05
DAL227,5p,9,T>G,251,287,538,3765324,3771243,7536567,7.138528722692971e-05
DAL227,5p,10,T>G,315,258,573,3765318,3771238,7536556,7.602942245768491e-05
DAL227,5p,11,T>G,284,359,643,3765365,3771237,7536602,8.531696379880482e-05
DAL227,5p,12,T>G,297,232,529,3765326,3771232,7536558,7.01911933803203e-05
DAL227,5p,13,T>G,308,271,579,3765325,3771231,7536556,7.682554206457167e-05
DAL227,5p,14,T>G,487,196,683,3765297,3771226,7536523,9.0625345401321e-05
DAL227,5p,15,T>G,377,345,722,3765318,3771201,7536519,9.580019635059634e-05
DAL227,5p,16,T>G,306,260,566,3765316,3771188,7536504,7.510113442519237e-05
DAL227,5p,17,T>G,231,502,733,3765326,3771175,7536501,9.725998842168268e-05
DAL227,5p,18,T>G,359,358,717,3765280,3771169,7536449,9.513764373645996e-05
DAL227,5p,19,T>G,331,611,942,3765279,3771164,7536443,0.0001249926523692
DAL227,5p,20,T>G,294,439,733,3765254,3771167,7536421,9.726102084795952e-05
DAL227,5p,21,T>G,309,726,1035,3765270,3771169,7536439,0.0001373327641874
DAL227,5p,22,T>G,342,707,1049,3765253,3771158,7536411,0.0001391909225757
DAL227,5p,23,T>G,446,674,1120,3765254,3771157,7536411,0.0001486118525117
DAL227,5p,24,T>G,513,622,1135,3765270,3771180,7536450,0.0001506014104784
DAL227,5p,25,T>G,398,721,1119,3765247,3771148,7536395,0.0001484794785835
WA02,3p,1,T>G,19,28,47,6552698,6754258,13306956,3.5319873305359997e-06
WA02,3p,2,T>G,116,52,168,6552698,6754258,13306956,1.262497599000102e-05
WA02,3p,3,T>G,63,63,126,6552698,6754258,13306956,9.468731992500764e-06
WA02,3p,4,T>G,60,115,175,6552698,6754256,13306954,1.315101863281409e-05
WA02,3p,5,T>G,306,530,836,6552698,6754256,13306954,6.282429472590046e-05
WA02,3p,6,T>G,364,540,904,6552698,6754257,13306955,6.793439971804218e-05
WA02,3p,7,T>G,331,455,786,6552698,6754257,13306955,5.906685639201456e-05
WA02,3p,8,T>G,433,536,969,6552692,6754207,13306899,7.281936986220457e-05
WA02,3p,9,T>G,458,566,1024,6552688,6754191,13306879,7.695267988834948e-05
WA02,3p,10,T>G,427,735,1162,6552680,6754207,13306887,8.732320339084566e-05
WA02,3p,11,T>G,452,657,1109,6552667,6754202,13306869,8.334041614146799e-05
WA02,3p,12,T>G,482,588,1070,6552670,6754189,13306859,8.040965940948198e-05
WA02,3p,13,T>G,415,667,1082,6552675,6754177,13306852,8.131149275576221e-05
WA02,3p,14,T>G,502,630,1132,6552653,6754155,13306808,8.50692367395697e-05
WA02,3p,15,T>G,568,667,1235,6552632,6754146,13306778,9.280984472725102e-05
WA02,3p,16,T>G,548,695,1243,6552629,6754119,13306748,9.341125269675204e-05
WA02,3p,17,T>G,550,731,1281,6552608,6754116,13306724,9.626712029196667e-05
WA02,3p,18,T>G,505,688,1193,6552611,6754085,13306696,8.965411098292168e-05
WA02,3p,19,T>G,541,625,1166,6552605,6754056,13306661,8.762528781638008e-05
WA02,3p,20,T>G,529,700,1229,6552618,6754033,13306651,9.235982817915644e-05
WA02,3p,21,T>G,556,779,1335,6552597,6754089,13306686,0.000100325505539
WA02,3p,22,T>G,648,652,1300,6552593,6754062,13306655,9.769547643641473e-05
WA02,3p,23,T>G,523,614,1137,6552585,6754052,13306637,8.544608228209727e-05
WA02,3p,24,T>G,556,761,1317,6552556,6754026,13306582,9.897357563347222e-05
WA02,3p,25,T>G,679,808,1487,6552517,6754038,13306555,0.000111749434771
WA02,5p,1,T>G,121,47,168,6552698,6754258,13306956,1.262497599000102e-05
WA02,5p,2,T>G,125,40,165,6552562,6754179,13306741,1.2399730332167734e-05
WA02,5p,3,T>G,258,251,509,6552698,6754258,13306956,3.82506713030388e-05
WA02,5p,4,T>G,234,242,476,6552698,6754258,13306956,3.577076530500289e-05
WA02,5p,5,T>G,465,688,1153,6552698,6754258,13306956,8.664641259804271e-05
WA02,5p,6,T>G,470,558,1028,6552697,6754258,13306955,7.725283507759664e-05
WA02,5p,7,T>G,422,449,871,6552685,6754258,13306943,6.545455255951724e-05
WA02,5p,8,T>G,423,559,982,6552655,6754257,13306912,7.379623461852006e-05
WA02,5p,9,T>G,635,646,1281,6552662,6754226,13306888,9.626593385320444e-05
WA02,5p,10,T>G,651,715,1366,6552618,6754222,13306840,0.0001026539734452
WA02,5p,11,T>G,648,733,1381,6552625,6754225,13306850,0.0001037811352799
WA02,5p,12,T>G,700,721,1421,6552628,6754236,13306864,0.0001067869935395
WA02,5p,13,T>G,676,661,1337,6552614,6754205,13306819,0.0001004748016787
WA02,5p,14,T>G,698,725,1423,6552607,6754183,13306790,0.0001069378865977
WA02,5p,15,T>G,747,712,1459,6552586,6754168,13306754,0.0001096435689725
WA02,5p,16,T>G,642,730,1372,6552525,6754178,13306703,0.0001031059308981
WA02,5p,17,T>G,693,763,1456,6552567,6754148,13306715,0.0001094184402386
WA02,5p,18,T>G,608,678,1286,6552548,6754087,13306635,9.664351656147478e-05
WA02,5p,19,T>G,690,893,1583,6552516,6754124,13306640,0.0001189631642548
WA02,5p,20,T>G,483,873,1356,6552507,6754132,13306639,0.0001019040194898
WA02,5p,21,T>G,573,782,1355,6552521,6754152,13306673,0.0001018286088491
WA02,5p,22,T>G,693,858,1551,6552516,6754117,13306633,0.0001165584111322
WA02,5p,23,T>G,609,710,1319,6552465,6754131,13306596,9.912377290179998e-05
WA02,5p,24,T>G,605,844,1449,6552457,6754135,13306592,0.0001088933965962
WA02,5p,25,T>G,694,753,1447,6552470,6754083,13306553,0.0001087434138653
WA03,3p,1,T>G,36,67,103,5399458,5543742,10943200,9.412237736676656e-06
WA03,3p,2,T>G,60,39,99,5399458,5543742,10943200,9.046713941077563e-06
WA03,3p,3,T>G,74,177,251,5399458,5543742,10943200,2.293661817384312e-05
WA03,3p,4,T>G,102,317,419,5399458,5543736,10943194,3.82886385821178e-05
WA03,3p,5,T>G,682,870,1552,5399458,5543740,10943198,0.0001418232586123
WA03,3p,6,T>G,719,1081,1800,5399458,5543741,10943199,0.0001644857230504
WA03,3p,7,T>G,707,933,1640,5399458,5543739,10943197,0.0001498647972799
WA03,3p,8,T>G,810,1169,1979,5399449,5543673,10943122,0.0001808441868782
WA03,3p,9,T>G,1063,1394,2457,5399436,5543670,10943106,0.0002245249200729
WA03,3p,10,T>G,931,1469,2400,5399438,5543654,10943092,0.0002193164418246
WA03,3p,11,T>G,937,1270,2207,5399404,5543644,10943048,0.0002016805555454
WA03,3p,12,T>G,1185,1409,2594,5399397,5543595,10942992,0.0002370466870486
WA03,3p,13,T>G,936,1292,2228,5399378,5543551,10942929,0.0002036017961918
WA03,3p,14,T>G,1017,1389,2406,5399356,5543493,10942849,0.0002198696153076
WA03,3p,15,T>G,1268,1493,2761,5399349,5543505,10942854,0.000252310777426
WA03,3p,16,T>G,1096,1713,2809,5399342,5543495,10942837,0.0002566976004485
WA03,3p,17,T>G,1006,1641,2647,5399346,5543438,10942784,0.0002418945672326
WA03,3p,18,T>G,1184,1528,2712,5399325,5543443,10942768,0.0002478349170886
WA03,3p,19,T>G,913,1622,2535,5399297,5543425,10942722,0.0002316608244274
WA03,3p,20,T>G,1210,1584,2794,5399252,5543409,10942661,0.000255330947381
WA03,3p,21,T>G,1201,1659,2860,5399248,5543303,10942551,0.0002613650144285
WA03,3p,22,T>G,1188,1842,3030,5399256,5543263,10942519,0.0002769015068651
WA03,3p,23,T>G,1115,1447,2562,5399255,5543267,10942522,0.0002341324970605
WA03,3p,24,T>G,1135,1747,2882,5399198,5543130,10942328,0.0002633808820207
WA03,3p,25,T>G,1177,1661,2838,5399050,5543142,10942192,0.0002593630234234
WA03,5p,1,T>G,142,76,218,5399457,5543742,10943199,1.992104868055493e-05
WA03,5p,2,T>G,178,96,274,5399258,5543638,10942896,2.503907557926165e-05
WA03,5p,3,T>G,818,404,1222,5399457,5543742,10943199,0.0001116675297598
WA03,5p,4,T>G,423,485,908,5399458,5543742,10943200,8.297390160099423e-05
WA03,5p,5,T>G,1103,1401,2504,5399456,5543740,10943196,0.0002288179796834
WA03,5p,6,T>G,913,987,1900,5399452,5543742,10943194,0.000173623898105
WA03,5p,7,T>G,804,1093,1897,5399453,5543742,10943195,0.0001733497392671
WA03,5p,8,T>G,1076,1467,2543,5399403,5543732,10943135,0.0002323831333525
WA03,5p,9,T>G,1411,1776,3187,5399319,5543732,10943051,0.0002912350495305
WA03,5p,10,T>G,1465,1541,3006,5399344,5543717,10943061,0.0002746946215505
WA03,5p,11,T>G,1367,1996,3363,5399321,5543705,10943026,0.0003073190176099
WA03,5p,12,T>G,1705,1654,3359,5399213,5543665,10942878,0.0003069576394802
WA03,5p,13,T>G,1264,1812,3076,5399156,5543662,10942818,0.0002810976112368
WA03,5p,14,T>G,1399,1428,2827,5399124,5543629,10942753,0.0002583444952106
WA03,5p,15,T>G,1644,2114,3758,5399092,5543505,10942597,0.0003434285298087
WA03,5p,16,T>G,1744,1776,3520,5399083,5543501,10942584,0.0003216790476545
WA03,5p,17,T>G,1529,1661,3190,5399113,5543491,10942604,0.0002915211041174
WA03,5p,18,T>G,1477,1795,3272,5399074,5543600,10942674,0.0002990128372644
WA03,5p,19,T>G,1391,1534,2925,5399071,5543546,10942617,0.0002673035161515
WA03,5p,20,T>G,1622,1766,3388,5399050,5543533,10942583,0.0003096161116621
WA03,5p,21,T>G,1569,1599,3168,5399034,5543509,10942543,0.0002895122276421
WA03,5p,22,T>G,1648,1690,3338,5398989,5543454,10942443,0.0003050507094256
WA03,5p,23,T>G,1579,2238,3817,5398935,5543457,10942392,0.0003488268378614
WA03,5p,24,T>G,1721,1892,3613,5398952,5543428,10942380,0.0003301841098554
WA03,5p,25,T>G,1710,2010,3720,5398991,5543444,10942435,0.0003399608953583
WA07,3p,1,T>G,25,44,69,5691729,6013979,11705708,5.894560158172406e-06
WA07,3p,2,T>G,45,93,138,5691729,6013979,11705708,1.1789120316344812e-05
WA07,3p,3,T>G,73,51,124,5691729,6013979,11705708,1.059312260309244e-05
WA07,3p,4,T>G,57,73,130,5691729,6013979,11705708,1.110569305162917e-05
WA07,3p,5,T>G,353,255,608,5691729,6013979,11705708,5.1940472118388736e-05
WA07,3p,6,T>G,338,409,747,5691729,6013979,11705708,6.3815020842823e-05
WA07,3p,7,T>G,296,378,674,5691729,6013979,11705708,5.757874705229278e-05
WA07,3p,8,T>G,345,449,794,5691713,6013800,11705513,6.783128599318971e-05
WA07,3p,9,T>G,461,513,974,5691720,6013901,11705621,8.320788790274348e-05
WA07,3p,10,T>G,496,611,1107,5691718,6013892,11705610,9.45700394938837e-05
WA07,3p,11,T>G,411,528,939,5691711,6013883,11705594,8.02180564266965e-05
WA07,3p,12,T>G,463,570,1033,5691705,6013884,11705589,8.824844268836024e-05
WA07,3p,13,T>G,532,516,1048,5691711,6013848,11705559,8.953011129156668e-05
WA07,3p,14,T>G,518,684,1202,5691695,6013877,11705572,0.0001026861395581
WA07,3p,15,T>G,544,681,1225,5691211,6013856,11705067,0.0001046555308055
WA07,3p,16,T>G,521,637,1158,5691636,6013850,11705486,9.892797274713754e-05
WA07,3p,17,T>G,474,559,1033,5691662,6013813,11705475,8.82493021428007e-05
WA07,3p,18,T>G,505,623,1128,5691639,6013769,11705408,9.636571403576876e-05
WA07,3p,19,T>G,629,637,1266,5691628,6013742,11705370,0.0001081554876095
WA07,3p,20,T>G,710,695,1405,5691604,6013772,11705376,0.0001200303176933
WA07,3p,21,T>G,739,607,1346,5691611,6013735,11705346,0.0001149901933697
WA07,3p,22,T>G,538,615,1153,5691577,6013736,11705313,9.85022784098127e-05
WA07,3p,23,T>G,557,584,1141,5691568,6013670,11705238,9.747772749259775e-05
WA07,3p,24,T>G,632,654,1286,5691554,6013661,11705215,0.0001098655599235
WA07,3p,25,T>G,589,798,1387,5691455,6013662,11705117,0.0001184951846273
WA07,5p,1,T>G,106,14,120,5691729,6013979,11705708,1.025140897073462e-05
WA07,5p,2,T>G,98,15,113,5691636,6013923,11705559,9.653532992315872e-06
WA07,5p,3,T>G,385,217,602,5691729,6013979,11705708,5.142790166985201e-05
WA07,5p,4,T>G,384,161,545,5691728,6013979,11705707,4.655848638617044e-05
WA07,5p,5,T>G,642,504,1146,5691729,6013978,11705707,9.790096403403911e-05
WA07,5p,6,T>G,427,472,899,5691728,6013979,11705707,7.680014543333436e-05
WA07,5p,7,T>G,433,285,718,5691728,6013979,11705707,6.133760224820252e-05
WA07,5p,8,T>G,486,312,798,5691579,6013975,11705554,6.817276653458691e-05
WA07,5p,9,T>G,611,475,1086,5691672,6013971,11705643,9.277576635474018e-05
WA07,5p,10,T>G,570,374,944,5691582,6013961,11705543,8.064555399095967e-05
WA07,5p,11,T>G,582,637,1219,5691326,6013942,11705268,0.0001041411439703
WA07,5p,12,T>G,577,522,1099,5691520,6013938,11705458,9.388782566218256e-05
WA07,5p,13,T>G,561,485,1046,5691511,6013949,11705460,8.936000806461259e-05
WA07,5p,14,T>G,472,552,1024,5691556,6013950,11705506,8.748019948902679e-05
WA07,5p,15,T>G,625,541,1166,5691563,6013633,11705196,9.961388087820145e-05
WA07,5p,16,T>G,610,945,1555,5691534,6013925,11705459,0.0001328440003933
WA07,5p,17,T>G,662,824,1486,5691561,6013916,11705477,0.00012694911963
WA07,5p,18,T>G,749,941,1690,5691474,6013905,11705379,0.0001443780675533
WA07,5p,19,T>G,650,508,1158,5691482,6013884,11705366,9.892898692787564e-05
WA07,5p,20,T>G,641,548,1189,5691421,6013876,11705297,0.0001015779437292
WA07,5p,21,T>G,636,664,1300,5691379,6013853,11705232,0.0001110614467103
WA07,5p,22,T>G,671,698,1369,5691396,6013861,11705257,0.0001169559967799
WA07,5p,23,T>G,679,1080,1759,5691314,6013795,11705109,0.0001502762597084
WA07,5p,24,T>G,842,921,1763,5691332,6013785,11705117,0.0001506178878861
WA07,5p,25,T>G,562,781,1343,5691334,6013719,11705053,0.0001147367722299
WA08,3p,1,T>G,14,36,50,6798117,7189085,13987202,3.574696354567554e-06
WA08,3p,2,T>G,62,40,102,6798117,7189085,13987202,7.29238056331781e-06
WA08,3p,3,T>G,49,68,117,6798117,7189085,13987202,8.364789469688077e-06
WA08,3p,4,T>G,52,106,158,6798117,7189081,13987198,1.1296043710827572e-05
WA08,3p,5,T>G,263,531,794,6798117,7189085,13987202,5.676617811053276e-05
WA08,3p,6,T>G,361,509,870,6798117,7189085,13987202,6.219971656947543e-05
WA08,3p,7,T>G,299,431,730,6798117,7189084,13987201,5.219057050799513e-05
WA08,3p,8,T>G,474,541,1015,6798110,7189053,13987163,7.256653833232657e-05
WA08,3p,9,T>G,429,592,1021,6798103,7189051,13987154,7.299555005971909e-05
WA08,3p,10,T>G,479,634,1113,6798074,7189042,13987116,7.957323010690695e-05
WA08,3p,11,T>G,430,741,1171,6798109,7189046,13987155,8.371966994002712e-05
WA08,3p,12,T>G,384,872,1256,6798091,7189018,13987109,8.979696948096994e-05
WA08,3p,13,T>G,325,728,1053,6798090,7189013,13987103,7.528363807716294e-05
WA08,3p,14,T>G,475,708,1183,6798067,7188981,13987048,8.457824696104568e-05
WA08,3p,15,T>G,444,725,1169,6798069,7188978,13987047,8.357732693684378e-05
WA08,3p,16,T>G,504,925,1429,6798049,7188961,13987010,0.0001021662242323
WA08,3p,17,T>G,519,733,1252,6798000,7188943,13986943,8.951205420655536e-05
WA08,3p,18,T>G,426,942,1368,6798023,7188956,13986979,9.780525158434856e-05
WA08,3p,19,T>G,530,762,1292,6798028,7188946,13986974,9.23716595169191e-05
WA08,3p,20,T>G,608,701,1309,6798009,7188917,13986926,9.358739725941212e-05
WA08,3p,21,T>G,499,1003,1502,6798010,7188926,13986936,0.0001073859206905
WA08,3p,22,T>G,551,780,1331,6798012,7188920,13986932,9.51602538712564e-05
WA08,3p,23,T>G,543,764,1307,6798009,7188864,13986873,9.344476066952206e-05
WA08,3p,24,T>G,549,805,1354,6798015,7188867,13986882,9.680499199178202e-05
WA08,3p,25,T>G,660,730,1390,6797966,7188892,13986858,9.937900277531952e-05
WA08,5p,1,T>G,89,71,160,6798116,7189085,13987201,1.1439029152437288e-05
WA08,5p,2,T>G,95,65,160,6797941,7188997,13986938,1.1439244243450568e-05
WA08,5p,3,T>G,289,331,620,6798117,7189084,13987201,4.4326237965694495e-05
WA08,5p,4,T>G,168,288,456,6798115,7189085,13987200,3.2601235415236785e-05
WA08,5p,5,T>G,486,776,1262,6798116,7189084,13987200,9.022534889041407e-05
WA08,5p,6,T>G,435,546,981,6798112,7189085,13987197,7.013556754795117e-05
WA08,5p,7,T>G,488,477,965,6798110,7189085,13987195,6.899167417055386e-05
WA08,5p,8,T>G,501,891,1392,6798069,7189064,13987133,9.952003745156352e-05
WA08,5p,9,T>G,504,1264,1768,6798054,7189067,13987121,0.0001264019950924
WA08,5p,10,T>G,601,922,1523,6798015,7189037,13987052,0.0001088864186677
WA08,5p,11,T>G,742,1547,2289,6797997,7189047,13987044,0.0001636514477254
WA08,5p,12,T>G,547,1063,1610,6798016,7189056,13987072,0.0001151062924391
WA08,5p,13,T>G,701,1010,1711,6797995,7189043,13987038,0.0001223275435442
WA08,5p,14,T>G,678,1495,2173,6797984,7189041,13987025,0.000155358269539
WA08,5p,15,T>G,650,858,1508,6797997,7189013,13987010,0.000107814322003
WA08,5p,16,T>G,746,886,1632,6797921,7188997,13986918,0.0001166804581252
WA08,5p,17,T>G,687,1084,1771,6797959,7188875,13986834,0.0001266190761969
WA08,5p,18,T>G,673,1090,1763,6797991,7188972,13986963,0.0001260459472152
WA08,5p,19,T>G,619,878,1497,6797966,7188988,13986954,0.0001070283065204
WA08,5p,20,T>G,592,817,1409,6797883,7188971,13986854,0.000100737449608
WA08,5p,21,T>G,726,951,1677,6797885,7188979,13986864,0.0001198982130662
WA08,5p,22,T>G,637,793,1430,6797887,7188939,13986826,0.0001022390641021
WA08,5p,23,T>G,626,852,1478,6797851,7188919,13986770,0.0001056712879385
WA08,5p,24,T>G,743,956,1699,6797841,7188876,13986717,0.0001214723941293
WA08,5p,25,T>G,573,707,1280,6797835,7188817,13986652,9.15158252310846e-05
WA09,3p,1,T>G,38,58,96,4741672,4881751,9623423,9.975660427687735e-06
WA09,3p,2,T>G,44,49,93,4741672,4881751,9623423,9.663921039322496e-06
WA09,3p,3,T>G,108,97,205,4741672,4881751,9623423,2.130219153829152e-05
WA09,3p,4,T>G,163,184,347,4741672,4881748,9623420,3.605786716157042e-05
WA09,3p,5,T>G,880,1125,2005,4741672,4881751,9623423,0.0002083458245574
WA09,3p,6,T>G,905,1187,2092,4741672,4881751,9623423,0.00021738626682
WA09,3p,7,T>G,934,1007,1941,4741672,4881748,9623420,0.0002016954471487
WA09,3p,8,T>G,899,1003,1902,4741663,4881718,9623381,0.0001976436348098
WA09,3p,9,T>G,1026,1447,2473,4741664,4881723,9623387,0.0002569781304648
WA09,3p,10,T>G,1299,1391,2690,4741658,4881705,9623363,0.0002795280610323
WA09,3p,11,T>G,1314,1223,2537,4741648,4881712,9623360,0.0002636293352841
WA09,3p,12,T>G,1454,1457,2911,4741642,4881680,9623322,0.0003024942945897
WA09,3p,13,T>G,1195,1490,2685,4741628,4881645,9623273,0.0002790111015243
WA09,3p,14,T>G,1317,1227,2544,4741616,4881571,9623187,0.0002643614844022
WA09,3p,15,T>G,1240,1445,2685,4741598,4881557,9623155,0.0002790145227838
WA09,3p,16,T>G,1277,1486,2763,4741586,4881546,9623132,0.0002871206588457
WA09,3p,17,T>G,1215,1344,2559,4741582,4881528,9623110,0.0002659223473492
WA09,3p,18,T>G,1225,2096,3321,4741560,4881490,9623050,0.0003451088792015
WA09,3p,19,T>G,1439,1698,3137,4741552,4881442,9622994,0.0003259900193224
WA09,3p,20,T>G,1334,2280,3614,4741534,4881501,9623035,0.000375557191676
WA09,3p,21,T>G,1186,2002,3188,4741546,4881493,9623039,0.0003312882759801
WA09,3p,22,T>G,1365,1728,3093,4741524,4881498,9623022,0.0003214167025701
WA09,3p,23,T>G,1196,2346,3542,4741501,4881486,9622987,0.0003680769806713
WA09,3p,24,T>G,1308,1916,3224,4741491,4881450,9622941,0.0003350327098545
WA09,3p,25,T>G,1361,1342,2703,4741451,4881469,9622920,0.0002808918706588
WA09,5p,1,T>G,79,76,155,4741672,4881751,9623423,1.6106535065537492e-05
WA09,5p,2,T>G,109,123,232,4741495,4881667,9623162,2.4108499888082524e-05
WA09,5p,3,T>G,361,740,1101,4741672,4881750,9623422,0.0001144083674185
WA09,5p,4,T>G,338,376,714,4741672,4881751,9623423,7.419397443092753e-05
WA09,5p,5,T>G,1372,1417,2789,4741671,4881751,9623422,0.0002898137481656
WA09,5p,6,T>G,997,1025,2022,4741669,4881751,9623420,0.0002101124132584
WA09,5p,7,T>G,988,926,1914,4741667,4881751,9623418,0.0001988898331133
WA09,5p,8,T>G,1226,1654,2880,4741639,4881744,9623383,0.0002992710567583
WA09,5p,9,T>G,1813,1255,3068,4741618,4881747,9623365,0.0003188074026081
WA09,5p,10,T>G,1518,1403,2921,4741622,4881737,9623359,0.0003035322697615
WA09,5p,11,T>G,1611,1594,3205,4741614,4881733,9623347,0.0003330442100861
WA09,5p,12,T>G,1614,1524,3138,4741580,4881734,9623314,0.0003260830936203
WA09,5p,13,T>G,1492,1535,3027,4741530,4881708,9623238,0.0003145510897683
WA09,5p,14,T>G,1369,1406,2775,4741498,4881705,9623203,0.0002883655265299
WA09,5p,15,T>G,1604,1396,3000,4741496,4881672,9623168,0.000311747649007
WA09,5p,16,T>G,1454,1871,3325,4741451,4881636,9623087,0.0003455232193162
WA09,5p,17,T>G,1505,1633,3138,4741476,4881638,9623114,0.0003260898707008
WA09,5p,18,T>G,1588,1678,3266,4741455,4881610,9623065,0.0003393929065219
WA09,5p,19,T>G,1903,1721,3624,4741379,4881580,9622959,0.0003765993391429
WA09,5p,20,T>G,1377,2537,3914,4741390,4881557,9622947,0.0004067361069327
WA09,5p,21,T>G,1725,1568,3293,4741379,4881587,9622966,0.0003422021858956
WA09,5p,22,T>G,2060,1523,3583,4741354,4881580,9622934,0.0003723396627265
WA09,5p,23,T>G,1703,1123,2826,4741312,4881565,9622877,0.0002936751659612
WA09,5p,24,T>G,1671,1360,3031,4741363,4881548,9622911,0.0003149774532883
WA09,5p,25,T>G,1581,2036,3617,4741301,4881503,9622804,0.0003758779665469
WA11,3p,1,T>G,55,39,94,9756642,10108269,19864911,4.7319617993757936e-06
WA11,3p,2,T>G,93,36,129,9756642,10108269,19864911,6.493862469356143e-06
WA11,3p,3,T>G,167,98,265,9756642,10108269,19864911,1.3340105072708354e-05
WA11,3p,4,T>G,189,269,458,9756642,10108267,19864909,2.305573108842331e-05
WA11,3p,5,T>G,957,996,1953,9756642,10108269,19864911,9.831405738490346e-05
WA11,3p,6,T>G,896,1201,2097,9756642,10108269,19864911,0.0001055630201413
WA11,3p,7,T>G,963,1033,1996,9756642,10108265,19864907,0.0001004786984404
WA11,3p,8,T>G,1045,1165,2210,9756629,10108160,19864789,0.0001112521255574
WA11,3p,9,T>G,1088,1334,2422,9756610,10108092,19864702,0.0001219248091413
WA11,3p,10,T>G,1266,1198,2464,9756615,10107969,19864584,0.0001240398490096
WA11,3p,11,T>G,1274,1653,2927,9756587,10107918,19864505,0.00014734824754
WA11,3p,12,T>G,1176,1136,2312,9756581,10108019,19864600,0.0001163879463971
WA11,3p,13,T>G,1116,1491,2607,9756565,10107963,19864528,0.0001312389602209
WA11,3p,14,T>G,1242,1651,2893,9756515,10107914,19864429,0.0001456372091037
WA11,3p,15,T>G,1136,1300,2436,9756471,10107972,19864443,0.0001226311757143
WA11,3p,16,T>G,1234,2039,3273,9756477,10108011,19864488,0.0001647663911599
WA11,3p,17,T>G,1119,1865,2984,9756469,10108044,19864513,0.0001502176267799
WA11,3p,18,T>G,1179,1780,2959,9756421,10108016,19864437,0.0001489596709939
WA11,3p,19,T>G,1201,1404,2605,9756438,10108000,19864438,0.0001311388723909
WA11,3p,20,T>G,2061,1554,3615,9756433,10107963,19864396,0.0001819838871516
WA11,3p,21,T>G,1486,1779,3265,9756421,10107904,19864325,0.0001643650111443
WA11,3p,22,T>G,1295,2265,3560,9756405,10107842,19864247,0.0001792164585951
WA11,3p,23,T>G,1266,2326,3592,9756375,10107816,19864191,0.0001808279028327
WA11,3p,24,T>G,1411,1700,3111,9756358,10107704,19864062,0.0001566144930477
WA11,3p,25,T>G,1424,1774,3198,9756281,10107693,19863974,0.0001609949751243
WA11,5p,1,T>G,163,41,204,9756641,10108269,19864910,1.026936442198832e-05
WA11,5p,2,T>G,180,87,267,9756471,10108196,19864667,1.3440950205709463e-05
WA11,5p,3,T>G,762,529,1291,9756642,10108269,19864911,6.498896471270372e-05
WA11,5p,4,T>G,655,570,1225,9756638,10108269,19864907,6.166653586649059e-05
WA11,5p,5,T>G,1356,1250,2606,9756638,10108267,19864905,0.0001311861295082
WA11,5p,6,T>G,1113,1188,2301,9756642,10108269,19864911,0.0001158323840464
WA11,5p,7,T>G,942,1090,2032,9756629,10108269,19864898,0.0001022909858384
WA11,5p,8,T>G,1416,1455,2871,9756500,10108261,19864761,0.0001445272862834
WA11,5p,9,T>G,1410,1490,2900,9756493,10108240,19864733,0.0001459873636358
WA11,5p,10,T>G,1442,1719,3161,9756446,10108197,19864643,0.0001591269473103
WA11,5p,11,T>G,1633,1742,3375,9756457,10108195,19864652,0.0001698997797696
WA11,5p,12,T>G,1558,1742,3300,9756411,10108221,19864632,0.0001661243963643
WA11,5p,13,T>G,1436,1333,2769,9756334,10108178,19864512,0.0001393943128328
WA11,5p,14,T>G,1422,1435,2857,9756261,10108167,19864428,0.0001438249316818
WA11,5p,15,T>G,1646,5224,6870,9756237,10108096,19864333,0.0003458459944262
WA11,5p,16,T>G,1534,4577,6111,9756275,10108079,19864354,0.000307636482918
WA11,5p,17,T>G,1420,1733,3153,9756369,10108078,19864447,0.0001587257878359
WA11,5p,18,T>G,1420,1719,3139,9756327,10108075,19864402,0.0001580213690802
WA11,5p,19,T>G,1927,5079,7006,9756284,10108088,19864372,0.0003526917437913
WA11,5p,20,T>G,1631,1483,3114,9756292,10108082,19864374,0.0001567630573206
WA11,5p,21,T>G,1960,1460,3420,9756251,10108036,19864287,0.000172168273646
WA11,5p,22,T>G,1855,1598,3453,9756136,10108029,19864165,0.0001738306140731
WA11,5p,23,T>G,1526,1623,3149,9756095,10108016,19864111,0.000158527104485
WA11,5p,24,T>G,1792,1581,3373,9756046,10108010,19864056,0.000169804193061
WA11,5p,25,T>G,1610,1480,3090,9756056,10107943,19863999,0.0001555578008234
WA12,3p,1,T>G,54,20,74,6632243,6940679,13572922,5.452031625909292e-06
WA12,3p,2,T>G,35,35,70,6632243,6940679,13572922,5.157327213697979e-06
WA12,3p,3,T>G,92,75,167,6632243,6940679,13572922,1.2303909209822322e-05
WA12,3p,4,T>G,169,167,336,6632243,6940676,13572919,2.475517609734501e-05
WA12,3p,5,T>G,667,884,1551,6632243,6940678,13572921,0.000114271644254
WA12,3p,6,T>G,738,932,1670,6632243,6940679,13572922,0.0001230390920982
WA12,3p,7,T>G,711,859,1570,6632243,6940676,13572919,0.0001156715073596
WA12,3p,8,T>G,755,1035,1790,6632240,6940664,13572904,0.0001318803993603
WA12,3p,9,T>G,813,1339,2152,6632231,6940656,13572887,0.0001585513826203
WA12,3p,10,T>G,972,1494,2466,6632228,6940644,13572872,0.0001816859394238
WA12,3p,11,T>G,1157,1213,2370,6632231,6940642,13572873,0.0001746129946106
WA12,3p,12,T>G,1122,1323,2445,6632223,6940615,13572838,0.0001801391868082
WA12,3p,13,T>G,961,1553,2514,6632204,6940591,13572795,0.0001852234561857
WA12,3p,14,T>G,947,1172,2119,6632209,6940533,13572742,0.0001561217328083
WA12,3p,15,T>G,896,1156,2052,6632188,6940474,13572662,0.0001511862595561
WA12,3p,16,T>G,979,1138,2117,6632187,6940478,13572665,0.0001559752635167
WA12,3p,17,T>G,996,1000,1996,6632168,6940473,13572641,0.0001470605462857
WA12,3p,18,T>G,1090,1099,2189,6632160,6940482,13572642,0.0001612803166841
WA12,3p,19,T>G,1038,1183,2221,6632121,6940435,13572556,0.0001636390374812
WA12,3p,20,T>G,1041,1313,2354,6632105,6940432,13572537,0.0001734384662204
WA12,3p,21,T>G,1122,1207,2329,6632096,6940454,13572550,0.0001715963470386
WA12,3p,22,T>G,967,1222,2189,6632039,6940438,13572477,0.0001612822773617
WA12,3p,23,T>G,901,1250,2151,6631950,6940459,13572409,0.0001584832876757
WA12,3p,24,T>G,1143,1190,2333,6631933,6940411,13572344,0.0001718936684776
WA12,3p,25,T>G,1189,1141,2330,6631986,6940428,13572414,0.0001716717453505
WA12,5p,1,T>G,192,50,242,6632243,6940679,13572922,1.782961693878444e-05
WA12,5p,2,T>G,218,58,276,6631949,6940524,13572473,2.0335277145145176e-05
WA12,5p,3,T>G,489,296,785,6632242,6940678,13572920,5.783574941869546e-05
WA12,5p,4,T>G,373,364,737,6632242,6940679,13572921,5.4299291950494667e-05
WA12,5p,5,T>G,947,1464,2411,6632242,6940677,13572919,0.0001776331237223
WA12,5p,6,T>G,960,1021,1981,6632242,6940679,13572921,0.0001459523709008
WA12,5p,7,T>G,908,946,1854,6632238,6940679,13572917,0.000136595545379
WA12,5p,8,T>G,995,1238,2233,6632204,6940670,13572874,0.0001645193199317
WA12,5p,9,T>G,1247,1046,2293,6632209,6940675,13572884,0.0001689397772794
WA12,5p,10,T>G,1373,1426,2799,6632199,6940665,13572864,0.0002062202936683
WA12,5p,11,T>G,1262,1500,2762,6632166,6940667,13572833,0.0002034947309821
WA12,5p,12,T>G,1753,1230,2983,6632126,6940660,13572786,0.0002197780175713
WA12,5p,13,T>G,1455,1226,2681,6632065,6940658,13572723,0.0001975285283579
WA12,5p,14,T>G,1092,1291,2383,6632026,6940638,13572664,0.0001755734909521
WA12,5p,15,T>G,1224,1461,2685,6631987,6940631,13572618,0.000197824767484
WA12,5p,16,T>G,1303,1365,2668,6631930,6940590,13572520,0.0001965736650231
WA12,5p,17,T>G,1142,1312,2454,6631958,6940621,13572579,0.0001808057260156
WA12,5p,18,T>G,1333,1375,2708,6632019,6940577,13572596,0.0001995196792124
WA12,5p,19,T>G,1176,1272,2448,6631996,6940532,13572528,0.0001803643359586
WA12,5p,20,T>G,1319,1328,2647,6631973,6940532,13572505,0.0001950266365715
WA12,5p,21,T>G,1287,1352,2639,6631936,6940534,13572470,0.000194437711043
WA12,5p,22,T>G,1721,1163,2884,6631921,6940529,13572450,0.0002124892705443
WA12,5p,23,T>G,1091,1216,2307,6631926,6940534,13572460,0.0001699765554659
WA12,5p,24,T>G,1249,1282,2531,6631934,6940518,13572452,0.0001864806742363
WA12,5p,25,T>G,1083,1333,2416,6631933,6940515,13572448,0.000178007681444
WA13,3p,1,T>G,6,7,13,5896847,6081528,11978375,1.0852891147588885e-06
WA13,3p,2,T>G,17,3,20,5896847,6081528,11978375,1.6696755611675207e-06
WA13,3p,3,T>G,15,11,26,5896847,6081528,11978375,2.170578229517777e-06
WA13,3p,4,T>G,12,19,31,5896847,6081522,11978369,2.587998416144969e-06
WA13,3p,5,T>G,45,162,207,5896847,6081527,11978374,1.7281143500778988e-05
WA13,3p,6,T>G,87,124,211,5896847,6081528,11978375,1.7615077170317344e-05
WA13,3p,7,T>G,69,155,224,5896847,6081528,11978375,1.870036628507623e-05
WA13,3p,8,T>G,119,97,216,5896845,6081521,11978366,1.803250960940749e-05
WA13,3p,9,T>G,93,286,379,5896842,6081517,11978359,3.16403941474788e-05
WA13,3p,10,T>G,125,117,242,5896843,6081517,11978360,2.0203099589593235e-05
WA13,3p,11,T>G,128,246,374,5896841,6081492,11978333,3.1223042471769654e-05
WA13,3p,12,T>G,86,198,284,5896836,6081505,11978341,2.370946026665963e-05
WA13,3p,13,T>G,295,156,451,5896834,6081495,11978329,3.7651328494984567e-05
WA13,3p,14,T>G,281,83,364,5896832,6081501,11978333,3.0388201763968327e-05
WA13,3p,15,T>G,100,210,310,5896825,6081505,11978330,2.5880068423561548e-05
WA13,3p,16,T>G,161,150,311,5896830,6081509,11978339,2.5963533007372724e-05
WA13,3p,17,T>G,148,133,281,5896823,6081499,11978322,2.345904543224001e-05
WA13,3p,18,T>G,153,140,293,5896827,6081499,11978326,2.4460847033216492e-05
WA13,3p,19,T>G,118,150,268,5896822,6081480,11978302,2.237378887257977e-05
WA13,3p,20,T>G,107,146,253,5896818,6081448,11978266,2.1121588049555752e-05
WA13,3p,21,T>G,123,232,355,5896824,6081466,11978290,2.9636951518121536e-05
WA13,3p,22,T>G,166,186,352,5896824,6081460,11978284,2.938651312658808e-05
WA13,3p,23,T>G,225,145,370,5896819,6081454,11978273,3.088926091432379e-05
WA13,3p,24,T>G,245,162,407,5896803,6081440,11978243,3.3978272105516646e-05
WA13,3p,25,T>G,140,140,280,5896783,6081437,11978220,2.3375760338347437e-05
WA13,5p,1,T>G,86,20,106,5896847,6081528,11978375,8.849280474187859e-06
WA13,5p,2,T>G,101,22,123,5896725,6081443,11978168,1.0268682155735337e-05
WA13,5p,3,T>G,195,8601,8796,5896847,6081528,11978375,0.0007343233118014
WA13,5p,4,T>G,76,64,140,5896841,6081528,11978369,1.1687734782590184e-05
WA13,5p,5,T>G,209,116,325,5896841,6081528,11978369,2.713224145958436e-05
WA13,5p,6,T>G,146,69,215,5896841,6081528,11978369,1.7949021273263496e-05
WA13,5p,7,T>G,168,8670,8838,5896845,6081528,11978373,0.0007378297536735
WA13,5p,8,T>G,166,156,322,5896843,6081526,11978369,2.6881789999957425e-05
WA13,5p,9,T>G,167,8713,8880,5896837,6081518,11978355,0.0007413371869509
WA13,5p,10,T>G,162,8762,8924,5896833,6081518,11978351,0.0007450107281043
WA13,5p,11,T>G,211,263,474,5896827,6081513,11978340,3.9571426424696577e-05
WA13,5p,12,T>G,142,119,261,5896822,6081502,11978324,2.178935884519404e-05
WA13,5p,13,T>G,174,108,282,5896809,6081508,11978317,2.3542539406829857e-05
WA13,5p,14,T>G,123,110,233,5896802,6081520,11978322,1.9451806354846695e-05
WA13,5p,15,T>G,289,208,497,5896798,6081508,11978306,4.1491676702866e-05
WA13,5p,16,T>G,216,76,292,5896754,6081491,11978245,2.4377527759701023e-05
WA13,5p,17,T>G,235,166,401,5896805,6081514,11978319,3.347715151015764e-05
WA13,5p,18,T>G,147,168,315,5896796,6081504,11978300,2.6297554744830234e-05
WA13,5p,19,T>G,178,162,340,5896797,6081472,11978269,2.838473572433546e-05
WA13,5p,20,T>G,166,140,306,5896788,6081482,11978270,2.554626001918474e-05
WA13,5p,21,T>G,218,125,343,5896782,6081484,11978266,2.8635196446630924e-05
WA13,5p,22,T>G,136,354,490,5896771,6081483,11978254,4.090746447687618e-05
WA13,5p,23,T>G,243,102,345,5896768,6081501,11978269,2.8802158308516866e-05
WA13,5p,24,T>G,235,322,557,5896781,6081498,11978279,4.650083705680925e-05
WA13,5p,25,T>G,205,209,414,5896769,6081462,11978231,3.45626996173308e-05
WA14,3p,1,T>G,18,26,44,6684341,7140972,13825313,3.1825680908634763e-06
WA14,3p,2,T>G,42,118,160,6684341,7140972,13825313,1.1572974875867189e-05
WA14,3p,3,T>G,105,63,168,6684341,7140972,13825313,1.2151623619660546e-05
WA14,3p,4,T>G,127,154,281,6684341,7140971,13825312,2.0325038595874004e-05
WA14,3p,5,T>G,497,1031,1528,6684341,7140970,13825311,0.0001105219260528
WA14,3p,6,T>G,709,1216,1925,6684341,7140971,13825312,0.0001392373640464
WA14,3p,7,T>G,593,1144,1737,6684341,7140969,13825310,0.0001256391357589
WA14,3p,8,T>G,693,1166,1859,6684326,7140932,13825258,0.0001344640367651
WA14,3p,9,T>G,722,1179,1901,6684323,7140920,13825243,0.0001375021039413
WA14,3p,10,T>G,755,926,1681,6684256,7140912,13825168,0.0001215898425248
WA14,3p,11,T>G,834,979,1813,6684256,7140894,13825150,0.0001311378176728
WA14,3p,12,T>G,863,911,1774,6684291,7140849,13825140,0.0001283169646021
WA14,3p,13,T>G,968,966,1934,6684289,7140794,13825083,0.0001398906610542
WA14,3p,14,T>G,921,939,1860,6684291,7140742,13825033,0.0001345385577018
WA14,3p,15,T>G,943,1111,2054,6684271,7140702,13824973,0.0001485717187295
WA14,3p,16,T>G,907,1023,1930,6684263,7140648,13824911,0.0001396030686924
WA14,3p,17,T>G,921,830,1751,6684212,7140653,13824865,0.0001266558479956
WA14,3p,18,T>G,1216,1162,2378,6684177,7140647,13824824,0.0001720094230494
WA14,3p,19,T>G,1145,1287,2432,6684172,7140542,13824714,0.0001759168399433
WA14,3p,20,T>G,1175,1455,2630,6684176,7140544,13824720,0.0001902389343147
WA14,3p,21,T>G,1347,1208,2555,6684132,7140443,13824575,0.0001848158080808
WA14,3p,22,T>G,1062,1206,2268,6684105,7140560,13824665,0.0001640546081948
WA14,3p,23,T>G,1260,1117,2377,6683638,7140562,13824200,0.0001719448503349
WA14,3p,24,T>G,1760,1242,3002,6683623,7140532,13824155,0.0002171561299768
WA14,3p,25,T>G,1211,1244,2455,6683613,7140513,13824126,0.0001775880804327
WA14,5p,1,T>G,87,46,133,6684341,7140972,13825313,9.6200353655646e-06
WA14,5p,2,T>G,113,102,215,6684184,7140911,13825095,1.5551430207170368e-05
WA14,5p,3,T>G,587,549,1136,6684338,7140972,13825310,8.216813944859102e-05
WA14,5p,4,T>G,376,731,1107,6684341,7140972,13825313,8.00705199224061e-05
WA14,5p,5,T>G,897,1469,2366,6684341,7140972,13825313,0.0001711353659768
WA14,5p,6,T>G,648,1012,1660,6684340,7140972,13825312,0.0001200696230218
WA14,5p,7,T>G,999,817,1816,6684336,7140972,13825308,0.0001313533123457
WA14,5p,8,T>G,723,1341,2064,6684277,7140970,13825247,0.000149292088597
WA14,5p,9,T>G,1508,1621,3129,6684241,7140959,13825200,0.0002263258397708
WA14,5p,10,T>G,835,1732,2567,6684210,7140628,13824838,0.0001856802951325
WA14,5p,11,T>G,981,1546,2527,6684218,7140646,13824864,0.0001827866082443
WA14,5p,12,T>G,1285,1644,2929,6684139,7140917,13825056,0.0002118617096379
WA14,5p,13,T>G,1101,1475,2576,6684018,7140931,13824949,0.0001863298012889
WA14,5p,14,T>G,909,1432,2341,6683951,7140942,13824893,0.0001693322328064
WA14,5p,15,T>G,1372,1216,2588,6684030,7140908,13824938,0.0001871979462041
WA14,5p,16,T>G,963,1513,2476,6683910,7140868,13824778,0.0001790987168112
WA14,5p,17,T>G,829,1639,2468,6683904,7140873,13824777,0.0001785200585875
WA14,5p,18,T>G,1037,1821,2858,6683891,7140646,13824537,0.0002067338674705
WA14,5p,19,T>G,1271,1640,2911,6683958,7140595,13824553,0.0002105673868804
WA14,5p,20,T>G,997,1719,2716,6683860,7140558,13824418,0.0001964639668736
WA14,5p,21,T>G,1079,1675,2754,6683480,7140494,13823974,0.0001992191246887
WA14,5p,22,T>G,1042,1520,2562,6683768,7140398,13824166,0.0001853276356779
WA14,5p,23,T>G,1703,1763,3466,6683762,7140257,13824019,0.0002507230350305
WA14,5p,24,T>G,1130,2548,3678,6683714,7140421,13824135,0.0002660564295704
WA14,5p,25,T>G,1146,1767,2913,6683731,7140511,13824242,0.0002107167973477
WA18,3p,1,T>G,51,69,120,14112928,14131239,28244167,4.248664865917271e-06
WA18,3p,2,T>G,176,62,238,14112928,14131239,28244167,8.42651865073592e-06
WA18,3p,3,T>G,136,140,276,14112928,14131239,28244167,9.771929191609723e-06
WA18,3p,4,T>G,389,503,892,14112928,14131238,28244166,3.158174328815374e-05
WA18,3p,5,T>G,1116,1151,2267,14112928,14131239,28244167,8.02643604252871e-05
WA18,3p,6,T>G,1354,1707,3061,14112928,14131239,28244167,0.0001083763596214
WA18,3p,7,T>G,1220,1396,2616,14112928,14131237,28244165,9.26209006355826e-05
WA18,3p,8,T>G,1321,2491,3812,14112927,14131187,28244114,0.0001349661738371
WA18,3p,9,T>G,1537,2615,4152,14112909,14131177,28244086,0.0001470042259466
WA18,3p,10,T>G,1941,2874,4815,14112909,14131197,28244106,0.0001704780459328
WA18,3p,11,T>G,2093,1718,3811,14112900,14131167,28244067,0.0001349309927638
WA18,3p,12,T>G,1905,2903,4808,14112895,14131136,28244031,0.0001702306586478
WA18,3p,13,T>G,1889,2359,4248,14112898,14131061,28243959,0.0001504038438803
WA18,3p,14,T>G,1621,3301,4922,14112830,14131006,28243836,0.0001742681128724
WA18,3p,15,T>G,2198,2571,4769,14112809,14130957,28243766,0.0001688514201682
WA18,3p,16,T>G,2003,6332,8335,14112765,14130927,28243692,0.0002951101435322
WA18,3p,17,T>G,2251,2418,4669,14112743,14130850,28243593,0.0001653118284206
WA18,3p,18,T>G,2201,4138,6339,14112708,14130769,28243477,0.0002244412046009
WA18,3p,19,T>G,2032,1938,3970,14112724,14130771,28243495,0.0001405633403373
WA18,3p,20,T>G,2096,1976,4072,14112697,14130797,28243494,0.0001441747965035
WA18,3p,21,T>G,2329,1727,4056,14112659,14130783,28243442,0.0001436085587585
WA18,3p,22,T>G,2276,1763,4039,14112575,14130715,28243290,0.0001430074187532
WA18,3p,23,T>G,2247,2400,4647,14112548,14130648,28243196,0.0001645352034521
WA18,3p,24,T>G,2259,1816,4075,14112551,14130690,28243241,0.0001442823081104
WA18,3p,25,T>G,2599,1749,4348,14112486,14130651,28243137,0.0001539489044719
WA18,5p,1,T>G,477,81,558,14112926,14131239,28244165,1.9756293025479774e-05
WA18,5p,2,T>G,565,225,790,14112820,14131183,28244003,2.79705394451346e-05
WA18,5p,3,T>G,2126,2279,4405,14112928,14131239,28244167,0.0001559614061197
WA18,5p,4,T>G,1315,2532,3847,14112928,14131239,28244167,0.0001362051144931
WA18,5p,5,T>G,1858,2640,4498,14112925,14131239,28244164,0.0001592541383062
WA18,5p,6,T>G,1839,1982,3821,14112927,14131239,28244166,0.0001352845752287
WA18,5p,7,T>G,2188,1668,3856,14112921,14131239,28244160,0.000136523798194
WA18,5p,8,T>G,2671,2333,5004,14112828,14131230,28244058,0.0001771700086439
WA18,5p,9,T>G,2902,3109,6011,14112833,14131230,28244063,0.0002128234878954
WA18,5p,10,T>G,3806,2892,6698,14112791,14131213,28244004,0.0002371476792029
WA18,5p,11,T>G,4107,2964,7071,14112776,14131211,28243987,0.0002503541727306
WA18,5p,12,T>G,8990,2275,11265,14112682,14131223,28243905,0.0003988471140941
WA18,5p,13,T>G,4983,2255,7238,14112608,14131206,28243814,0.0002562685053796
WA18,5p,14,T>G,9381,2926,12307,14112535,14131179,28243714,0.0004357429762955
WA18,5p,15,T>G,7791,1829,9620,14112545,14131148,28243693,0.0003406070162283
WA18,5p,16,T>G,3165,2538,5703,14112522,14131083,28243605,0.0002019218155755
WA18,5p,17,T>G,4049,1970,6019,14112485,14130990,28243475,0.000213111169925
WA18,5p,18,T>G,4219,2724,6943,14112481,14130987,28243468,0.0002458267518705
WA18,5p,19,T>G,5050,2342,7392,14112359,14130867,28243226,0.0002617264755803
WA18,5p,20,T>G,3212,2356,5568,14112397,14130866,28243263,0.0001971443597009
WA18,5p,21,T>G,6239,2141,8380,14112347,14130679,28243026,0.000296710416228
WA18,5p,22,T>G,5538,2252,7790,14112376,14129592,28241968,0.0002758306361652
WA18,5p,23,T>G,6479,2257,8736,14112288,14129275,28241563,0.0003093313213578
WA18,5p,24,T>G,4997,2481,7478,14112253,14129481,28241734,0.0002647854412905
WA18,5p,25,T>G,5883,2430,8313,14112273,14130551,28242824,0.0002943402543598
WA22,3p,1,T>G,0,2,2,1513709,1653397,3167106,6.314913362546122e-07
WA22,3p,2,T>G,7,2,9,1513709,1653396,3167105,2.841711910403981e-06
WA22,3p,3,T>G,13,7,20,1513709,1653396,3167105,6.314915356453291e-06
WA22,3p,4,T>G,18,19,37,1513709,1653394,3167103,1.16826007869021e-05
WA22,3p,5,T>G,73,101,174,1513709,1653397,3167106,5.4939746254151264e-05
WA22,3p,6,T>G,75,98,173,1513709,1653397,3167106,5.462400058602396e-05
WA22,3p,7,T>G,90,191,281,1513709,1653397,3167106,8.872453274377302e-05
WA22,3p,8,T>G,127,114,241,1513709,1653395,3167104,7.609475407185871e-05
WA22,3p,9,T>G,100,86,186,1513709,1653397,3167106,5.872869427167894e-05
WA22,3p,10,T>G,164,99,263,1513706,1653396,3167102,8.304121559709792e-05
WA22,3p,11,T>G,153,84,237,1513685,1653390,3167075,7.483245581490808e-05
WA22,3p,12,T>G,170,78,248,1513662,1653379,3167041,7.830653281722592e-05
WA22,3p,13,T>G,158,129,287,1513689,1653380,3167069,9.062006542958174e-05
WA22,3p,14,T>G,124,152,276,1513686,1653352,3167038,8.714767552520683e-05
WA22,3p,15,T>G,88,124,212,1513677,1653343,3167020,6.69398993375476e-05
WA22,3p,16,T>G,169,303,472,1513637,1653341,3166978,0.0001490379787924
WA22,3p,17,T>G,159,175,334,1513671,1653319,3166990,0.0001054629158917
WA22,3p,18,T>G,161,136,297,1513665,1653288,3166953,9.378099390802453e-05
WA22,3p,19,T>G,108,132,240,1513662,1653275,3166937,7.57830042087986e-05
WA22,3p,20,T>G,170,161,331,1513684,1653304,3166988,0.0001045157101953
WA22,3p,21,T>G,135,98,233,1513677,1653327,3167004,7.357111010911259e-05
WA22,3p,22,T>G,191,84,275,1513684,1653356,3167040,8.683186824290189e-05
WA22,3p,23,T>G,107,133,240,1513676,1653329,3167005,7.578137704234758e-05
WA22,3p,24,T>G,161,207,368,1513672,1653285,3166957,0.0001161998726222
WA22,3p,25,T>G,131,118,249,1513669,1653296,3166965,7.862417172276928e-05
WA22,5p,1,T>G,16,38,54,1513709,1653397,3167106,1.705026607887453e-05
WA22,5p,2,T>G,16,11,27,1513674,1653378,3167052,8.525278397702343e-06
WA22,5p,3,T>G,54,26,80,1513709,1653397,3167106,2.525965345018449e-05
WA22,5p,4,T>G,30,101,131,1513709,1653397,3167106,4.1362682524677104e-05
WA22,5p,5,T>G,174,115,289,1513708,1653396,3167104,9.125055571272683e-05
WA22,5p,6,T>G,101,85,186,1513704,1653397,3167101,5.8728786988479366e-05
WA22,5p,7,T>G,132,96,228,1513707,1653397,3167104,7.199005779412359e-05
WA22,5p,8,T>G,142,110,252,1513692,1653397,3167089,7.956833546515428e-05
WA22,5p,9,T>G,159,127,286,1513700,1653389,3167089,9.030374580569096e-05
WA22,5p,10,T>G,143,130,273,1513705,1653389,3167094,8.619889400188312e-05
WA22,5p,11,T>G,325,150,475,1513699,1653381,3167080,0.0001499804236078
WA22,5p,12,T>G,119,102,221,1513692,1653345,3167037,6.978131294329685e-05
WA22,5p,13,T>G,121,112,233,1513697,1653377,3167074,7.356948400953056e-05
WA22,5p,14,T>G,281,143,424,1513677,1653376,3167053,0.0001338784036768
WA22,5p,15,T>G,227,127,354,1513695,1653381,3167076,0.0001117750252914
WA22,5p,16,T>G,156,84,240,1513668,1653368,3167036,7.578063526906546e-05
WA22,5p,17,T>G,233,114,347,1513675,1653395,3167070,0.0001095649922483
WA22,5p,18,T>G,125,123,248,1513651,1653392,3167043,7.83064833663452e-05
WA22,5p,19,T>G,185,118,303,1513674,1653350,3167024,9.567341453680174e-05
WA22,5p,20,T>G,166,185,351,1513678,1653356,3167034,0.0001108292490702
WA22,5p,21,T>G,149,95,244,1513690,1653371,3167061,7.704303769330619e-05
WA22,5p,22,T>G,230,215,445,1513691,1653380,3167071,0.0001405083750885
WA22,5p,23,T>G,291,169,460,1513634,1653393,3167027,0.0001452466303571
WA22,5p,24,T>G,181,150,331,1513632,1653375,3167007,0.0001045150831684
WA22,5p,25,T>G,232,165,397,1513644,1653364,3167008,0.0001253549091129
WA25,3p,1,T>G,7,7,14,3375244,3569089,6944333,2.0160323532872054e-06
WA25,3p,2,T>G,52,16,68,3375244,3569089,6944333,9.792157144537856e-06
WA25,3p,3,T>G,96,21,117,3375244,3569089,6944333,1.6848270381043074e-05
WA25,3p,4,T>G,39,63,102,3375244,3569087,6944331,1.4688239947087777e-05
WA25,3p,5,T>G,278,204,482,3375244,3569089,6944333,6.94091138774595e-05
WA25,3p,6,T>G,322,273,595,3375244,3569089,6944333,8.568137501470624e-05
WA25,3p,7,T>G,607,297,904,3375244,3569089,6944333,0.0001301780890979
WA25,3p,8,T>G,575,359,934,3375239,3569076,6944315,0.0001344985070521
WA25,3p,9,T>G,366,269,635,3375240,3569076,6944316,9.144169130552238e-05
WA25,3p,10,T>G,470,312,782,3375240,3569075,6944315,0.0001126100990522
WA25,3p,11,T>G,312,415,727,3375233,3569054,6944287,0.0001046903735401
WA25,3p,12,T>G,512,307,819,3375226,3569069,6944295,0.0001179385380373
WA25,3p,13,T>G,591,535,1126,3375230,3569053,6944283,0.0001621477696113
WA25,3p,14,T>G,462,383,845,3375223,3569037,6944260,0.0001216832319066
WA25,3p,15,T>G,411,351,762,3375218,3569039,6944257,0.0001097309618581
WA25,3p,16,T>G,428,308,736,3375196,3569030,6944226,0.0001059873339375
WA25,3p,17,T>G,343,322,665,3375198,3569022,6944220,9.576309506323244e-05
WA25,3p,18,T>G,452,340,792,3375213,3569006,6944219,0.0001140517025744
WA25,3p,19,T>G,465,362,827,3375204,3569005,6944209,0.0001190920376964
WA25,3p,20,T>G,410,732,1142,3375190,3568979,6944169,0.0001644545229241
WA25,3p,21,T>G,571,672,1243,3375199,3568998,6944197,0.0001789983780702
WA25,3p,22,T>G,552,516,1068,3375179,3568994,6944173,0.0001537980116566
WA25,3p,23,T>G,559,419,978,3375175,3568972,6944147,0.0001408380323746
WA25,3p,24,T>G,475,472,947,3375177,3568962,6944139,0.0001363739982739
WA25,3p,25,T>G,511,464,975,3375156,3568970,6944126,0.0001404064384776
WA25,5p,1,T>G,35,18,53,3375244,3569089,6944333,7.632122480301564e-06
WA25,5p,2,T>G,65,18,83,3375147,3569045,6944192,1.1952434494898758e-05
WA25,5p,3,T>G,274,148,422,3375243,3569089,6944332,6.0768983971388464e-05
WA25,5p,4,T>G,241,350,591,3375243,3569089,6944332,8.5105378026281e-05
WA25,5p,5,T>G,450,571,1021,3375244,3569088,6944332,0.0001470263806511
WA25,5p,6,T>G,392,380,772,3375244,3569089,6944333,0.0001111697840526
WA25,5p,7,T>G,368,248,616,3375242,3569089,6944331,8.870544909221638e-05
WA25,5p,8,T>G,518,297,815,3375221,3569088,6944309,0.000117362289034
WA25,5p,9,T>G,461,764,1225,3375227,3569087,6944314,0.0001764033135598
WA25,5p,10,T>G,452,480,932,3375217,3569085,6944302,0.0001342107529309
WA25,5p,11,T>G,589,729,1318,3375193,3569088,6944281,0.0001897964670496
WA25,5p,12,T>G,552,480,1032,3375142,3569084,6944226,0.0001486126747602
WA25,5p,13,T>G,518,351,869,3375133,3569081,6944214,0.0001251401526508
WA25,5p,14,T>G,445,465,910,3375151,3569071,6944222,0.0001310441976077
WA25,5p,15,T>G,614,514,1128,3375137,3569055,6944192,0.0001624379049427
WA25,5p,16,T>G,721,430,1151,3375081,3569035,6944116,0.0001657518393989
WA25,5p,17,T>G,631,427,1058,3375076,3568871,6943947,0.0001523629140602
WA25,5p,18,T>G,647,313,960,3375102,3568996,6944098,0.0001382468968611
WA25,5p,19,T>G,514,453,967,3375134,3569021,6944155,0.0001392538040985
WA25,5p,20,T>G,501,671,1172,3375145,3569019,6944164,0.0001687748158021
WA25,5p,21,T>G,588,467,1055,3375130,3569013,6944143,0.0001519265948296
WA25,5p,22,T>G,722,390,1112,3375139,3569001,6944140,0.0001601350203192
WA25,5p,23,T>G,723,414,1137,3375144,3569002,6944146,0.0001637350366769
WA25,5p,24,T>G,681,331,1012,3375124,3568967,6944091,0.0001457354173498
WA25,5p,25,T>G,515,446,961,3375125,3568950,6944075,0.0001383913624204
WA26,3p,1,T>G,8,10,18,2709623,2900126,5609749,3.208699711876592e-06
WA26,3p,2,T>G,25,2,27,2709623,2900126,5609749,4.813049567814888e-06
WA26,3p,3,T>G,25,15,40,2709623,2900126,5609749,7.130443804170204e-06
WA26,3p,4,T>G,51,43,94,2709623,2900126,5609749,1.675654293979998e-05
WA26,3p,5,T>G,142,166,308,2709623,2900126,5609749,5.4904417292110576e-05
WA26,3p,6,T>G,142,218,360,2709623,2900126,5609749,6.417399423753185e-05
WA26,3p,7,T>G,531,261,792,2709623,2900126,5609749,0.0001411827873225
WA26,3p,8,T>G,226,209,435,2709619,2900114,5609733,7.754379753902726e-05
WA26,3p,9,T>G,172,301,473,2709613,2900111,5609724,8.431787374922545e-05
WA26,3p,10,T>G,273,243,516,2709609,2900074,5609683,9.198380728465406e-05
WA26,3p,11,T>G,266,187,453,2709594,2900076,5609670,8.075341330238677e-05
WA26,3p,12,T>G,587,292,879,2709607,2900081,5609688,0.000156693206467
WA26,3p,13,T>G,484,254,738,2709604,2900084,5609688,0.0001315581187402
WA26,3p,14,T>G,326,172,498,2709584,2900069,5609653,8.877554458359545e-05
WA26,3p,15,T>G,426,159,585,2709593,2900082,5609675,0.0001042841162812
WA26,3p,16,T>G,501,150,651,2709580,2900075,5609655,0.0001160499175082
WA26,3p,17,T>G,534,242,776,2709570,2900078,5609648,0.0001383331004013
WA26,3p,18,T>G,330,208,538,2709582,2900059,5609641,9.590631557349214e-05
WA26,3p,19,T>G,336,210,546,2709567,2900016,5609583,9.733343815395904e-05
WA26,3p,20,T>G,217,183,400,2709563,2899983,5609546,7.130701842894237e-05
WA26,3p,21,T>G,343,299,642,2709562,2900021,5609583,0.0001144470096975
WA26,3p,22,T>G,857,289,1146,2709522,2900007,5609529,0.0002042952269254
WA26,3p,23,T>G,619,254,873,2709541,2899974,5609515,0.0001556284277696
WA26,3p,24,T>G,458,257,715,2709558,2899951,5609509,0.0001274621361691
WA26,3p,25,T>G,365,297,662,2709500,2900002,5609502,0.0001180140411751
WA26,5p,1,T>G,29,24,53,2709622,2900126,5609748,9.447839724707776e-06
WA26,5p,2,T>G,37,19,56,2709554,2900092,5609646,9.982804619043695e-06
WA26,5p,3,T>G,163,256,419,2709623,2900126,5609749,7.469139884868289e-05
WA26,5p,4,T>G,99,212,311,2709623,2900126,5609749,5.543920057742334e-05
WA26,5p,5,T>G,291,459,750,2709623,2900125,5609748,0.0001336958451609
WA26,5p,6,T>G,262,295,557,2709621,2900126,5609747,9.92914653726808e-05
WA26,5p,7,T>G,290,415,705,2709622,2900126,5609748,0.0001256740944513
WA26,5p,8,T>G,248,295,543,2709609,2900124,5609733,9.679605072113058e-05
WA26,5p,9,T>G,319,403,722,2709594,2900123,5609717,0.0001287052448456
WA26,5p,10,T>G,271,481,752,2709601,2900123,5609724,0.000134052940929
WA26,5p,11,T>G,358,399,757,2709605,2900103,5609708,0.0001349446352644
WA26,5p,12,T>G,348,331,679,2709595,2900107,5609702,0.0001210402976842
WA26,5p,13,T>G,363,297,660,2709592,2900104,5609696,0.0001176534343394
WA26,5p,14,T>G,392,253,645,2709563,2900089,5609652,0.0001149803945057
WA26,5p,15,T>G,323,384,707,2709545,2900085,5609630,0.0001260332677912
WA26,5p,16,T>G,344,523,867,2709540,2900076,5609616,0.0001545560337819
WA26,5p,17,T>G,406,774,1180,2709554,2900055,5609609,0.0002103533419174
WA26,5p,18,T>G,326,395,721,2709554,2900082,5609636,0.0001285288385913
WA26,5p,19,T>G,371,279,650,2709570,2900086,5609656,0.0001158716327703
WA26,5p,20,T>G,287,367,654,2709563,2900082,5609645,0.0001165849175839
WA26,5p,21,T>G,354,454,808,2709545,2900061,5609606,0.0001440386365816
WA26,5p,22,T>G,301,461,762,2709542,2900059,5609601,0.0001358385382489
WA26,5p,23,T>G,394,441,835,2709528,2900065,5609593,0.0001488521538015
WA26,5p,24,T>G,381,435,816,2709495,2900057,5609552,0.0001454661620036
WA26,5p,25,T>G,301,413,714,2709506,2900041,5609547,0.0001272830052052
