Sample,End,Position,Substitution,Pos_Count,Neg_Count,Combined_Count,Pos_Total,Neg_Total,Combined_Total,Frequency
DAL192,3p,1,T>A,55,9,64,6350003,6167708,12517711,5.112755838507535e-06
DAL192,3p,2,T>A,41,7,48,6350003,6167706,12517709,3.8345674915433805e-06
DAL192,3p,3,T>A,98,47,145,6350003,6167708,12517711,1.1583587446618636e-05
DAL192,3p,4,T>A,173,80,253,6350003,6167708,12517711,2.02113629241001e-05
DAL192,3p,5,T>A,230,244,474,6350003,6167708,12517711,3.786634792894644e-05
DAL192,3p,6,T>A,287,255,542,6350003,6167708,12517711,4.329865100736069e-05
DAL192,3p,7,T>A,374,258,632,6350003,6167708,12517711,5.048846390526191e-05
DAL192,3p,8,T>A,409,251,660,6350003,6167618,12517621,5.272567367233758e-05
DAL192,3p,9,T>A,342,354,696,6350003,6167637,12517640,5.560153511364762e-05
DAL192,3p,10,T>A,491,343,834,6350003,6167645,12517648,6.662593484015527e-05
DAL192,3p,11,T>A,464,337,801,6349987,6167644,12517631,6.39897437462408e-05
DAL192,3p,12,T>A,507,463,970,6349997,6167646,12517643,7.749062662994942e-05
DAL192,3p,13,T>A,456,387,843,6349992,6167621,12517613,6.73451080489547e-05
DAL192,3p,14,T>A,805,398,1203,6349967,6167610,12517577,9.610486118839134e-05
DAL192,3p,15,T>A,738,467,1205,6349968,6167615,12517583,9.626459037659266e-05
DAL192,3p,16,T>A,611,502,1113,6349943,6167587,12517530,8.891530517602114e-05
DAL192,3p,17,T>A,391,351,742,6349922,6167606,12517528,5.927687958836601e-05
DAL192,3p,18,T>A,881,395,1276,6349922,6167564,12517486,0.0001019374018073
DAL192,3p,19,T>A,735,371,1106,6349921,6167519,12517440,8.835672469770177e-05
DAL192,3p,20,T>A,573,419,992,6349910,6167516,12517426,7.924951982939623e-05
DAL192,3p,21,T>A,604,443,1047,6349882,6167507,12517389,8.364364165721781e-05
DAL192,3p,22,T>A,528,536,1064,6349894,6167488,12517382,8.500179989713504e-05
DAL192,3p,23,T>A,619,515,1134,6349902,6167465,12517367,9.059413213657472e-05
DAL192,3p,24,T>A,616,440,1056,6349899,6167465,12517364,8.436280993346523e-05
DAL192,3p,25,T>A,608,514,1122,6349856,6167384,12517240,8.963637351364998e-05
DAL192,5p,1,T>A,11,5,16,6350003,6167708,12517711,1.2781889596268838e-06
DAL192,5p,2,T>A,5,12,17,6349992,6167694,12517686,1.3580784819175043e-06
DAL192,5p,3,T>A,381,190,571,6350003,6167707,12517710,4.561537214075098e-05
DAL192,5p,4,T>A,190,94,284,6350003,6167708,12517711,2.268785403337719e-05
DAL192,5p,5,T>A,319,243,562,6350003,6167707,12517710,4.489639079352373e-05
DAL192,5p,6,T>A,266,218,484,6350002,6167707,12517709,3.866522220639576e-05
DAL192,5p,7,T>A,130,133,263,6350002,6167708,12517710,2.101023270230737e-05
DAL192,5p,8,T>A,268,242,510,6349926,6167708,12517634,4.074252370695612e-05
DAL192,5p,9,T>A,280,256,536,6349914,6167708,12517622,4.281963459193767e-05
DAL192,5p,10,T>A,510,284,794,6349896,6167708,12517604,6.343066931978356e-05
DAL192,5p,11,T>A,297,287,584,6349942,6167706,12517648,4.66541318305164e-05
DAL192,5p,12,T>A,491,366,857,6349906,6167700,12517606,6.84635704303203e-05
DAL192,5p,13,T>A,545,284,829,6349906,6167705,12517611,6.622669453460409e-05
DAL192,5p,14,T>A,379,322,701,6349889,6167679,12517568,5.600129354200432e-05
DAL192,5p,15,T>A,415,339,754,6349890,6167649,12517539,6.023548238994901e-05
DAL192,5p,16,T>A,426,433,859,6349904,6167639,12517543,6.862369076742936e-05
DAL192,5p,17,T>A,493,570,1063,6349778,6167623,12517401,8.492178208559428e-05
DAL192,5p,18,T>A,468,454,922,6349859,6167631,12517490,7.365693921065645e-05
DAL192,5p,19,T>A,673,525,1198,6349822,6167638,12517460,9.570631741583356e-05
DAL192,5p,20,T>A,381,455,836,6349836,6167621,12517457,6.678672832668808e-05
DAL192,5p,21,T>A,613,527,1140,6349784,6167624,12517408,9.107316786350656e-05
DAL192,5p,22,T>A,501,445,946,6349783,6167584,12517367,7.557499911922372e-05
DAL192,5p,23,T>A,468,527,995,6349801,6167567,12517368,7.948955403404294e-05
DAL192,5p,24,T>A,445,479,924,6349759,6167564,12517323,7.381770047796962e-05
DAL192,5p,25,T>A,642,560,1202,6349777,6167551,12517328,9.602688369274976e-05
DAL193,3p,1,T>A,50,16,66,6484405,6362696,12847101,5.137345771625832e-06
DAL193,3p,2,T>A,59,39,98,6484402,6362696,12847098,7.628181866441744e-06
DAL193,3p,3,T>A,138,160,298,6484405,6362696,12847101,2.319589454461361e-05
DAL193,3p,4,T>A,328,255,583,6484405,6362696,12847101,4.537988764936152e-05
DAL193,3p,5,T>A,989,1013,2002,6484405,6362696,12847101,0.0001558328217393
DAL193,3p,6,T>A,1238,1285,2523,6484405,6362696,12847101,0.0001963867179062
DAL193,3p,7,T>A,1019,1071,2090,6484405,6362696,12847101,0.0001626826161014
DAL193,3p,8,T>A,1447,906,2353,6484400,6362644,12847044,0.0001831549732374
DAL193,3p,9,T>A,1391,1178,2569,6484400,6362631,12847031,0.0001999683817996
DAL193,3p,10,T>A,1258,1117,2375,6484393,6362640,12847033,0.0001848675877146
DAL193,3p,11,T>A,1270,1309,2579,6484398,6362639,12847037,0.0002007466780083
DAL193,3p,12,T>A,1395,1329,2724,6484368,6362594,12846962,0.000212034565059
DAL193,3p,13,T>A,1153,1187,2340,6484385,6362543,12846928,0.0001821447119498
DAL193,3p,14,T>A,1330,1166,2496,6484363,6362486,12846849,0.0001942888874929
DAL193,3p,15,T>A,1841,1090,2931,6484332,6362438,12846770,0.0002281507336085
DAL193,3p,16,T>A,1191,1081,2272,6484341,6362460,12846801,0.0001768533660636
DAL193,3p,17,T>A,1366,1273,2639,6484294,6362445,12846739,0.0002054217805779
DAL193,3p,18,T>A,1613,1536,3149,6484244,6362380,12846624,0.0002451227653272
DAL193,3p,19,T>A,1407,1366,2773,6484265,6362400,12846665,0.0002158536865404
DAL193,3p,20,T>A,1290,1297,2587,6484261,6362382,12846643,0.0002013755655854
DAL193,3p,21,T>A,1779,1484,3263,6484248,6362443,12846691,0.0002539953673673
DAL193,3p,22,T>A,1577,1073,2650,6484224,6362407,12846631,0.0002062797631534
DAL193,3p,23,T>A,1275,1309,2584,6484218,6362399,12846617,0.0002011424486306
DAL193,3p,24,T>A,1351,1308,2659,6484164,6362319,12846483,0.0002069827204846
DAL193,3p,25,T>A,1420,1138,2558,6484128,6362355,12846483,0.0001991206464835
DAL193,5p,1,T>A,19,5,24,6484405,6362696,12847101,1.8681257351366665e-06
DAL193,5p,2,T>A,13,36,49,6484386,6362681,12847067,3.8141001366304073e-06
DAL193,5p,3,T>A,657,253,910,6484400,6362696,12847096,7.083312835834651e-05
DAL193,5p,4,T>A,279,256,535,6484403,6362696,12847099,4.164364266205157e-05
DAL193,5p,5,T>A,1172,869,2041,6484403,6362696,12847099,0.0001588685507911
DAL193,5p,6,T>A,1477,1074,2551,6484404,6362696,12847100,0.0001985662133866
DAL193,5p,7,T>A,798,615,1413,6484404,6362696,12847100,0.0001099859112173
DAL193,5p,8,T>A,1069,1010,2079,6484314,6362693,12847007,0.0001618275758703
DAL193,5p,9,T>A,1522,1039,2561,6484295,6362695,12846990,0.0001993463060218
DAL193,5p,10,T>A,2143,2071,4214,6484284,6362694,12846978,0.0003280148841229
DAL193,5p,11,T>A,1228,1167,2395,6484315,6362677,12846992,0.0001864249623569
DAL193,5p,12,T>A,1007,1219,2226,6484218,6362670,12846888,0.0001732715347094
DAL193,5p,13,T>A,1540,1554,3094,6484143,6362652,12846795,0.0002408382791194
DAL193,5p,14,T>A,1439,1186,2625,6484145,6362627,12846772,0.0002043314849831
DAL193,5p,15,T>A,1453,1293,2746,6484166,6362534,12846700,0.0002137513914079
DAL193,5p,16,T>A,1385,1300,2685,6484111,6362519,12846630,0.0002090042291246
DAL193,5p,17,T>A,1835,1082,2917,6484043,6362598,12846641,0.0002270632455596
DAL193,5p,18,T>A,1875,1639,3514,6483967,6362571,12846538,0.0002735367302848
DAL193,5p,19,T>A,1410,1366,2776,6483980,6362593,12846573,0.0002160887576787
DAL193,5p,20,T>A,1347,1141,2488,6483952,6362554,12846506,0.0001936713375605
DAL193,5p,21,T>A,1420,1502,2922,6484003,6362532,12846535,0.0002274543291245
DAL193,5p,22,T>A,2130,1171,3301,6484010,6362499,12846509,0.0002569569678423
DAL193,5p,23,T>A,1192,1243,2435,6483966,6362463,12846429,0.0001895468382692
DAL193,5p,24,T>A,1724,1335,3059,6483905,6362426,12846331,0.0002381224646943
DAL193,5p,25,T>A,1412,1157,2569,6483942,6362403,12846345,0.0001999790601918
DAL195,3p,1,T>A,19,5,24,2363278,2267461,4630739,5.182758086776215e-06
DAL195,3p,2,T>A,23,7,30,2363278,2267460,4630738,6.478449007480017e-06
DAL195,3p,3,T>A,37,15,52,2363278,2267461,4630739,1.1229309188015131e-05
DAL195,3p,4,T>A,66,32,98,2363278,2267461,4630739,2.1162928854336208e-05
DAL195,3p,5,T>A,198,181,379,2363278,2267461,4630739,8.184438812034105e-05
DAL195,3p,6,T>A,201,200,401,2363278,2267461,4630739,8.659524969988591e-05
DAL195,3p,7,T>A,219,172,391,2363278,2267461,4630739,8.443576716372916e-05
DAL195,3p,8,T>A,250,190,440,2363278,2267413,4630691,9.50182165037572e-05
DAL195,3p,9,T>A,263,209,472,2363276,2267438,4630714,0.0001019281259866
DAL195,3p,10,T>A,280,287,567,2363274,2267432,4630706,0.0001224435323684
DAL195,3p,11,T>A,270,226,496,2363274,2267431,4630705,0.0001071111202289
DAL195,3p,12,T>A,334,323,657,2363273,2267414,4630687,0.0001418795958353
DAL195,3p,13,T>A,417,199,616,2363269,2267412,4630681,0.0001330257903751
DAL195,3p,14,T>A,304,189,493,2363250,2267410,4630660,0.0001064643053042
DAL195,3p,15,T>A,335,253,588,2363254,2267411,4630665,0.0001269796022817
DAL195,3p,16,T>A,292,242,534,2363259,2267394,4630653,0.0001153185090742
DAL195,3p,17,T>A,240,355,595,2363234,2267398,4630632,0.0001284921799011
DAL195,3p,18,T>A,280,346,626,2363236,2267374,4630610,0.0001351873727219
DAL195,3p,19,T>A,355,312,667,2363215,2267369,4630584,0.0001440423065427
DAL195,3p,20,T>A,257,328,585,2363222,2267380,4630602,0.0001263334659294
DAL195,3p,21,T>A,329,317,646,2363235,2267382,4630617,0.0001395062472236
DAL195,3p,22,T>A,293,268,561,2363231,2267383,4630614,0.0001211502405512
DAL195,3p,23,T>A,281,237,518,2363219,2267370,4630589,0.0001118648189247
DAL195,3p,24,T>A,331,338,669,2363198,2267373,4630571,0.000144474623108
DAL195,3p,25,T>A,261,383,644,2363180,2267377,4630557,0.0001390761413799
DAL195,5p,1,T>A,16,2,18,2363278,2267461,4630739,3.887068565082161e-06
DAL195,5p,2,T>A,9,4,13,2363264,2267447,4630711,2.8073442717543806e-06
DAL195,5p,3,T>A,168,47,215,2363278,2267459,4630737,4.6428894579847655e-05
DAL195,5p,4,T>A,66,64,130,2363278,2267461,4630739,2.8073272970037823e-05
DAL195,5p,5,T>A,374,177,551,2363277,2267461,4630738,0.0001189875134373
DAL195,5p,6,T>A,294,202,496,2363277,2267461,4630738,0.0001071103569236
DAL195,5p,7,T>A,243,138,381,2363277,2267461,4630738,8.227630239499622e-05
DAL195,5p,8,T>A,233,153,386,2363212,2267460,4630672,8.335723195251143e-05
DAL195,5p,9,T>A,217,187,404,2363181,2267461,4630642,8.724492197842113e-05
DAL195,5p,10,T>A,487,263,750,2363146,2267458,4630604,0.0001619659120062
DAL195,5p,11,T>A,297,164,461,2362948,2267450,4630398,9.955947631283532e-05
DAL195,5p,12,T>A,290,142,432,2362864,2267454,4630318,9.329812768799032e-05
DAL195,5p,13,T>A,301,244,545,2363073,2267445,4630518,0.0001176974152783
DAL195,5p,14,T>A,375,213,588,2363094,2267434,4630528,0.0001269833591331
DAL195,5p,15,T>A,402,217,619,2363178,2267432,4630610,0.0001336756928352
DAL195,5p,16,T>A,306,275,581,2363170,2267429,4630599,0.0001254697286463
DAL195,5p,17,T>A,356,182,538,2363159,2267431,4630590,0.000116183898812
DAL195,5p,18,T>A,298,261,559,2363182,2267420,4630602,0.0001207186452215
DAL195,5p,19,T>A,350,353,703,2363138,2267420,4630558,0.000151817556329
DAL195,5p,20,T>A,400,344,744,2363110,2267401,4630511,0.0001606734116385
DAL195,5p,21,T>A,483,240,723,2363086,2267400,4630486,0.0001561391180105
DAL195,5p,22,T>A,631,265,896,2363094,2267388,4630482,0.000193500374259
DAL195,5p,23,T>A,439,247,686,2363068,2267398,4630466,0.0001481492359516
DAL195,5p,24,T>A,496,309,805,2363067,2267402,4630469,0.000173848480575
DAL195,5p,25,T>A,403,241,644,2363135,2267374,4630509,0.0001390775830475
DAL212,3p,1,T>A,24,7,31,4131322,4008153,8139475,3.80859944898166e-06
DAL212,3p,2,T>A,40,12,52,4131322,4008153,8139475,6.388618430549882e-06
DAL212,3p,3,T>A,83,52,135,4131322,4008153,8139475,1.6585836310081423e-05
DAL212,3p,4,T>A,121,96,217,4131322,4008153,8139475,2.6660196142871624e-05
DAL212,3p,5,T>A,464,407,871,4131322,4008151,8139473,0.0001070093850056
DAL212,3p,6,T>A,363,424,787,4131322,4008151,8139473,9.668930654355632e-05
DAL212,3p,7,T>A,476,552,1028,4131322,4008153,8139475,0.0001262980720501
DAL212,3p,8,T>A,529,469,998,4131319,4008093,8139412,0.0001226132796816
DAL212,3p,9,T>A,423,535,958,4131316,4008115,8139431,0.0001176986450281
DAL212,3p,10,T>A,483,443,926,4131317,4008102,8139419,0.0001137673340075
DAL212,3p,11,T>A,429,449,878,4131313,4008105,8139418,0.0001078701204435
DAL212,3p,12,T>A,517,499,1016,4131314,4008034,8139348,0.0001248257231414
DAL212,3p,13,T>A,451,550,1001,4131307,4007923,8139230,0.0001229846066519
DAL212,3p,14,T>A,445,456,901,4131271,4007904,8139175,0.0001106991801994
DAL212,3p,15,T>A,514,429,943,4131254,4007935,8139189,0.0001158592090686
DAL212,3p,16,T>A,630,398,1028,4131236,4007982,8139218,0.0001263020599767
DAL212,3p,17,T>A,624,499,1123,4131249,4007981,8139230,0.0001379737395306
DAL212,3p,18,T>A,721,609,1330,4131222,4007954,8139176,0.0001634072048571
DAL212,3p,19,T>A,622,476,1098,4131233,4007956,8139189,0.0001349028754584
DAL212,3p,20,T>A,560,487,1047,4131221,4007928,8139149,0.0001286375270928
DAL212,3p,21,T>A,626,596,1222,4131228,4007917,8139145,0.0001501386202113
DAL212,3p,22,T>A,779,590,1369,4131183,4007898,8139081,0.000168200807929
DAL212,3p,23,T>A,591,619,1210,4131172,4007904,8139076,0.0001486655241946
DAL212,3p,24,T>A,644,656,1300,4131124,4007904,8139028,0.0001597242324267
DAL212,3p,25,T>A,560,549,1109,4131071,4007924,8138995,0.0001362576092011
DAL212,5p,1,T>A,5,6,11,4131322,4008153,8139475,1.3514385141547826e-06
DAL212,5p,2,T>A,5,5,10,4131307,4008143,8139450,1.2285842409499413e-06
DAL212,5p,3,T>A,163,114,277,4131321,4008153,8139474,3.403168312841837e-05
DAL212,5p,4,T>A,203,120,323,4131322,4008153,8139475,3.968314909745408e-05
DAL212,5p,5,T>A,1048,442,1490,4131322,4008153,8139475,0.0001830584896446
DAL212,5p,6,T>A,488,508,996,4131322,4008153,8139475,0.0001223666145543
DAL212,5p,7,T>A,415,267,682,4131322,4008153,8139475,8.378918787759653e-05
DAL212,5p,8,T>A,460,552,1012,4131248,4008153,8139401,0.0001243334736794
DAL212,5p,9,T>A,467,567,1034,4131243,4008153,8139396,0.0001270364533191
DAL212,5p,10,T>A,938,643,1581,4131179,4008148,8139327,0.0001942421038004
DAL212,5p,11,T>A,663,542,1205,4131234,4008143,8139377,0.000148045728807
DAL212,5p,12,T>A,541,451,992,4131187,4008141,8139328,0.0001218773834891
DAL212,5p,13,T>A,570,538,1108,4131181,4008142,8139323,0.0001361292579247
DAL212,5p,14,T>A,555,564,1119,4131134,4008108,8139242,0.0001374820898555
DAL212,5p,15,T>A,784,609,1393,4131156,4008091,8139247,0.0001711460531914
DAL212,5p,16,T>A,639,594,1233,4131154,4008081,8139235,0.0001514884384097
DAL212,5p,17,T>A,596,629,1225,4131159,4008081,8139240,0.0001505054525975
DAL212,5p,18,T>A,639,589,1228,4131113,4008066,8139179,0.0001508751681219
DAL212,5p,19,T>A,538,510,1048,4131040,4008052,8139092,0.0001287612918001
DAL212,5p,20,T>A,563,577,1140,4131020,4008040,8139060,0.0001400653146677
DAL212,5p,21,T>A,583,591,1174,4130973,4008040,8139013,0.0001442435341975
DAL212,5p,22,T>A,599,834,1433,4131015,4007967,8138982,0.0001760662451397
DAL212,5p,23,T>A,715,506,1221,4131005,4007962,8138967,0.0001500190380425
DAL212,5p,24,T>A,755,715,1470,4131060,4007918,8138978,0.0001806123569814
DAL212,5p,25,T>A,707,609,1316,4131016,4007614,8138630,0.000161697976195
DAL218,3p,1,T>A,49,33,82,6952891,6658031,13610922,6.024573500604882e-06
DAL218,3p,2,T>A,29,40,69,6952891,6658031,13610922,5.069458189533376e-06
DAL218,3p,3,T>A,190,146,336,6952891,6658030,13610921,2.468605908446607e-05
DAL218,3p,4,T>A,219,164,383,6952891,6658031,13610922,2.813916647233744e-05
DAL218,3p,5,T>A,1446,786,2232,6952891,6658031,13610922,0.0001639859518701
DAL218,3p,6,T>A,1027,784,1811,6952891,6658030,13610921,0.0001330549196487
DAL218,3p,7,T>A,966,1128,2094,6952891,6658026,13610917,0.000153847092007
DAL218,3p,8,T>A,991,734,1725,6952887,6657945,13610832,0.0001267372927679
DAL218,3p,9,T>A,1454,1071,2525,6952882,6657945,13610827,0.000185514076404
DAL218,3p,10,T>A,1384,1301,2685,6952881,6657960,13610841,0.00019726922091
DAL218,3p,11,T>A,1018,1095,2113,6952866,6657905,13610771,0.0001552446955429
DAL218,3p,12,T>A,1934,1074,3008,6952858,6657882,13610740,0.000221001944053
DAL218,3p,13,T>A,1542,1286,2828,6952870,6657811,13610681,0.000207777994356
DAL218,3p,14,T>A,1509,1098,2607,6952816,6657779,13610595,0.0001915419568358
DAL218,3p,15,T>A,1541,1056,2597,6952788,6657738,13610526,0.0001908082024162
DAL218,3p,16,T>A,1249,1147,2396,6952760,6657689,13610449,0.0001760412165682
DAL218,3p,17,T>A,1359,1036,2395,6952737,6657651,13610388,0.000175968532271
DAL218,3p,18,T>A,1399,1386,2785,6952711,6657672,13610383,0.0002046231909858
DAL218,3p,19,T>A,1561,1302,2863,6952716,6657697,13610413,0.0002103536461384
DAL218,3p,20,T>A,1668,1295,2963,6952697,6657752,13610449,0.0002177003859314
DAL218,3p,21,T>A,1923,1425,3348,6952660,6657692,13610352,0.0002459892293748
DAL218,3p,22,T>A,1915,944,2859,6952654,6657637,13610291,0.0002100616364484
DAL218,3p,23,T>A,1189,1388,2577,6952651,6657632,13610283,0.0001893421319747
DAL218,3p,24,T>A,2370,1199,3569,6952669,6657588,13610257,0.0002622287000164
DAL218,3p,25,T>A,2160,1102,3262,6952605,6657566,13610171,0.0002396736969726
DAL218,5p,1,T>A,4,14,18,6952891,6658031,13610922,1.3224673537913156e-06
DAL218,5p,2,T>A,11,28,39,6952874,6658014,13610888,2.865353090849032e-06
DAL218,5p,3,T>A,655,354,1009,6952891,6658031,13610922,7.413164222085763e-05
DAL218,5p,4,T>A,305,209,514,6952891,6658031,13610922,3.7763789991596456e-05
DAL218,5p,5,T>A,1248,747,1995,6952891,6658031,13610922,0.0001465734650452
DAL218,5p,6,T>A,1491,821,2312,6952891,6658031,13610922,0.0001698635845536
DAL218,5p,7,T>A,844,671,1515,6952888,6658031,13610919,0.0001113076934775
DAL218,5p,8,T>A,1338,804,2142,6952719,6658029,13610748,0.0001573756269677
DAL218,5p,9,T>A,1145,1345,2490,6952736,6658029,13610765,0.0001829434275002
DAL218,5p,10,T>A,2677,2132,4809,6952716,6658028,13610744,0.0003533238153623
DAL218,5p,11,T>A,1279,983,2262,6952715,6658016,13610731,0.000166192396279
DAL218,5p,12,T>A,1556,936,2492,6952625,6658005,13610630,0.000183092186034
DAL218,5p,13,T>A,1731,1000,2731,6952475,6658005,13610480,0.0002006542017621
DAL218,5p,14,T>A,1890,1089,2979,6952554,6657955,13610509,0.0002188749884372
DAL218,5p,15,T>A,1490,1088,2578,6952449,6657923,13610372,0.0001894143672193
DAL218,5p,16,T>A,1465,1134,2599,6952253,6657920,13610173,0.0001909601002132
DAL218,5p,17,T>A,1822,1090,2912,6952350,6657874,13610224,0.0002139568018865
DAL218,5p,18,T>A,2469,1187,3656,6952457,6657843,13610300,0.0002686200891971
DAL218,5p,19,T>A,2308,1113,3421,6952296,6657770,13610066,0.0002513580757066
DAL218,5p,20,T>A,1373,1103,2476,6952289,6657772,13610061,0.0001819242397223
DAL218,5p,21,T>A,1954,1238,3192,6952371,6657729,13610100,0.0002345317080697
DAL218,5p,22,T>A,1788,1423,3211,6952322,6657786,13610108,0.0002359275914636
DAL218,5p,23,T>A,1809,1224,3033,6952288,6657745,13610033,0.0002228503046245
DAL218,5p,24,T>A,1926,1490,3416,6952375,6657772,13610147,0.0002509892068028
DAL218,5p,25,T>A,1460,1287,2747,6952272,6657720,13609992,0.000201837003284
DAL224,3p,1,T>A,36,18,54,4609472,4586477,9195949,5.8721508786097004e-06
DAL224,3p,2,T>A,38,21,59,4609471,4586476,9195947,6.415869947923797e-06
DAL224,3p,3,T>A,125,95,220,4609472,4586477,9195949,2.392357765359508e-05
DAL224,3p,4,T>A,151,218,369,4609472,4586477,9195949,4.012636433716629e-05
DAL224,3p,5,T>A,343,841,1184,4609472,4586477,9195949,0.0001287523451902
DAL224,3p,6,T>A,424,368,792,4609472,4586477,9195949,8.612487955294228e-05
DAL224,3p,7,T>A,475,410,885,4609472,4586476,9195948,9.623803875359016e-05
DAL224,3p,8,T>A,485,973,1458,4609469,4586423,9195892,0.0001585490564699
DAL224,3p,9,T>A,516,594,1110,4609466,4586431,9195897,0.0001207060061677
DAL224,3p,10,T>A,642,417,1059,4609461,4586371,9195832,0.0001151608685326
DAL224,3p,11,T>A,524,490,1014,4609461,4586382,9195843,0.0001102672153058
DAL224,3p,12,T>A,735,693,1428,4609458,4586384,9195842,0.0001552875745364
DAL224,3p,13,T>A,755,503,1258,4609454,4586364,9195818,0.0001368013155545
DAL224,3p,14,T>A,647,753,1400,4609412,4586293,9195705,0.0001522449882852
DAL224,3p,15,T>A,764,664,1428,4609400,4586272,9195672,0.0001552904453312
DAL224,3p,16,T>A,669,621,1290,4609379,4586240,9195619,0.0001402841940276
DAL224,3p,17,T>A,720,681,1401,4609381,4586216,9195597,0.0001523555240622
DAL224,3p,18,T>A,618,655,1273,4609363,4586282,9195645,0.0001384350961786
DAL224,3p,19,T>A,674,560,1234,4609353,4586195,9195548,0.0001341953736743
DAL224,3p,20,T>A,666,630,1296,4609344,4586225,9195569,0.0001409374449802
DAL224,3p,21,T>A,826,589,1415,4609343,4586223,9195566,0.0001538785105778
DAL224,3p,22,T>A,601,567,1168,4609324,4586172,9195496,0.0001270187056793
DAL224,3p,23,T>A,688,676,1364,4609323,4586083,9195406,0.0001483349402951
DAL224,3p,24,T>A,765,1356,2121,4609325,4586202,9195527,0.0002306556220214
DAL224,3p,25,T>A,1189,659,1848,4609265,4586173,9195438,0.000200969219737
DAL224,5p,1,T>A,3,3,6,4609472,4586477,9195949,6.524612087344112e-07
DAL224,5p,2,T>A,7,17,24,4609461,4586469,9195930,2.6098502272200856e-06
DAL224,5p,3,T>A,1237,171,1408,4609468,4586477,9195945,0.0001531109635823
DAL224,5p,4,T>A,231,155,386,4609471,4586477,9195948,4.19750089930913e-05
DAL224,5p,5,T>A,500,365,865,4609471,4586477,9195948,9.406316782130564e-05
DAL224,5p,6,T>A,1683,456,2139,4609472,4586477,9195949,0.0002326024209138
DAL224,5p,7,T>A,312,303,615,4609471,4586477,9195948,6.68772811677491e-05
DAL224,5p,8,T>A,337,549,886,4609397,4586477,9195874,9.634755761116344e-05
DAL224,5p,9,T>A,441,852,1293,4609357,4586473,9195830,0.0001406072100071
DAL224,5p,10,T>A,656,726,1382,4609338,4586470,9195808,0.0001502858693874
DAL224,5p,11,T>A,533,430,963,4609388,4586469,9195857,0.0001047210716739
DAL224,5p,12,T>A,478,539,1017,4609357,4586464,9195821,0.0001105937142534
DAL224,5p,13,T>A,552,559,1111,4609320,4586461,9195781,0.0001208162743327
DAL224,5p,14,T>A,504,637,1141,4609270,4586428,9195698,0.0001240797599051
DAL224,5p,15,T>A,675,1389,2064,4609299,4586416,9195715,0.0002244523672166
DAL224,5p,16,T>A,643,705,1348,4609292,4586373,9195665,0.0001465908120837
DAL224,5p,17,T>A,603,589,1192,4609285,4586385,9195670,0.0001296262262564
DAL224,5p,18,T>A,616,648,1264,4609226,4586351,9195577,0.0001374573884814
DAL224,5p,19,T>A,732,800,1532,4609203,4586337,9195540,0.0001666025051274
DAL224,5p,20,T>A,763,554,1317,4609148,4586313,9195461,0.0001432228357012
DAL224,5p,21,T>A,1714,1099,2813,4609195,4586347,9195542,0.0003059091024759
DAL224,5p,22,T>A,586,629,1215,4609138,4586312,9195450,0.0001321305645726
DAL224,5p,23,T>A,662,702,1364,4609100,4586313,9195413,0.0001483348273753
DAL224,5p,24,T>A,616,740,1356,4609109,4586316,9195425,0.0001474646359466
DAL224,5p,25,T>A,658,798,1456,4609125,4586257,9195382,0.0001583403495363
DAL227,3p,1,T>A,25,18,43,3765386,3771243,7536629,5.70546858549094e-06
DAL227,3p,2,T>A,40,23,63,3765386,3771243,7536629,8.359174904323935e-06
DAL227,3p,3,T>A,145,58,203,3765386,3771243,7536629,2.6935119136154903e-05
DAL227,3p,4,T>A,140,108,248,3765386,3771243,7536629,3.290595835352914e-05
DAL227,3p,5,T>A,272,303,575,3765386,3771243,7536629,7.629405666644862e-05
DAL227,3p,6,T>A,383,296,679,3765386,3771243,7536629,9.00933295243802e-05
DAL227,3p,7,T>A,314,490,804,3765386,3771243,7536629,0.000106678994017
DAL227,3p,8,T>A,337,377,714,3765386,3771207,7536593,9.473776811352293e-05
DAL227,3p,9,T>A,655,355,1010,3765384,3771218,7536602,0.0001340126492018
DAL227,3p,10,T>A,350,279,629,3765382,3771209,7536591,8.345948453352451e-05
DAL227,3p,11,T>A,377,392,769,3765378,3771214,7536592,0.0001020355088878
DAL227,3p,12,T>A,583,402,985,3765377,3771173,7536550,0.0001306964061805
DAL227,3p,13,T>A,625,380,1005,3765373,3771183,7536556,0.0001333500341535
DAL227,3p,14,T>A,487,453,940,3765341,3771166,7536507,0.0001247262160043
DAL227,3p,15,T>A,707,570,1277,3765341,3771186,7536527,0.0001694414416613
DAL227,3p,16,T>A,459,480,939,3765340,3771079,7536419,0.0001245949833734
DAL227,3p,17,T>A,583,806,1389,3765328,3771049,7536377,0.0001843060664295
DAL227,3p,18,T>A,675,469,1144,3765321,3771036,7536357,0.0001517974798699
DAL227,3p,19,T>A,549,648,1197,3765313,3771111,7536424,0.000158828643399
DAL227,3p,20,T>A,610,606,1216,3765308,3771082,7536390,0.000161350460897
DAL227,3p,21,T>A,1121,495,1616,3765307,3771104,7536411,0.0002144256729098
DAL227,3p,22,T>A,708,713,1421,3765309,3771137,7536446,0.0001885504122234
DAL227,3p,23,T>A,955,556,1511,3765319,3771112,7536431,0.0002004927796725
DAL227,3p,24,T>A,929,797,1726,3765312,3771081,7536393,0.0002290220268502
DAL227,3p,25,T>A,719,527,1246,3765249,3771100,7536349,0.000165332046061
DAL227,5p,1,T>A,3,4,7,3765386,3771243,7536629,9.287972115915484e-07
DAL227,5p,2,T>A,10,33,43,3765373,3771238,7536611,5.705482212097719e-06
DAL227,5p,3,T>A,316,413,729,3765386,3771243,7536629,9.672759532146268e-05
DAL227,5p,4,T>A,211,217,428,3765385,3771243,7536628,5.678932275813534e-05
DAL227,5p,5,T>A,351,394,745,3765386,3771242,7536628,9.885057349254866e-05
DAL227,5p,6,T>A,672,660,1332,3765386,3771243,7536629,0.0001767368408342
DAL227,5p,7,T>A,116,233,349,3765386,3771243,7536629,4.6307175263635774e-05
DAL227,5p,8,T>A,451,313,764,3765342,3771242,7536584,0.0001013721866564
DAL227,5p,9,T>A,413,393,806,3765324,3771243,7536567,0.0001069452444329
DAL227,5p,10,T>A,614,572,1186,3765318,3771238,7536556,0.0001573663089612
DAL227,5p,11,T>A,461,527,988,3765365,3771237,7536602,0.0001310935617934
DAL227,5p,12,T>A,479,396,875,3765326,3771232,7536558,0.0001161007451942
DAL227,5p,13,T>A,661,451,1112,3765325,3771231,7536556,0.0001475475004763
DAL227,5p,14,T>A,440,495,935,3765297,3771226,7536523,0.0001240625153004
DAL227,5p,15,T>A,410,458,868,3765318,3771201,7536519,0.0001151725352248
DAL227,5p,16,T>A,377,638,1015,3765316,3771188,7536504,0.000134677829402
DAL227,5p,17,T>A,491,588,1079,3765326,3771175,7536501,0.0001431698874583
DAL227,5p,18,T>A,539,454,993,3765280,3771169,7536449,0.0001317596655931
DAL227,5p,19,T>A,451,560,1011,3765279,3771164,7536443,0.0001341481651224
DAL227,5p,20,T>A,439,541,980,3765254,3771167,7536421,0.0001300351984051
DAL227,5p,21,T>A,367,725,1092,3765270,3771169,7536439,0.0001448960178673
DAL227,5p,22,T>A,521,623,1144,3765253,3771158,7536411,0.0001517963922084
DAL227,5p,23,T>A,458,625,1083,3765254,3771157,7536411,0.0001437023538127
DAL227,5p,24,T>A,467,587,1054,3765270,3771180,7536450,0.0001398536446204
DAL227,5p,25,T>A,411,463,874,3765247,3771148,7536395,0.0001159705668293
WA02,3p,1,T>A,12,38,50,6552698,6754258,13306956,3.757433330357446e-06
WA02,3p,2,T>A,40,34,74,6552698,6754258,13306956,5.56100132892902e-06
WA02,3p,3,T>A,70,56,126,6552698,6754258,13306956,9.468731992500764e-06
WA02,3p,4,T>A,122,100,222,6552698,6754256,13306954,1.6683006494198448e-05
WA02,3p,5,T>A,382,364,746,6552698,6754256,13306954,5.606091371473892e-05
WA02,3p,6,T>A,357,381,738,6552698,6754257,13306955,5.5459720123799925e-05
WA02,3p,7,T>A,370,415,785,6552698,6754257,13306955,5.899170771976008e-05
WA02,3p,8,T>A,519,380,899,6552692,6754207,13306899,6.755894066679247e-05
WA02,3p,9,T>A,482,539,1021,6552688,6754191,13306879,7.672723258398908e-05
WA02,3p,10,T>A,603,614,1217,6552680,6754207,13306887,9.145640148593732e-05
WA02,3p,11,T>A,644,586,1230,6552667,6754202,13306869,9.243346425068136e-05
WA02,3p,12,T>A,508,709,1217,6552670,6754189,13306859,9.145659392648556e-05
WA02,3p,13,T>A,551,656,1207,6552675,6754177,13306852,9.070514949741684e-05
WA02,3p,14,T>A,490,696,1186,6552653,6754155,13306808,8.912730987025588e-05
WA02,3p,15,T>A,534,623,1157,6552632,6754146,13306778,8.694817032342464e-05
WA02,3p,16,T>A,591,580,1171,6552629,6754119,13306748,8.800046412541968e-05
WA02,3p,17,T>A,589,609,1198,6552608,6754116,13306724,9.002967221684316e-05
WA02,3p,18,T>A,650,584,1234,6552611,6754085,13306696,9.273526651544456e-05
WA02,3p,19,T>A,696,541,1237,6552605,6754056,13306661,9.296096143127116e-05
WA02,3p,20,T>A,687,645,1332,6552618,6754033,13306651,0.0001001003182543
WA02,3p,21,T>A,711,775,1486,6552597,6754089,13306686,0.0001116731844427
WA02,3p,22,T>A,650,694,1344,6552593,6754062,13306655,0.0001010020925619
WA02,3p,23,T>A,646,670,1316,6552585,6754052,13306637,9.889801608024628e-05
WA02,3p,24,T>A,606,749,1355,6552556,6754026,13306582,0.0001018293052265
WA02,3p,25,T>A,679,837,1516,6552517,6754038,13306555,0.0001139288117773
WA02,5p,1,T>A,11,20,31,6552698,6754258,13306956,2.3296086648216166e-06
WA02,5p,2,T>A,30,32,62,6552562,6754179,13306741,4.659292609663027e-06
WA02,5p,3,T>A,315,166,481,6552698,6754258,13306956,3.614650863803863e-05
WA02,5p,4,T>A,445,209,654,6552698,6754258,13306956,4.914722796107539e-05
WA02,5p,5,T>A,600,400,1000,6552698,6754258,13306956,7.514866660714892e-05
WA02,5p,6,T>A,806,450,1256,6552697,6754258,13306955,9.438673235161612e-05
WA02,5p,7,T>A,395,443,838,6552685,6754258,13306943,6.297464413877778e-05
WA02,5p,8,T>A,620,535,1155,6552655,6754257,13306912,8.679699692911473e-05
WA02,5p,9,T>A,567,833,1400,6552662,6754226,13306888,0.0001052086708778
WA02,5p,10,T>A,1117,1262,2379,6552618,6754222,13306840,0.0001787802363295
WA02,5p,11,T>A,712,685,1397,6552625,6754225,13306850,0.0001049835235235
WA02,5p,12,T>A,623,497,1120,6552628,6754236,13306864,8.416708850409833e-05
WA02,5p,13,T>A,617,805,1422,6552614,6754205,13306819,0.000106862504104
WA02,5p,14,T>A,695,805,1500,6552607,6754183,13306790,0.0001127244061114
WA02,5p,15,T>A,755,766,1521,6552586,6754168,13306754,0.0001143028570303
WA02,5p,16,T>A,701,879,1580,6552525,6754178,13306703,0.0001187371507427
WA02,5p,17,T>A,617,656,1273,6552567,6754148,13306715,9.566598518116606e-05
WA02,5p,18,T>A,850,669,1519,6552548,6754087,13306635,0.0001141535782712
WA02,5p,19,T>A,634,599,1233,6552516,6754124,13306640,9.266050633368005e-05
WA02,5p,20,T>A,708,706,1414,6552507,6754132,13306639,0.0001062627459871
WA02,5p,21,T>A,886,984,1870,6552521,6754152,13306673,0.0001405309952382
WA02,5p,22,T>A,713,666,1379,6552516,6754117,13306633,0.0001036325267255
WA02,5p,23,T>A,759,761,1520,6552465,6754131,13306596,0.0001142290635411
WA02,5p,24,T>A,914,698,1612,6552457,6754135,13306592,0.0001211429643292
WA02,5p,25,T>A,815,866,1681,6552470,6754083,13306553,0.0001263287344213
WA03,3p,1,T>A,40,63,103,5399458,5543742,10943200,9.412237736676656e-06
WA03,3p,2,T>A,62,84,146,5399458,5543742,10943200,1.3341618539366912e-05
WA03,3p,3,T>A,142,112,254,5399458,5543742,10943200,2.321076102054244e-05
WA03,3p,4,T>A,291,352,643,5399458,5543736,10943194,5.875798235871538e-05
WA03,3p,5,T>A,1080,1114,2194,5399458,5543740,10943198,0.000200489838528
WA03,3p,6,T>A,1070,1226,2296,5399458,5543741,10943199,0.0002098106778465
WA03,3p,7,T>A,1122,1115,2237,5399458,5543739,10943197,0.0002044192387288
WA03,3p,8,T>A,1321,1243,2564,5399449,5543673,10943122,0.0002343024230196
WA03,3p,9,T>A,1405,1627,3032,5399436,5543670,10943106,0.0002770694170375
WA03,3p,10,T>A,1398,1652,3050,5399438,5543654,10943092,0.0002787146448188
WA03,3p,11,T>A,1398,1505,2903,5399404,5543644,10943048,0.0002652825794056
WA03,3p,12,T>A,1598,1819,3417,5399397,5543595,10942992,0.0003122546374885
WA03,3p,13,T>A,1476,2023,3499,5399378,5543551,10942929,0.0003197498585616
WA03,3p,14,T>A,1571,1785,3356,5399356,5543493,10942849,0.0003066843013186
WA03,3p,15,T>A,2404,2291,4695,5399349,5543505,10942854,0.000429047120614
WA03,3p,16,T>A,1642,2012,3654,5399342,5543495,10942837,0.0003339170637376
WA03,3p,17,T>A,1412,1782,3194,5399346,5543438,10942784,0.0002918818465209
WA03,3p,18,T>A,1611,2545,4156,5399325,5543443,10942768,0.0003797942166004
WA03,3p,19,T>A,1532,1704,3236,5399297,5543425,10942722,0.0002957216677897
WA03,3p,20,T>A,1584,1475,3059,5399252,5543409,10942661,0.0002795480916387
WA03,3p,21,T>A,1544,1989,3533,5399248,5543303,10942551,0.000322868040551
WA03,3p,22,T>A,1633,1502,3135,5399256,5543263,10942519,0.0002864971036376
WA03,3p,23,T>A,1678,1393,3071,5399255,5543267,10942522,0.0002806482819956
WA03,3p,24,T>A,1692,1712,3404,5399198,5543130,10942328,0.0003110855386532
WA03,3p,25,T>A,1718,1523,3241,5399050,5543142,10942192,0.000296192938307
WA03,5p,1,T>A,16,21,37,5399457,5543742,10943199,3.3810954182593223e-06
WA03,5p,2,T>A,56,68,124,5399258,5543638,10942896,1.133155245192863e-05
WA03,5p,3,T>A,1168,961,2129,5399457,5543742,10943199,0.0001945500579857
WA03,5p,4,T>A,708,382,1090,5399458,5543742,10943200,9.960523430075296e-05
WA03,5p,5,T>A,1539,1681,3220,5399456,5543740,10943196,0.0002942467630114
WA03,5p,6,T>A,2219,1459,3678,5399452,5543742,10943194,0.0003360993143318
WA03,5p,7,T>A,1212,1018,2230,5399453,5543742,10943195,0.0002037796091543
WA03,5p,8,T>A,1407,1179,2586,5399403,5543732,10943135,0.0002363125374949
WA03,5p,9,T>A,1864,1541,3405,5399319,5543732,10943051,0.0003111563676345
WA03,5p,10,T>A,3005,2279,5284,5399344,5543717,10943061,0.0004828630672898
WA03,5p,11,T>A,1728,1958,3686,5399321,5543705,10943026,0.0003368355334255
WA03,5p,12,T>A,2324,1711,4035,5399213,5543665,10942878,0.0003687329786551
WA03,5p,13,T>A,2102,2314,4416,5399156,5543662,10942818,0.0004035523573543
WA03,5p,14,T>A,2006,1626,3632,5399124,5543629,10942753,0.0003319091639919
WA03,5p,15,T>A,2178,2025,4203,5399092,5543505,10942597,0.0003840952929181
WA03,5p,16,T>A,2271,2043,4314,5399083,5543501,10942584,0.000394239605563
WA03,5p,17,T>A,2054,1765,3819,5399113,5543491,10942604,0.0003490028516064
WA03,5p,18,T>A,2311,1855,4166,5399074,5543600,10942674,0.0003807113325317
WA03,5p,19,T>A,2213,1787,4000,5399071,5543546,10942617,0.0003655432699508
WA03,5p,20,T>A,2016,1821,3837,5399050,5543533,10942583,0.0003506484712064
WA03,5p,21,T>A,2308,1683,3991,5399034,5543509,10942543,0.0003647232640529
WA03,5p,22,T>A,2115,1636,3751,5398989,5543454,10942443,0.0003427936522036
WA03,5p,23,T>A,1988,1544,3532,5398935,5543457,10942392,0.0003227813443349
WA03,5p,24,T>A,2345,1842,4187,5398952,5543428,10942380,0.0003826407052213
WA03,5p,25,T>A,1902,1772,3674,5398991,5543444,10942435,0.000335757077835
WA07,3p,1,T>A,26,14,40,5691729,6013979,11705708,3.4171363235782063e-06
WA07,3p,2,T>A,84,30,114,5691729,6013979,11705708,9.738838522197889e-06
WA07,3p,3,T>A,105,22,127,5691729,6013979,11705708,1.0849407827360806e-05
WA07,3p,4,T>A,140,184,324,5691729,6013979,11705708,2.7678804220983477e-05
WA07,3p,5,T>A,529,457,986,5691729,6013979,11705708,8.423241037620279e-05
WA07,3p,6,T>A,443,531,974,5691729,6013979,11705708,8.320726947912932e-05
WA07,3p,7,T>A,399,412,811,5691729,6013979,11705708,6.928243896054813e-05
WA07,3p,8,T>A,427,405,832,5691713,6013800,11705513,7.107761957976553e-05
WA07,3p,9,T>A,750,314,1064,5691720,6013901,11705621,9.089650177466024e-05
WA07,3p,10,T>A,694,489,1183,5691718,6013892,11705610,0.0001010626528647
WA07,3p,11,T>A,571,411,982,5691711,6013883,11705594,8.389151374975076e-05
WA07,3p,12,T>A,741,473,1214,5691705,6013884,11705589,0.000103711141746
WA07,3p,13,T>A,648,541,1189,5691711,6013848,11705559,0.000101575670158
WA07,3p,14,T>A,740,406,1146,5691695,6013877,11705572,9.790209312283072e-05
WA07,3p,15,T>A,714,520,1234,5691211,6013856,11705067,0.0001054244285829
WA07,3p,16,T>A,807,609,1416,5691636,6013850,11705486,0.0001209689200431
WA07,3p,17,T>A,1069,1180,2249,5691662,6013813,11705475,0.0001921323141521
WA07,3p,18,T>A,899,832,1731,5691639,6013769,11705408,0.000147880364358
WA07,3p,19,T>A,771,580,1351,5691628,6013742,11705370,0.0001154171119751
WA07,3p,20,T>A,850,559,1409,5691604,6013772,11705376,0.0001203720410177
WA07,3p,21,T>A,833,606,1439,5691611,6013735,11705346,0.0001229352810245
WA07,3p,22,T>A,883,531,1414,5691577,6013736,11705313,0.0001207998453351
WA07,3p,23,T>A,968,540,1508,5691568,6013670,11705238,0.0001288312121462
WA07,3p,24,T>A,909,653,1562,5691554,6013661,11705215,0.000133444793624
WA07,3p,25,T>A,1040,587,1627,5691455,6013662,11705117,0.0001389990377712
WA07,5p,1,T>A,6,13,19,5691729,6013979,11705708,1.623139753699648e-06
WA07,5p,2,T>A,2,29,31,5691636,6013923,11705559,2.648314360723824e-06
WA07,5p,3,T>A,316,160,476,5691729,6013979,11705708,4.066392225058066e-05
WA07,5p,4,T>A,336,196,532,5691728,6013979,11705707,4.544791698613335e-05
WA07,5p,5,T>A,683,458,1141,5691729,6013978,11705707,9.747382195710178e-05
WA07,5p,6,T>A,797,567,1364,5691728,6013979,11705707,0.0001165243585885
WA07,5p,7,T>A,572,327,899,5691728,6013979,11705707,7.680014543333436e-05
WA07,5p,8,T>A,542,444,986,5691579,6013975,11705554,8.423351855025401e-05
WA07,5p,9,T>A,567,481,1048,5691672,6013971,11705643,8.952946882114891e-05
WA07,5p,10,T>A,816,822,1638,5691582,6013961,11705543,0.0001399337049122
WA07,5p,11,T>A,696,604,1300,5691326,6013942,11705268,0.0001110611051365
WA07,5p,12,T>A,769,722,1491,5691520,6013938,11705458,0.0001273764768537
WA07,5p,13,T>A,619,683,1302,5691511,6013949,11705460,0.0001112301438815
WA07,5p,14,T>A,648,443,1091,5691556,6013950,11705506,9.320400160403148e-05
WA07,5p,15,T>A,642,592,1234,5691563,6013633,11705196,0.000105423266727
WA07,5p,16,T>A,792,706,1498,5691534,6013925,11705459,0.0001279744775493
WA07,5p,17,T>A,754,901,1655,5691561,6013916,11705477,0.0001413868055099
WA07,5p,18,T>A,669,447,1116,5691474,6013905,11705379,9.534078307075748e-05
WA07,5p,19,T>A,694,602,1296,5691482,6013884,11705366,0.0001107184516913
WA07,5p,20,T>A,839,2071,2910,5691421,6013876,11705297,0.0002486053963432
WA07,5p,21,T>A,812,704,1516,5691379,6013853,11705232,0.0001295147332406
WA07,5p,22,T>A,787,792,1579,5691396,6013861,11705257,0.0001348966537001
WA07,5p,23,T>A,794,755,1549,5691314,6013795,11705109,0.0001323353759456
WA07,5p,24,T>A,948,571,1519,5691332,6013785,11705117,0.0001297723038565
WA07,5p,25,T>A,791,896,1687,5691334,6013719,11705053,0.0001441257890929
WA08,3p,1,T>A,36,59,95,6798117,7189085,13987202,6.7919230736783526e-06
WA08,3p,2,T>A,37,44,81,6798117,7189085,13987202,5.791008094399437e-06
WA08,3p,3,T>A,84,115,199,6798117,7189085,13987202,1.4227291491178864e-05
WA08,3p,4,T>A,87,162,249,6798117,7189081,13987198,1.780199293668396e-05
WA08,3p,5,T>A,413,366,779,6798117,7189085,13987202,5.569376920416249e-05
WA08,3p,6,T>A,424,357,781,6798117,7189085,13987202,5.583675705834519e-05
WA08,3p,7,T>A,427,402,829,6798117,7189084,13987201,5.9268469796065706e-05
WA08,3p,8,T>A,591,434,1025,6798110,7189053,13987163,7.328147959668447e-05
WA08,3p,9,T>A,484,734,1218,6798103,7189051,13987154,8.707990203010562e-05
WA08,3p,10,T>A,542,703,1245,6798074,7189042,13987116,8.901048650772612e-05
WA08,3p,11,T>A,606,645,1251,6798109,7189046,13987155,8.943920332619463e-05
WA08,3p,12,T>A,601,798,1399,6798091,7189018,13987109,0.0001000206690317
WA08,3p,13,T>A,623,776,1399,6798090,7189013,13987103,0.0001000207119372
WA08,3p,14,T>A,570,473,1043,6798067,7188981,13987048,7.456898696565565e-05
WA08,3p,15,T>A,679,619,1298,6798069,7188978,13987047,9.280014573483596e-05
WA08,3p,16,T>A,606,600,1206,6798049,7188961,13987010,8.622285963905081e-05
WA08,3p,17,T>A,757,624,1381,6798000,7188943,13986943,9.873494158087296e-05
WA08,3p,18,T>A,830,638,1468,6798023,7188956,13986979,0.0001049547582791
WA08,3p,19,T>A,640,733,1373,6798028,7188946,13986974,9.816276200985288e-05
WA08,3p,20,T>A,662,542,1204,6798009,7188917,13986926,8.60803867840582e-05
WA08,3p,21,T>A,682,646,1328,6798010,7188926,13986936,9.49457407969837e-05
WA08,3p,22,T>A,620,613,1233,6798012,7188920,13986932,8.815371376653579e-05
WA08,3p,23,T>A,642,639,1281,6798009,7188864,13986873,9.15858748413602e-05
WA08,3p,24,T>A,738,831,1569,6798015,7188867,13986882,0.0001121765379875
WA08,3p,25,T>A,668,833,1501,6797966,7188892,13986858,0.0001073150238602
WA08,5p,1,T>A,18,11,29,6798116,7189085,13987201,2.0733240338792587e-06
WA08,5p,2,T>A,51,50,101,6797941,7188997,13986938,7.221022928678171e-06
WA08,5p,3,T>A,419,210,629,6798117,7189084,13987201,4.496968335551909e-05
WA08,5p,4,T>A,321,146,467,6798115,7189085,13987200,3.338766872569206e-05
WA08,5p,5,T>A,573,495,1068,6798116,7189084,13987200,7.635552505147563e-05
WA08,5p,6,T>A,767,665,1432,6798112,7189085,13987197,0.0001023793401923
WA08,5p,7,T>A,396,552,948,6798110,7189085,13987195,6.777627680174617e-05
WA08,5p,8,T>A,592,638,1230,6798069,7189064,13987133,8.793796412745914e-05
WA08,5p,9,T>A,619,632,1251,6798054,7189067,13987121,8.943942073568964e-05
WA08,5p,10,T>A,1213,876,2089,6798015,7189037,13987052,0.0001493524153624
WA08,5p,11,T>A,800,838,1638,6797997,7189047,13987044,0.0001171083754365
WA08,5p,12,T>A,755,598,1353,6798016,7189056,13987072,9.673218240386553e-05
WA08,5p,13,T>A,589,812,1401,6797995,7189043,13987038,0.0001001641662802
WA08,5p,14,T>A,650,717,1367,6797984,7189041,13987025,9.773343509431062e-05
WA08,5p,15,T>A,811,707,1518,6797997,7189013,13987010,0.0001085292710879
WA08,5p,16,T>A,731,725,1456,6797921,7188997,13986918,0.0001040972714646
WA08,5p,17,T>A,711,639,1350,6797959,7188875,13986834,9.651934097451932e-05
WA08,5p,18,T>A,831,790,1621,6797991,7188972,13986963,0.0001158936360952
WA08,5p,19,T>A,762,669,1431,6797966,7188988,13986954,0.0001023096236678
WA08,5p,20,T>A,732,767,1499,6797883,7188971,13986854,0.0001071720631387
WA08,5p,21,T>A,823,727,1550,6797885,7188979,13986864,0.0001108182649091
WA08,5p,22,T>A,649,675,1324,6797887,7188939,13986826,9.466050410579212e-05
WA08,5p,23,T>A,679,710,1389,6797851,7188919,13986770,9.93081318989302e-05
WA08,5p,24,T>A,797,726,1523,6797841,7188876,13986717,0.0001088890266386
WA08,5p,25,T>A,843,659,1502,6797835,7188817,13986652,0.0001073881011696
WA09,3p,1,T>A,71,86,157,4741672,4881751,9623423,1.6314361324447653e-05
WA09,3p,2,T>A,67,101,168,4741672,4881751,9623423,1.745740574845354e-05
WA09,3p,3,T>A,117,128,245,4741672,4881751,9623423,2.5458716716494743e-05
WA09,3p,4,T>A,212,134,346,4741672,4881748,9623420,3.595395399972151e-05
WA09,3p,5,T>A,1229,1098,2327,4741672,4881751,9623423,0.0002418058522419
WA09,3p,6,T>A,1160,1070,2230,4741672,4881751,9623423,0.0002317262786848
WA09,3p,7,T>A,1269,1211,2480,4741672,4881748,9623420,0.0002577046413852
WA09,3p,8,T>A,1362,1245,2607,4741663,4881718,9623381,0.000270902710804
WA09,3p,9,T>A,1262,1573,2835,4741664,4881723,9623387,0.0002945948240468
WA09,3p,10,T>A,1600,1822,3422,4741658,4881705,9623363,0.0003555929460418
WA09,3p,11,T>A,1550,1525,3075,4741648,4881712,9623360,0.0003195349649186
WA09,3p,12,T>A,1567,1786,3353,4741642,4881680,9623322,0.0003484243798555
WA09,3p,13,T>A,1428,1379,2807,4741628,4881645,9623273,0.0002916887009232
WA09,3p,14,T>A,1544,1500,3044,4741616,4881571,9623187,0.0003163193233177
WA09,3p,15,T>A,1671,1652,3323,4741598,4881557,9623155,0.0003453129457023
WA09,3p,16,T>A,1604,1559,3163,4741586,4881546,9623132,0.0003286871675458
WA09,3p,17,T>A,1630,1616,3246,4741582,4881528,9623110,0.0003373129892519
WA09,3p,18,T>A,1548,1902,3450,4741560,4881490,9623050,0.0003585141924857
WA09,3p,19,T>A,1577,1665,3242,4741552,4881442,9622994,0.00033690138433
WA09,3p,20,T>A,1583,1599,3182,4741534,4881501,9623035,0.0003306649097711
WA09,3p,21,T>A,1663,1884,3547,4741546,4881493,9623039,0.0003685945780745
WA09,3p,22,T>A,1682,1584,3266,4741524,4881498,9623022,0.0003393944230824
WA09,3p,23,T>A,1722,1709,3431,4741501,4881486,9622987,0.0003565421007011
WA09,3p,24,T>A,1765,2225,3990,4741491,4881450,9622941,0.0004146341539452
WA09,3p,25,T>A,1743,1708,3451,4741451,4881469,9622920,0.0003586229543631
WA09,5p,1,T>A,17,28,45,4741672,4881751,9623423,4.676090825478626e-06
WA09,5p,2,T>A,38,52,90,4741495,4881667,9623162,9.352435301411324e-06
WA09,5p,3,T>A,317,173,490,4741672,4881750,9623422,5.091743872397989e-05
WA09,5p,4,T>A,355,293,648,4741672,4881751,9623423,6.733570788689222e-05
WA09,5p,5,T>A,1414,1869,3283,4741671,4881751,9623422,0.0003411468394506
WA09,5p,6,T>A,1698,1610,3308,4741669,4881751,9623420,0.0003437447393961
WA09,5p,7,T>A,1018,1239,2257,4741667,4881751,9623418,0.0002345320550349
WA09,5p,8,T>A,1334,1226,2560,4741639,4881744,9623383,0.0002660187171185
WA09,5p,9,T>A,1625,1316,2941,4741618,4881747,9623365,0.0003056103556292
WA09,5p,10,T>A,2796,2276,5072,4741622,4881737,9623359,0.0005270508977166
WA09,5p,11,T>A,1595,1951,3546,4741614,4881733,9623347,0.0003684788670719
WA09,5p,12,T>A,1576,1648,3224,4741580,4881734,9623314,0.0003350197239745
WA09,5p,13,T>A,1853,1730,3583,4741530,4881708,9623238,0.0003723279004426
WA09,5p,14,T>A,1647,1823,3470,4741498,4881705,9623203,0.0003605868025438
WA09,5p,15,T>A,2162,1722,3884,4741496,4881672,9623168,0.0004036092895811
WA09,5p,16,T>A,1880,1777,3657,4741451,4881636,9623087,0.0003800235828689
WA09,5p,17,T>A,1875,1734,3609,4741476,4881638,9623114,0.0003750345262458
WA09,5p,18,T>A,2372,1637,4009,4741455,4881610,9623065,0.0004166032340008
WA09,5p,19,T>A,1900,1805,3705,4741379,4881580,9622959,0.0003850167084781
WA09,5p,20,T>A,1794,1661,3455,4741390,4881557,9622947,0.0003590376212193
WA09,5p,21,T>A,1913,1888,3801,4741379,4881587,9622966,0.0003949925625841
WA09,5p,22,T>A,1873,1581,3454,4741354,4881580,9622934,0.0003589341878474
WA09,5p,23,T>A,1622,1384,3006,4741312,4881565,9622877,0.0003123805905448
WA09,5p,24,T>A,1786,1619,3405,4741363,4881548,9622911,0.0003538430314901
WA09,5p,25,T>A,2846,1581,4427,4741301,4881503,9622804,0.0004600530157322
WA11,3p,1,T>A,31,53,84,9756642,10108269,19864911,4.228561607952837e-06
WA11,3p,2,T>A,72,108,180,9756642,10108269,19864911,9.061203445613222e-06
WA11,3p,3,T>A,442,100,542,9756642,10108269,19864911,2.7284290375124256e-05
WA11,3p,4,T>A,266,309,575,9756642,10108267,19864909,2.8945513921055463e-05
WA11,3p,5,T>A,977,1068,2045,9756642,10108269,19864911,0.0001029453391459
WA11,3p,6,T>A,1089,991,2080,9756642,10108269,19864911,0.0001047072398159
WA11,3p,7,T>A,1106,1184,2290,9756642,10108265,19864907,0.0001152786670483
WA11,3p,8,T>A,1179,1215,2394,9756629,10108160,19864789,0.0001205147459658
WA11,3p,9,T>A,1443,1358,2801,9756610,10108092,19864702,0.0001410038771283
WA11,3p,10,T>A,1527,1661,3188,9756615,10107969,19864584,0.0001604866228258
WA11,3p,11,T>A,1528,1370,2898,9756587,10107918,19864505,0.0001458883571475
WA11,3p,12,T>A,1536,1430,2966,9756581,10108019,19864600,0.0001493108343485
WA11,3p,13,T>A,1512,1435,2947,9756565,10107963,19864528,0.0001483548967284
WA11,3p,14,T>A,1380,1698,3078,9756515,10107914,19864429,0.0001549503386178
WA11,3p,15,T>A,1505,1562,3067,9756471,10107972,19864443,0.0001543964761559
WA11,3p,16,T>A,1392,1579,2971,9756477,10108011,19864488,0.0001495633816486
WA11,3p,17,T>A,1383,1380,2763,9756469,10108044,19864513,0.0001390922596491
WA11,3p,18,T>A,2150,1395,3545,9756421,10108016,19864437,0.0001784596261147
WA11,3p,19,T>A,1490,1319,2809,9756438,10108000,19864438,0.0001414084808238
WA11,3p,20,T>A,1610,1436,3046,9756433,10107963,19864396,0.0001533396736553
WA11,3p,21,T>A,1859,1557,3416,9756421,10107904,19864325,0.0001719665782753
WA11,3p,22,T>A,1716,1326,3042,9756405,10107842,19864247,0.0001531394570355
WA11,3p,23,T>A,1963,1268,3231,9756375,10107816,19864191,0.0001626544972307
WA11,3p,24,T>A,1871,1636,3507,9756358,10107704,19864062,0.000176549992645
WA11,3p,25,T>A,1838,1395,3233,9756281,10107693,19863974,0.0001627569589045
WA11,5p,1,T>A,48,30,78,9756641,10108269,19864910,3.92652169076024e-06
WA11,5p,2,T>A,62,76,138,9756471,10108196,19864667,6.947007971490285e-06
WA11,5p,3,T>A,1407,649,2056,9756642,10108269,19864911,0.0001034990793565
WA11,5p,4,T>A,712,396,1108,9756638,10108269,19864907,5.5776752440874753e-05
WA11,5p,5,T>A,1561,1125,2686,9756638,10108267,19864905,0.000135213332256
WA11,5p,6,T>A,2286,1550,3836,9756642,10108269,19864911,0.0001931043134298
WA11,5p,7,T>A,1386,1150,2536,9756629,10108269,19864898,0.0001276623720897
WA11,5p,8,T>A,1667,1202,2869,9756500,10108261,19864761,0.0001444266054849
WA11,5p,9,T>A,1695,1338,3033,9756493,10108240,19864733,0.000152682646175
WA11,5p,10,T>A,2552,1760,4312,9756446,10108197,19864643,0.0002170690910478
WA11,5p,11,T>A,1871,1392,3263,9756457,10108195,19864652,0.000164261624115
WA11,5p,12,T>A,1641,1284,2925,9756411,10108221,19864632,0.0001472466240502
WA11,5p,13,T>A,1937,1588,3525,9756334,10108178,19864512,0.0001774521317211
WA11,5p,14,T>A,1915,1588,3503,9756261,10108167,19864428,0.0001763453747573
WA11,5p,15,T>A,2365,1537,3902,9756237,10108096,19864333,0.0001964324701967
WA11,5p,16,T>A,1983,1618,3601,9756275,10108079,19864354,0.0001812794918978
WA11,5p,17,T>A,1775,1583,3358,9756369,10108078,19864447,0.0001690457328109
WA11,5p,18,T>A,2233,1766,3999,9756327,10108075,19864402,0.0002013148948556
WA11,5p,19,T>A,2186,1627,3813,9756284,10108088,19864372,0.0001919517012669
WA11,5p,20,T>A,2115,1526,3641,9756292,10108082,19864374,0.0001832929645807
WA11,5p,21,T>A,1871,1613,3484,9756251,10108036,19864287,0.0001753901360768
WA11,5p,22,T>A,2102,1659,3761,9756136,10108029,19864165,0.0001893359222499
WA11,5p,23,T>A,1962,1668,3630,9756095,10108016,19864111,0.0001827416288602
WA11,5p,24,T>A,2239,1639,3878,9756046,10108010,19864056,0.0001952269969436
WA11,5p,25,T>A,2328,2069,4397,9756056,10107943,19863999,0.0002213552266087
WA12,3p,1,T>A,39,43,82,6632243,6940679,13572922,6.041440450331919e-06
WA12,3p,2,T>A,48,58,106,6632243,6940679,13572922,7.809666923599797e-06
WA12,3p,3,T>A,97,62,159,6632243,6940679,13572922,1.1714500385399696e-05
WA12,3p,4,T>A,219,105,324,6632243,6940676,13572919,2.387106266529698e-05
WA12,3p,5,T>A,917,1304,2221,6632243,6940678,13572921,0.0001636346369362
WA12,3p,6,T>A,776,905,1681,6632243,6940679,13572922,0.0001238495292318
WA12,3p,7,T>A,967,1073,2040,6632243,6940676,13572919,0.0001502992834481
WA12,3p,8,T>A,898,1135,2033,6632240,6940664,13572904,0.000149783716145
WA12,3p,9,T>A,1077,1244,2321,6632231,6940656,13572887,0.0001710026761439
WA12,3p,10,T>A,1083,1110,2193,6632228,6940644,13572872,0.0001615722891956
WA12,3p,11,T>A,1062,1112,2174,6632231,6940642,13572873,0.0001601724262799
WA12,3p,12,T>A,1132,1210,2342,6632223,6940615,13572838,0.0001725505012289
WA12,3p,13,T>A,1346,1451,2797,6632204,6940591,13572795,0.0002060739884452
WA12,3p,14,T>A,1088,1234,2322,6632209,6940533,13572742,0.0001710781800759
WA12,3p,15,T>A,1174,1388,2562,6632188,6940474,13572662,0.0001887617919019
WA12,3p,16,T>A,1121,1661,2782,6632187,6940478,13572665,0.0002049707997655
WA12,3p,17,T>A,1137,1373,2510,6632168,6940473,13572641,0.0001849308472831
WA12,3p,18,T>A,1146,1583,2729,6632160,6940482,13572642,0.0002010662330885
WA12,3p,19,T>A,1160,1346,2506,6632121,6940435,13572556,0.0001846372930787
WA12,3p,20,T>A,1238,1292,2530,6632105,6940432,13572537,0.0001864058281808
WA12,3p,21,T>A,1357,1546,2903,6632096,6940454,13572550,0.0002138875892886
WA12,3p,22,T>A,1209,1291,2500,6632039,6940438,13572477,0.0001841962966671
WA12,3p,23,T>A,1171,1300,2471,6631950,6940459,13572409,0.0001820605317744
WA12,3p,24,T>A,1150,1586,2736,6631933,6940411,13572344,0.0002015864024666
WA12,3p,25,T>A,1280,1457,2737,6631986,6940428,13572414,0.0002016590416413
WA12,5p,1,T>A,10,5,15,6632243,6940679,13572922,1.1051415457924242e-06
WA12,5p,2,T>A,35,53,88,6631949,6940524,13572473,6.483711553524549e-06
WA12,5p,3,T>A,347,200,547,6632242,6940678,13572920,4.030083430831391e-05
WA12,5p,4,T>A,304,179,483,6632242,6940679,13572921,3.558556039632147e-05
WA12,5p,5,T>A,1098,944,2042,6632242,6940677,13572919,0.0001504466356868
WA12,5p,6,T>A,1232,1349,2581,6632242,6940679,13572921,0.0001901580359894
WA12,5p,7,T>A,752,1245,1997,6632238,6940679,13572917,0.0001471312319967
WA12,5p,8,T>A,989,871,1860,6632204,6940670,13572874,0.0001370380363068
WA12,5p,9,T>A,1071,1304,2375,6632209,6940675,13572884,0.000174981234644
WA12,5p,10,T>A,1639,1777,3416,6632199,6940665,13572864,0.0002516786435051
WA12,5p,11,T>A,1189,1098,2287,6632166,6940667,13572833,0.0001684983525546
WA12,5p,12,T>A,1150,1304,2454,6632126,6940660,13572786,0.0001808029685283
WA12,5p,13,T>A,1351,1624,2975,6632065,6940658,13572723,0.0002191896202405
WA12,5p,14,T>A,1316,1068,2384,6632026,6940638,13572664,0.0001756471684556
WA12,5p,15,T>A,1401,1250,2651,6631987,6940631,13572618,0.0001953197238734
WA12,5p,16,T>A,1387,1284,2671,6631930,6940590,13572520,0.0001967946998788
WA12,5p,17,T>A,1141,1449,2590,6631958,6940621,13572579,0.0001908259292504
WA12,5p,18,T>A,1514,1279,2793,6632019,6940577,13572596,0.00020578229839
WA12,5p,19,T>A,1372,1315,2687,6631996,6940532,13572528,0.0001979734357519
WA12,5p,20,T>A,1297,1143,2440,6631973,6940532,13572505,0.0001797752146711
WA12,5p,21,T>A,1417,1596,3013,6631936,6940534,13572470,0.0002219934912363
WA12,5p,22,T>A,1354,1309,2663,6631921,6940529,13572450,0.0001962062855269
WA12,5p,23,T>A,1342,1231,2573,6631926,6940534,13572460,0.0001895750659791
WA12,5p,24,T>A,1545,1223,2768,6631934,6940518,13572452,0.0002039425153244
WA12,5p,25,T>A,1478,1512,2990,6631933,6940515,13572448,0.0002202992415222
WA13,3p,1,T>A,8,6,14,5896847,6081528,11978375,1.1687728928172645e-06
WA13,3p,2,T>A,10,5,15,5896847,6081528,11978375,1.2522566708756404e-06
WA13,3p,3,T>A,8,9,17,5896847,6081528,11978375,1.4192242269923926e-06
WA13,3p,4,T>A,18,71,89,5896847,6081522,11978369,7.4300599689323316e-06
WA13,3p,5,T>A,70,148,218,5896847,6081527,11978374,1.8199465136086084e-05
WA13,3p,6,T>A,107,299,406,5896847,6081528,11978375,3.389441389170067e-05
WA13,3p,7,T>A,88,130,218,5896847,6081528,11978375,1.8199463616725976e-05
WA13,3p,8,T>A,115,117,232,5896845,6081521,11978366,1.93682510619562e-05
WA13,3p,9,T>A,166,166,332,5896842,6081517,11978359,2.7716651337633145e-05
WA13,3p,10,T>A,98,100,198,5896843,6081517,11978360,1.6529808755121735e-05
WA13,3p,11,T>A,144,123,267,5896841,6081492,11978333,2.2290246898295447e-05
WA13,3p,12,T>A,127,181,308,5896836,6081505,11978341,2.5713076627222416e-05
WA13,3p,13,T>A,117,133,250,5896834,6081495,11978329,2.087102466462559e-05
WA13,3p,14,T>A,120,129,249,5896832,6081501,11978333,2.0787533624253057e-05
WA13,3p,15,T>A,159,145,304,5896825,6081505,11978330,2.5379163873428094e-05
WA13,3p,16,T>A,118,199,317,5896830,6081509,11978339,2.646443718114841e-05
WA13,3p,17,T>A,188,158,346,5896823,6081499,11978322,2.888551501621012e-05
WA13,3p,18,T>A,163,182,345,5896827,6081499,11978326,2.8802021250715668e-05
WA13,3p,19,T>A,131,137,268,5896822,6081480,11978302,2.237378887257977e-05
WA13,3p,20,T>A,221,80,301,5896818,6081448,11978266,2.5128845861329175e-05
WA13,3p,21,T>A,130,123,253,5896824,6081466,11978290,2.1121545729816192e-05
WA13,3p,22,T>A,201,141,342,5896824,6081460,11978284,2.8551669003673648e-05
WA13,3p,23,T>A,160,125,285,5896819,6081454,11978273,2.3793079352925083e-05
WA13,3p,24,T>A,152,129,281,5896803,6081440,11978243,2.3459200151474635e-05
WA13,3p,25,T>A,397,161,558,5896783,6081437,11978220,4.658455095999239e-05
WA13,5p,1,T>A,2,7,9,5896847,6081528,11978375,7.513540025253843e-07
WA13,5p,2,T>A,2,4,6,5896725,6081443,11978168,5.009113246700163e-07
WA13,5p,3,T>A,83,19,102,5896847,6081528,11978375,8.515345361954356e-06
WA13,5p,4,T>A,43,17,60,5896841,6081528,11978369,5.00902919253865e-06
WA13,5p,5,T>A,135,61,196,5896841,6081528,11978369,1.6362828695626257e-05
WA13,5p,6,T>A,128,122,250,5896841,6081528,11978369,2.087095496891104e-05
WA13,5p,7,T>A,73,92,165,5896845,6081528,11978373,1.3774825679581024e-05
WA13,5p,8,T>A,112,75,187,5896843,6081526,11978369,1.561147431674546e-05
WA13,5p,9,T>A,107,90,197,5896837,6081518,11978355,1.6446331737538252e-05
WA13,5p,10,T>A,263,107,370,5896833,6081518,11978351,3.088905977124898e-05
WA13,5p,11,T>A,182,8718,8900,5896827,6081513,11978340,0.0007430077957379
WA13,5p,12,T>A,170,117,287,5896822,6081502,11978324,2.395994631636279e-05
WA13,5p,13,T>A,150,104,254,5896809,6081508,11978317,2.1204982302605616e-05
WA13,5p,14,T>A,144,63,207,5896802,6081520,11978322,1.7281218521258654e-05
WA13,5p,15,T>A,144,109,253,5896798,6081508,11978306,2.11215175167507e-05
WA13,5p,16,T>A,130,113,243,5896754,6081491,11978245,2.0286778238381333e-05
WA13,5p,17,T>A,193,78,271,5896805,6081514,11978319,2.2624209624071623e-05
WA13,5p,18,T>A,131,111,242,5896796,6081504,11978300,2.02032007880918e-05
WA13,5p,19,T>A,184,113,297,5896797,6081472,11978269,2.4794901500375388e-05
WA13,5p,20,T>A,198,131,329,5896788,6081482,11978270,2.7466403746116927e-05
WA13,5p,21,T>A,223,122,345,5896782,6081484,11978266,2.880216552212148e-05
WA13,5p,22,T>A,195,179,374,5896771,6081483,11978254,3.12232483966361e-05
WA13,5p,23,T>A,218,143,361,5896768,6081501,11978269,3.013791057789736e-05
WA13,5p,24,T>A,143,193,336,5896781,6081498,11978279,2.8050774238936995e-05
WA13,5p,25,T>A,228,177,405,5896769,6081462,11978231,3.381133658217144e-05
WA14,3p,1,T>A,43,64,107,6684341,7140972,13825313,7.739426948236181e-06
WA14,3p,2,T>A,72,63,135,6684341,7140972,13825313,9.76469755151294e-06
WA14,3p,3,T>A,156,73,229,6684341,7140972,13825313,1.6563820291084912e-05
WA14,3p,4,T>A,238,147,385,6684341,7140971,13825312,2.784747280929356e-05
WA14,3p,5,T>A,986,686,1672,6684341,7140970,13825311,0.0001209376049479
WA14,3p,6,T>A,707,679,1386,6684341,7140971,13825312,0.0001002509021134
WA14,3p,7,T>A,812,824,1636,6684341,7140969,13825310,0.0001183336937833
WA14,3p,8,T>A,1119,931,2050,6684326,7140932,13825258,0.0001482793304833
WA14,3p,9,T>A,1209,1116,2325,6684323,7140920,13825243,0.0001681706426425
WA14,3p,10,T>A,1240,1111,2351,6684256,7140912,13825168,0.000170052183091
WA14,3p,11,T>A,1187,1235,2422,6684256,7140894,13825150,0.000175187972644
WA14,3p,12,T>A,1140,1438,2578,6684291,7140849,13825140,0.0001864718910622
WA14,3p,13,T>A,1333,1030,2363,6684289,7140794,13825083,0.0001709212161691
WA14,3p,14,T>A,1267,1000,2267,6684291,7140742,13825033,0.0001639779087688
WA14,3p,15,T>A,967,1026,1993,6684271,7140702,13824973,0.0001441594135482
WA14,3p,16,T>A,1145,1148,2293,6684263,7140648,13824911,0.000165860018918
WA14,3p,17,T>A,1058,904,1962,6684212,7140653,13824865,0.0001419182031795
WA14,3p,18,T>A,1331,1148,2479,6684177,7140647,13824824,0.0001793151218416
WA14,3p,19,T>A,1559,1126,2685,6684172,7140542,13824714,0.0001942173993617
WA14,3p,20,T>A,1283,1310,2593,6684176,7140544,13824720,0.0001875625690791
WA14,3p,21,T>A,1309,1694,3003,6684132,7140443,13824575,0.00021722186758
WA14,3p,22,T>A,1318,1371,2689,6684105,7140560,13824665,0.0001945074256772
WA14,3p,23,T>A,1585,1654,3239,6683638,7140562,13824200,0.0002342992722906
WA14,3p,24,T>A,1392,1393,2785,6683623,7140532,13824155,0.0002014589680164
WA14,3p,25,T>A,1428,1490,2918,6683613,7140513,13824126,0.0002110802520173
WA14,5p,1,T>A,17,9,26,6684341,7140972,13825313,1.8806084173284175e-06
WA14,5p,2,T>A,45,55,100,6684184,7140911,13825095,7.233223352172263e-06
WA14,5p,3,T>A,571,218,789,6684338,7140972,13825310,5.706924474026261e-05
WA14,5p,4,T>A,545,319,864,6684341,7140972,13825313,6.24940643296828e-05
WA14,5p,5,T>A,1130,1324,2454,6684341,7140972,13825313,0.0001775005021586
WA14,5p,6,T>A,1076,1036,2112,6684340,7140972,13825312,0.0001527632794109
WA14,5p,7,T>A,633,950,1583,6684336,7140972,13825308,0.0001145001615877
WA14,5p,8,T>A,903,1109,2012,6684277,7140970,13825247,0.0001455308538068
WA14,5p,9,T>A,1465,915,2380,6684241,7140959,13825200,0.0001721494083268
WA14,5p,10,T>A,1431,1702,3133,6684210,7140628,13824838,0.0002266211003702
WA14,5p,11,T>A,947,896,1843,6684218,7140646,13824864,0.0001333105338323
WA14,5p,12,T>A,1043,816,1859,6684139,7140917,13825056,0.0001344660014397
WA14,5p,13,T>A,1010,1267,2277,6684018,7140931,13824949,0.0001647022350679
WA14,5p,14,T>A,998,920,1918,6683951,7140942,13824893,0.0001387352509708
WA14,5p,15,T>A,1062,1163,2225,6684030,7140908,13824938,0.0001609410472582
WA14,5p,16,T>A,1268,975,2243,6683910,7140868,13824778,0.0001622449199545
WA14,5p,17,T>A,1288,1422,2710,6683904,7140873,13824777,0.0001960248617391
WA14,5p,18,T>A,1252,1016,2268,6683891,7140646,13824537,0.0001640561271599
WA14,5p,19,T>A,1575,1445,3020,6683958,7140595,13824553,0.0002184519094396
WA14,5p,20,T>A,1287,1388,2675,6683860,7140558,13824418,0.0001934982000688
WA14,5p,21,T>A,1581,997,2578,6683480,7140494,13823974,0.000186487619262
WA14,5p,22,T>A,1379,1313,2692,6683768,7140398,13824166,0.0001947314579411
WA14,5p,23,T>A,1332,1225,2557,6683762,7140257,13824019,0.0001849679170724
WA14,5p,24,T>A,1379,1234,2613,6683714,7140421,13824135,0.0001890172513506
WA14,5p,25,T>A,1445,1542,2987,6683731,7140511,13824242,0.0002160697128999
WA18,3p,1,T>A,28,30,58,14112928,14131239,28244167,2.053521351860014e-06
WA18,3p,2,T>A,105,42,147,14112928,14131239,28244167,5.2046144607486565e-06
WA18,3p,3,T>A,268,179,447,14112928,14131239,28244167,1.5826276625541833e-05
WA18,3p,4,T>A,446,588,1034,14112928,14131238,28244166,3.6609330224160274e-05
WA18,3p,5,T>A,2146,1669,3815,14112928,14131239,28244167,0.0001350721371956
WA18,3p,6,T>A,1973,2622,4595,14112928,14131239,28244167,0.000162688458824
WA18,3p,7,T>A,1824,1961,3785,14112928,14131237,28244165,0.0001340099804685
WA18,3p,8,T>A,2211,2445,4656,14112927,14131187,28244114,0.0001648485061347
WA18,3p,9,T>A,2276,2933,5209,14112909,14131177,28244086,0.0001844279896329
WA18,3p,10,T>A,2894,2774,5668,14112909,14131197,28244106,0.0002006790372476
WA18,3p,11,T>A,2309,2441,4750,14112900,14131167,28244067,0.0001681769130486
WA18,3p,12,T>A,2598,4690,7288,14112895,14131136,28244031,0.0002580368220102
WA18,3p,13,T>A,2916,11439,14355,14112898,14131061,28243959,0.0005082502775195
WA18,3p,14,T>A,3234,4437,7671,14112830,14131006,28243836,0.0002715990844869
WA18,3p,15,T>A,2693,15103,17796,14112809,14130957,28243766,0.0006300859453374
WA18,3p,16,T>A,2989,15989,18978,14112765,14130927,28243692,0.0006719376489447
WA18,3p,17,T>A,3298,60492,63790,14112743,14130850,28243593,0.0022585653319675
WA18,3p,18,T>A,3692,57152,60844,14112708,14130769,28243477,0.0021542673375519
WA18,3p,19,T>A,3428,11414,14842,14112724,14130771,28243495,0.0005255015358403
WA18,3p,20,T>A,3419,37900,41319,14112697,14130797,28243494,0.0014629563891776
WA18,3p,21,T>A,3379,9862,13241,14112659,14130783,28243442,0.0004688167964796
WA18,3p,22,T>A,2675,4970,7645,14112575,14130715,28243290,0.0002706837624086
WA18,3p,23,T>A,3053,6305,9358,14112548,14130648,28243196,0.0003313364394029
WA18,3p,24,T>A,3043,4495,7538,14112551,14130690,28243241,0.0002668957149783
WA18,3p,25,T>A,3748,6283,10031,14112486,14130651,28243137,0.000355165929337
WA18,5p,1,T>A,65,28,93,14112926,14131239,28244165,3.292715504246629e-06
WA18,5p,2,T>A,58,201,259,14112820,14131183,28244003,9.17008824846818e-06
WA18,5p,3,T>A,1675,670,2345,14112928,14131239,28244167,8.302599258813333e-05
WA18,5p,4,T>A,1141,403,1544,14112928,14131239,28244167,5.466615460813555e-05
WA18,5p,5,T>A,2201,2280,4481,14112925,14131239,28244164,0.0001586522440529
WA18,5p,6,T>A,2449,1914,4363,14112927,14131239,28244166,0.0001544743788858
WA18,5p,7,T>A,1477,1808,3285,14112921,14131239,28244160,0.0001163072295299
WA18,5p,8,T>A,2160,2943,5103,14112828,14131230,28244058,0.0001806751706854
WA18,5p,9,T>A,1823,1422,3245,14112833,14131230,28244063,0.0001148914021329
WA18,5p,10,T>A,2958,3479,6437,14112791,14131213,28244004,0.0002279067797894
WA18,5p,11,T>A,2308,2000,4308,14112776,14131211,28243987,0.0001525280407472
WA18,5p,12,T>A,2379,2173,4552,14112682,14131223,28243905,0.0001611675156108
WA18,5p,13,T>A,2497,2437,4934,14112608,14131206,28243814,0.0001746931204121
WA18,5p,14,T>A,2426,2437,4863,14112535,14131179,28243714,0.0001721799052348
WA18,5p,15,T>A,2718,2017,4735,14112545,14131148,28243693,0.0001676480480084
WA18,5p,16,T>A,2755,2777,5532,14112522,14131083,28243605,0.0001958673476703
WA18,5p,17,T>A,2774,2069,4843,14112485,14130990,28243475,0.0001714732340832
WA18,5p,18,T>A,2751,2308,5059,14112481,14130987,28243468,0.0001791210626117
WA18,5p,19,T>A,2658,2068,4726,14112359,14130867,28243226,0.0001673321595769
WA18,5p,20,T>A,2699,2293,4992,14112397,14130866,28243263,0.0001767501155939
WA18,5p,21,T>A,2722,1911,4633,14112347,14130679,28243026,0.0001640404962272
WA18,5p,22,T>A,2916,2232,5148,14112376,14129592,28241968,0.0001822819146314
WA18,5p,23,T>A,3023,2912,5935,14112288,14129275,28241563,0.0002101512582713
WA18,5p,24,T>A,3295,2904,6199,14112253,14129481,28241734,0.000219497853779
WA18,5p,25,T>A,3026,2445,5471,14112273,14130551,28242824,0.0001937129233252
WA22,3p,1,T>A,8,11,19,1513709,1653397,3167106,5.999167694418816e-06
WA22,3p,2,T>A,15,10,25,1513709,1653396,3167105,7.893644195566613e-06
WA22,3p,3,T>A,6,10,16,1513709,1653396,3167105,5.051932285162633e-06
WA22,3p,4,T>A,23,34,57,1513709,1653394,3167103,1.7997520131173504e-05
WA22,3p,5,T>A,70,37,107,1513709,1653397,3167106,3.3784786489621754e-05
WA22,3p,6,T>A,48,73,121,1513709,1653397,3167106,3.820522584340404e-05
WA22,3p,7,T>A,45,76,121,1513709,1653397,3167106,3.820522584340404e-05
WA22,3p,8,T>A,75,99,174,1513709,1653395,3167104,5.493978094814696e-05
WA22,3p,9,T>A,82,144,226,1513709,1653397,3167106,7.135852099677119e-05
WA22,3p,10,T>A,92,133,225,1513706,1653396,3167102,7.104286505455144e-05
WA22,3p,11,T>A,90,59,149,1513685,1653390,3167075,4.704656504819116e-05
WA22,3p,12,T>A,176,144,320,1513662,1653379,3167041,0.000101040687506
WA22,3p,13,T>A,116,129,245,1513689,1653380,3167069,7.735859243988685e-05
WA22,3p,14,T>A,87,98,185,1513686,1653352,3167038,5.8414202797692986e-05
WA22,3p,15,T>A,99,77,176,1513677,1653343,3167020,5.557274661985084e-05
WA22,3p,16,T>A,135,169,304,1513637,1653341,3166978,9.599056261205476e-05
WA22,3p,17,T>A,133,230,363,1513671,1653319,3166990,0.0001146198756548
WA22,3p,18,T>A,118,178,296,1513665,1653288,3166953,9.346523298577529e-05
WA22,3p,19,T>A,121,107,228,1513662,1653275,3166937,7.199385399835867e-05
WA22,3p,20,T>A,191,105,296,1513684,1653304,3166988,9.346420005380506e-05
WA22,3p,21,T>A,159,113,272,1513677,1653327,3167004,8.588558776686104e-05
WA22,3p,22,T>A,157,78,235,1513684,1653356,3167040,7.420177831666161e-05
WA22,3p,23,T>A,209,164,373,1513676,1653329,3167005,0.0001177768901533
WA22,3p,24,T>A,200,122,322,1513672,1653285,3166957,0.0001016748885444
WA22,3p,25,T>A,214,123,337,1513669,1653296,3166965,0.0001064110275926
WA22,5p,1,T>A,0,3,3,1513709,1653397,3167106,9.472370043819184e-07
WA22,5p,2,T>A,5,0,5,1513674,1653378,3167052,1.578755258833767e-06
WA22,5p,3,T>A,229,43,272,1513709,1653397,3167106,8.588282173062727e-05
WA22,5p,4,T>A,30,23,53,1513709,1653397,3167106,1.6734520410747223e-05
WA22,5p,5,T>A,108,143,251,1513708,1653396,3167104,7.925221274703957e-05
WA22,5p,6,T>A,103,57,160,1513704,1653397,3167101,5.0519386656756446e-05
WA22,5p,7,T>A,41,112,153,1513707,1653397,3167104,4.8309117730267146e-05
WA22,5p,8,T>A,95,96,191,1513692,1653397,3167089,6.030774632477963e-05
WA22,5p,9,T>A,144,136,280,1513700,1653389,3167089,8.84092616279492e-05
WA22,5p,10,T>A,147,240,387,1513705,1653389,3167094,0.0001221940365521
WA22,5p,11,T>A,153,179,332,1513699,1653381,3167080,0.0001048284223953
WA22,5p,12,T>A,138,198,336,1513692,1653345,3167037,0.0001060928558775
WA22,5p,13,T>A,90,160,250,1513697,1653377,3167074,7.89372146025006e-05
WA22,5p,14,T>A,138,171,309,1513677,1653376,3167053,9.756704418903e-05
WA22,5p,15,T>A,176,135,311,1513695,1653381,3167076,9.819783295380343e-05
WA22,5p,16,T>A,111,114,225,1513668,1653368,3167036,7.104434556474887e-05
WA22,5p,17,T>A,155,144,299,1513675,1653395,3167070,9.440902790276186e-05
WA22,5p,18,T>A,173,189,362,1513651,1653392,3167043,0.0001143022055589
WA22,5p,19,T>A,164,156,320,1513674,1653350,3167024,0.0001010412298738
WA22,5p,20,T>A,193,113,306,1513678,1653356,3167034,9.662037098433424e-05
WA22,5p,21,T>A,194,227,421,1513690,1653371,3167061,0.0001329308150364
WA22,5p,22,T>A,156,144,300,1513691,1653380,3167071,9.472474725069316e-05
WA22,5p,23,T>A,150,197,347,1513634,1653393,3167027,0.0001095664798563
WA22,5p,24,T>A,240,113,353,1513632,1653375,3167007,0.0001114617050104
WA22,5p,25,T>A,229,222,451,1513644,1653364,3167008,0.0001424057027958
WA25,3p,1,T>A,9,13,22,3375244,3569089,6944333,3.168050840879894e-06
WA25,3p,2,T>A,34,8,42,3375244,3569089,6944333,6.0480970598616165e-06
WA25,3p,3,T>A,44,78,122,3375244,3569089,6944333,1.7568281935788506e-05
WA25,3p,4,T>A,76,111,187,3375244,3569087,6944331,2.692843990299425e-05
WA25,3p,5,T>A,230,239,469,3375244,3569089,6944333,6.753708383512138e-05
WA25,3p,6,T>A,251,251,502,3375244,3569089,6944333,7.228916009644123e-05
WA25,3p,7,T>A,278,502,780,3375244,3569089,6944333,0.0001123218025402
WA25,3p,8,T>A,291,371,662,3375239,3569076,6944315,9.532977694704227e-05
WA25,3p,9,T>A,294,886,1180,3375240,3569076,6944316,0.0001699231428984
WA25,3p,10,T>A,441,423,864,3375240,3569075,6944315,0.0001244183191574
WA25,3p,11,T>A,376,495,871,3375233,3569054,6944287,0.0001254268436773
WA25,3p,12,T>A,352,576,928,3375226,3569069,6944295,0.0001336348758225
WA25,3p,13,T>A,513,425,938,3375230,3569053,6944283,0.0001350751402268
WA25,3p,14,T>A,391,405,796,3375223,3569037,6944260,0.0001146270444943
WA25,3p,15,T>A,419,256,675,3375218,3569039,6944257,9.720262369321872e-05
WA25,3p,16,T>A,449,457,906,3375196,3569030,6944226,0.0001304681040046
WA25,3p,17,T>A,485,591,1076,3375198,3569022,6944220,0.0001549490079519
WA25,3p,18,T>A,458,479,937,3375213,3569006,6944219,0.0001349323804447
WA25,3p,19,T>A,486,517,1003,3375204,3569005,6944209,0.0001444368969885
WA25,3p,20,T>A,519,444,963,3375190,3568979,6944169,0.0001386775005043
WA25,3p,21,T>A,480,351,831,3375199,3568998,6944197,0.0001196682640195
WA25,3p,22,T>A,712,430,1142,3375179,3568994,6944173,0.0001644544281946
WA25,3p,23,T>A,554,482,1036,3375175,3568972,6944147,0.0001491903901227
WA25,3p,24,T>A,573,507,1080,3375177,3568962,6944139,0.0001555268406925
WA25,3p,25,T>A,731,499,1230,3375156,3568970,6944126,0.0001771281223871
WA25,5p,1,T>A,1,6,7,3375244,3569089,6944333,1.0080161766436029e-06
WA25,5p,2,T>A,8,311,319,3375147,3569045,6944192,4.593766992617716e-05
WA25,5p,3,T>A,338,463,801,3375243,3569089,6944332,0.0001153458676802
WA25,5p,4,T>A,248,287,535,3375243,3569089,6944332,7.704124745187874e-05
WA25,5p,5,T>A,456,450,906,3375244,3569088,6944332,0.0001304661125072
WA25,5p,6,T>A,426,503,929,3375244,3569089,6944333,0.0001337781468717
WA25,5p,7,T>A,265,253,518,3375242,3569089,6944331,7.459321855481831e-05
WA25,5p,8,T>A,311,214,525,3375221,3569088,6944309,7.560147453115925e-05
WA25,5p,9,T>A,365,203,568,3375227,3569087,6944314,8.179353640978792e-05
WA25,5p,10,T>A,536,508,1044,3375217,3569085,6944302,0.0001503390837552
WA25,5p,11,T>A,391,376,767,3375193,3569088,6944281,0.0001104505995653
WA25,5p,12,T>A,355,501,856,3375142,3569084,6944226,0.0001232678775143
WA25,5p,13,T>A,394,700,1094,3375133,3569081,6944214,0.0001575412278481
WA25,5p,14,T>A,558,316,874,3375151,3569071,6944222,0.0001258600315485
WA25,5p,15,T>A,497,331,828,3375137,3569055,6944192,0.0001192363344792
WA25,5p,16,T>A,470,292,762,3375081,3569035,6944116,0.0001097331899409
WA25,5p,17,T>A,532,330,862,3375076,3568871,6943947,0.0001241368921738
WA25,5p,18,T>A,408,472,880,3375102,3568996,6944098,0.0001267263221227
WA25,5p,19,T>A,508,345,853,3375134,3569021,6944155,0.0001228371198511
WA25,5p,20,T>A,477,420,897,3375145,3569019,6944164,0.0001291732165311
WA25,5p,21,T>A,543,441,984,3375130,3569013,6944143,0.0001417021510069
WA25,5p,22,T>A,558,458,1016,3375139,3569001,6944140,0.0001463104142485
WA25,5p,23,T>A,643,496,1139,3375144,3569002,6944146,0.0001640230490545
WA25,5p,24,T>A,536,646,1182,3375124,3568967,6944091,0.0001702166633472
WA25,5p,25,T>A,633,429,1062,3375125,3568950,6944075,0.0001529361362024
WA26,3p,1,T>A,10,56,66,2709623,2900126,5609749,1.1765232276880837e-05
WA26,3p,2,T>A,18,13,31,2709623,2900126,5609749,5.526093948231908e-06
WA26,3p,3,T>A,42,32,74,2709623,2900126,5609749,1.3191321037714878e-05
WA26,3p,4,T>A,54,44,98,2709623,2900126,5609749,1.7469587320217e-05
WA26,3p,5,T>A,201,185,386,2709623,2900126,5609749,6.880878271024247e-05
WA26,3p,6,T>A,202,151,353,2709623,2900126,5609749,6.292616657180206e-05
WA26,3p,7,T>A,205,154,359,2709623,2900126,5609749,6.399573314242759e-05
WA26,3p,8,T>A,221,249,470,2709619,2900114,5609733,8.378295366285704e-05
WA26,3p,9,T>A,318,405,723,2709613,2900111,5609724,0.0001288833461325
WA26,3p,10,T>A,263,347,610,2709609,2900074,5609683,0.0001087405473713
WA26,3p,11,T>A,302,508,810,2709594,2900076,5609670,0.0001443935204744
WA26,3p,12,T>A,371,231,602,2709607,2900081,5609688,0.0001073143461811
WA26,3p,13,T>A,286,286,572,2709604,2900084,5609688,0.0001019664551754
WA26,3p,14,T>A,384,263,647,2709584,2900069,5609653,0.0001153369023003
WA26,3p,15,T>A,274,306,580,2709593,2900082,5609675,0.000103392799048
WA26,3p,16,T>A,480,286,766,2709580,2900075,5609655,0.0001365502869606
WA26,3p,17,T>A,495,272,767,2709570,2900078,5609648,0.0001367287216595
WA26,3p,18,T>A,345,280,625,2709582,2900059,5609641,0.0001114153294301
WA26,3p,19,T>A,377,322,699,2709567,2900016,5609583,0.0001246081928014
WA26,3p,20,T>A,376,355,731,2709563,2899983,5609546,0.0001303135761788
WA26,3p,21,T>A,412,331,743,2709562,2900021,5609583,0.0001324519130922
WA26,3p,22,T>A,414,375,789,2709522,2900007,5609529,0.0001406535201083
WA26,3p,23,T>A,313,327,640,2709541,2899974,5609515,0.0001140918599914
WA26,3p,24,T>A,445,641,1086,2709558,2899951,5609509,0.0001935998319995
WA26,3p,25,T>A,373,310,683,2709500,2900002,5609502,0.0001217576890069
WA26,5p,1,T>A,4,5,9,2709622,2900126,5609748,1.6043501419315092e-06
WA26,5p,2,T>A,7,49,56,2709554,2900092,5609646,9.982804619043695e-06
WA26,5p,3,T>A,225,44,269,2709623,2900126,5609749,4.7952234583044624e-05
WA26,5p,4,T>A,204,41,245,2709623,2900126,5609749,4.36739683005425e-05
WA26,5p,5,T>A,308,325,633,2709623,2900125,5609748,0.0001128392933158
WA26,5p,6,T>A,335,283,618,2709621,2900126,5609747,0.0001101653960508
WA26,5p,7,T>A,143,202,345,2709622,2900126,5609748,6.150008877404118e-05
WA26,5p,8,T>A,250,203,453,2709609,2900124,5609733,8.075250640271115e-05
WA26,5p,9,T>A,284,340,624,2709594,2900123,5609717,0.0001112355578721
WA26,5p,10,T>A,524,400,924,2709601,2900123,5609724,0.0001647139859287
WA26,5p,11,T>A,208,441,649,2709605,2900103,5609708,0.0001156922962835
WA26,5p,12,T>A,262,468,730,2709595,2900107,5609702,0.0001301316897047
WA26,5p,13,T>A,349,259,608,2709592,2900104,5609696,0.0001083837698156
WA26,5p,14,T>A,315,403,718,2709563,2900089,5609652,0.0001279936794653
WA26,5p,15,T>A,345,246,591,2709545,2900085,5609630,0.0001053545420999
WA26,5p,16,T>A,406,274,680,2709540,2900076,5609616,0.0001212204186525
WA26,5p,17,T>A,467,312,779,2709554,2900055,5609609,0.0001388688587742
WA26,5p,18,T>A,447,435,882,2709554,2900082,5609636,0.000157229453034
WA26,5p,19,T>A,430,214,644,2709570,2900086,5609656,0.0001148020484678
WA26,5p,20,T>A,414,305,719,2709563,2900082,5609645,0.0001281721035823
WA26,5p,21,T>A,349,315,664,2709545,2900061,5609606,0.0001183683845175
WA26,5p,22,T>A,383,372,755,2709542,2900059,5609601,0.0001345906776613
WA26,5p,23,T>A,328,418,746,2709528,2900065,5609593,0.0001329864751328
WA26,5p,24,T>A,305,274,579,2709495,2900057,5609552,0.0001032167987746
WA26,5p,25,T>A,370,303,673,2709506,2900041,5609547,0.0001199740371192
