Substitution,Max_Frequency,Sample,End,Position,Combined_Count,Combined_Total,Pos_Count,Neg_Count,Pos_Total,Neg_Total
G>A,0.002800958158726548,WA26,3p,24,15712,5609509,3839,11873,2709558,2899951
C>T,0.0013612009566697613,WA03,5p,21,14895,10942543,8266,6629,5399034,5543509
A>G,0.0012162130426171276,WA09,5p,12,11704,9623314,5922,5782,4741580,4881734
T>C,0.001142186032030738,WA03,5p,9,12499,10943051,6650,5849,5399319,5543732
A>C,0.0007481017575340509,WA13,5p,13,8961,11978317,270,8691,5896809,6081508
A>T,0.0007493594003989404,WA13,5p,25,8976,11978231,182,8794,5896769,6081462
C>G,0.0007569506385033499,WA13,5p,12,9067,11978324,189,8878,5896822,6081502
C>A,0.0007440078027317409,WA13,5p,5,8912,11978369,166,8746,5896841,6081528
T>G,0.0007450107281043943,WA13,5p,10,8924,11978351,162,8762,5896833,6081518
T>A,0.0022585653319675014,WA18,3p,17,63790,28243593,3298,60492,14112743,14130850
G>C,0.0007523015174023827,DAL224,5p,13,6918,9195781,534,6384,4609320,4586461
G>T,0.0007445921894708704,WA13,5p,6,8919,11978369,232,8687,5896841,6081528
A>-,6.792046780623307e-05,WA26,3p,25,381,5609502,212,169,2709500,2900002
T>-,7.009865912632441e-05,WA22,3p,25,222,3166965,79,143,1513669,1653296
C>-,6.061144108692715e-05,WA26,3p,25,340,5609502,181,159,2709500,2900002
G>-,6.061144108692715e-05,WA26,3p,25,340,5609502,147,193,2709500,2900002
->A,5.052805893575798e-05,WA18,5p,24,1427,28241734,220,1207,14112253,14129481
->T,8.228376539149148e-05,DAL195,5p,12,381,4630318,380,1,2362864,2267454
->C,4.677503153773748e-05,WA18,5p,23,1321,28241563,108,1213,14112288,14129275
->G,4.688058565890309e-05,WA18,5p,22,1324,28241968,102,1222,14112376,14129592
S,0.10427153369669345,WA22,3p,1,330239,3167106,125424,204815,1513709,1653397
